"","from","to","value","overlap_final.value.x","overlap_final.value.y","avg_contacts","source_structures","num_struc","min_rep"
"1","N.H4.2","N.S17.3",102,63,39,1.27167277167277,"6KR6,6OON,A0A163JTZ6,J9D5G4,D2VMG4,A0A0D1ZAJ4,F4PH46,A0A164ZA52,A0A383WDW5,Q54G64,S7WCF7,I0YVB2,R7QGN7,A0A2C5Z0M1,A0CB11,R9ACY5,D3BMP8,A0A1Z5TVE5,W7XD45,A0A4S2MWZ7,K1VVQ6,A0A158P1R9,G7DVX0,V6R0U9,G4N9J3,E3KLI3,A0A1E3QC61,S8ANP9,A0A139AUH8,U4LBG4,O74957,A0A0E9NDK5,A0A250WXN5,Q5KAT1,L2GUF2,A0A1W0E4B5,A0A2J7QB22,A0A3S3PD82,A0A1S3J512,G0QTT2,U5HIG6,A0A401PRI6,A0A2B4RHN2,G2QEV0,A0A397UU01,K7ISV0,E9FUN9,A0A1S3CYL5,D7FQK3,A0A1Y1YHC8,F4S231,A0A2G5B1D8,A0A1C7M8P2,J9JZ66,R7YY92,A0A1Q3ENA6,A8P0D4,F4NYW7,A0A409Y6G2,A0A1J8PPA3,A0A2R6NSC2,G4T5G9,F6YK55,1Z26,5G5T,6QZK,E0ST67,B1XJG0,A0A1T4Y3A2,A0A2G9DT08,Q9L1X1,A0A496APJ8,A0A1A5X8H4,A0A1R3T9N6,A0A0Q2M2Z1,D3S0S6,I3TE64,A0LL61,A0A139WY18,A0A1V4CHV0,A0A0C5JKF3,A5D4D9,A0A432MEQ5,A0A4R3EV39,A0A1P8WP90,A0A222F7P0,A0A329TD61,A0A101R2A0,A0A1U9ND56,A0A4R7BQC4,E0TGY3,A0A259TUP4,F6EYI8,A0A2S9Q9J0,A0A4Q2UIU6,A0A1H0LH25,A0A318LG42,A0A1W2A082,A0A2R5G167,B7K585,F8D8G0,A0A1I0NI68,,",366,37
"4","N.S11.11","N.S12.3",109,63,46,1.44685990338164,"4F1N,4KRE,5GUH,5VM9,6OON,7KX7,T1H8B3,S4RWI0,Q1K660,R9ACY5,D3BMP8,A0A1U7LLR0,A0A158P1R9,E3KLI3,B7Q5I1,D5GGK8,S8ANP9,L2GMR6,U4LBG4,O74957,A0A3N4IGK1,A6N7Y9,T1KZ60,A0A2G8JLH3,Q5KAT1,W2T741,A0A1W0E4B5,A0A2J7QB22,S4RYE2,A0A388KES6,A0A3S3PD82,A0A1S3J512,A0A1J1HRI1,C4V9J2,Q9JMB7,A0A401PRI6,Q96J94,A0A2B4RHN2,K7ISV0,H3HCL6,E9FUN9,A0A1S3CYL5,A0A1Y1YHC8,A0A4D8YSQ3,A0A158PJG6,J9JZ66,A0A158QZT6,A0A2K1J482,O04379,A0A371I3C8,M8AEW7,A0A2K3NY65,W4YU94,X1WG39,A0A0D8XL16,A0A016WPN3,G5EES3,A0A0K0EFP6,A0A0B2UV00,M7BCJ9,A0A498N3A3,A0A3M0IQP5,F6YK55,5I4A,7R8K,A0A2S7WBN3,A0A420DFE6,A0A4V1VDY2,A0A368P5I0,C4L1M1,A0A1M5ZSR3,A0A0K8QX04,A0A1I3LMA1,B1XJG0,A0A0B0H9B4,B7GJX9,A0A235B542,A0A1H3LE92,H0HWQ5,A0A317EJY3,A0A1I2BD20,A0A1I2T6Q1,D3S0S6,A0A2D1U4H7,A0A239JE83,A0A0Q0ZC47,A0A1V4CHV0,A0A1N6LUI7,E0UCX3,B9LVW4,R5NJJ8,A5D4D9,A0A142Y7A9,A0A4R7BQC4,A0A4Q2UIU6,H1YCU5,A0A345E7N0,A0A0C1XUA0,A0A1H2RBI2,A0A1C3ZXN2,W0JW77,A0A343TL88,A0A3P3RGE5,A0A0W1S8B8,A0A1V4C8L7,L9VRQ2,E4NRV1,A0A1I6HGN0,A0A1I0NI68,,",366,37
"5","C.H5.15","C.S6.1",187,64,123,1.82742632113821,"4F1N,7SWF,J9D5G4,Q389P5,C4LVV2,A8BCK6,A0A0G4H2S4,D2VMG4,A0A074TLL7,F4PH46,Q54G64,S7WCF7,R7QGN7,C1DZY0,A0A2C5Z0M1,A0CB11,R9ACY5,W7XD45,A0A1U7LLR0,V6R0U9,G4N9J3,B7Q5I1,A0A1E3QC61,L2GMR6,U4LBG4,O74957,A6N7Y9,T1KZ60,A0A250WXN5,Q5KAT1,L2GUF2,A0A1W0E4B5,A0A2J7QB22,S4RYE2,A0A2K3CW87,A0A388KES6,A0A3S3PD82,A0A1S3J512,G0QTT2,C4V9J2,Q9JMB7,A0A075AN09,A0A401PRI6,Q96J94,A0A2B4RHN2,G2QEV0,K7ISV0,H3HCL6,A0A1S3CYL5,A0A1D8PMK0,A0A2G5B1D8,Q5BD61,A0A4D8YSQ3,A0A074YJ47,A0A2K1J482,O04379,A0A371I3C8,M8AEW7,A0A2K3NY65,A0A409Y6G2,A7RQ46,D8SNM6,Q69VD5,A0A1Y1HWP2,1YVU,1Z26,3DLB,5AWH,5G5T,5I4A,6QZK,E8N0K8,A0A1I7IXT4,A0A2W1JZ37,A0A2S7WBN3,A0A420DFE6,E0ST67,A0A4V1VDY2,A0A368P5I0,A0A4R1RMM2,A0A1Y2RDH8,Q11QW7,A0A0M2PXX3,A0A1I3LMA1,A0A1C0UUC4,A0A2U2J9E0,B1XJG0,A0A326U7G5,A0A3D8L290,H1KXR6,A0A1Q4R485,A0A097QRL6,A0A0B0H9B4,A0YYT3,R6KUL9,A0A1Z4L0A1,B0JXD6,A0A1Z4K1Y3,A0A1N6SSK9,A0A1J0AGK2,A0A2G9DT08,Q9L1X1,R5XQK4,A0A1H3LE92,A0A1V9G9U4,S7VLM7,A0A1A5X8H4,A0A1I2T6Q1,A0A1R3T9N6,A0A0Q2M2Z1,H8KXJ0,D3S0S6,A0A2D1U4H7,A0A0B7I4Z6,A0LL61,A0A1J1EK56,A0A4Q6XKV6,A0A239JE83,A0A2N4XBY2,Q53W94,R5JEI2,A0A0Q0ZC47,A0A2T0XH18,A0A1V4CHV0,A0A1K1RQP7,A0A1N6LUI7,A0A0P0NGR6,A0A1X7IML5,A0A0A2LKJ7,K1L112,A0A0U3AL92,A0A1H3A054,E0UCX3,B9LVW4,A0A0C5JKF3,R5NJJ8,A5D4D9,A0A142Y7A9,A0A432MEQ5,A0A372DKU2,C1F5Q7,A0A4R3EV39,A0A1C9VH88,A0A2T2YMB1,A0A329TD61,A0A101R2A0,A0A1E3XF49,A0A1U9ND56,A0A4R7BQC4,A0A1Q1FPH0,A0A259TUP4,F6EYI8,A0A2S9Q9J0,A0A4Q2UIU6,A0A1H0LH25,A0A318LG42,H1YCU5,L0JS08,A0A1Q5ZS75,A0A345E7N0,M0AF24,A0A1W2A082,A0A1H3X247,A0A0C1XUA0,M0D2X3,A0A2R5G167,A0A346PK63,R7RTW6,A0A1H2RBI2,A0A1C3ZXN2,M5RSF0,W0JW77,B7K585,F8D8G0,A0A343TL88,L0AJX6,A0A2A5QS34,A0A343JEE2,A0A3P3RGE5,A0A329TBQ3,A0A285N2A8,A0A0W1S8B8,A0A1V4C8L7,L9VRQ2,E4NRV1,A0A1I6HGN0,A0A1I0NI68,,",366,37
"9","N.H4.2","N.H5.12",116,65,51,1.37088989441931,"4KRE,5VM9,6OON,J9D5G4,C4LVV2,S4RWI0,D2VMG4,S7WCF7,I0YVB2,C1DZY0,A0A2C5Z0M1,A0A1Z5TVE5,W7XD45,A0A4S2MWZ7,K1VVQ6,A0A158P1R9,A0A1E3QC61,L2GMR6,A0A177URI1,A6N7Y9,A0A2G8JLH3,Q5KAT1,L2GUF2,A0A226EFL3,A0A1S3J512,G0QTT2,A0A1J1HRI1,Q9JMB7,A0A075AN09,A0A401PRI6,Q96J94,A0A1S3CYL5,F4S231,A0A1D8PMK0,A0A2G5B1D8,A0A165QYQ9,T0SAU8,A0A3S1A0C3,A8P0D4,A0A409Y6G2,A7BJS5,Q9QZ81,Q8CJG0,V2WTL2,A0A139WDH0,A0A0R3W9Q7,B7QCC4,E9GN30,A0A077Z361,R7U9I3,A0A1X7V1N5,A0A0L8GBV4,Q32KD4,E0W4C3,A0A482XDA9,A0A3P7EJD6,J9K2Z4,T1IBM6,V3ZRX0,A0A1D2N447,A0A226D7A9,T1KTE4,A0A2C9JGZ6,A0A3Q0KUG5,T1FY40,5AWH,6QZK,A0A0M2PXX3,A0A1I3LMA1,A0A142XB92,R6KUL9,R5XQK4,A0A496APJ8,A0A062U2W9,H0HWQ5,A0A1V9G9U4,A0A1I2BD20,F8ERC7,S7VLM7,A0A1I2T6Q1,A0A0B7I4Z6,A0LL61,A0A4Q6XKV6,A0A2N4XBY2,R5JEI2,A0A0Q0ZC47,A0A2T0XH18,A0A1V4CHV0,A0A1K1RQP7,A0A0P0NGR6,A0A1X7IML5,A0A0A2LKJ7,K1L112,A0A0U3AL92,A0A1H3A054,A0A0C5JKF3,A0A142Y7A9,A0A432MEQ5,A0A372DKU2,A0A1P8WP90,A0A222F7P0,A0A1C9VH88,A0A2T2YMB1,A0A1E3XF49,A0A4Q2UIU6,H1YCU5,A0A1Q5ZS75,M0AF24,A0A0C1XUA0,M0D2X3,A0A2R5G167,A0A1H2RBI2,A0A1C3ZXN2,B9LVP8,B7K585,A0A343JEE2,,",366,37
"11","N.L11.6","N.S11.3",167,65,102,2.75814479638009,"7KX7,T1H8B3,F4PH46,Q54G64,S7WCF7,R7QGN7,D3BMP8,W7XD45,A0A4S2MWZ7,A0A158P1R9,E3KLI3,B7Q5I1,A0A1E3QC61,D5GGK8,S8ANP9,L2GMR6,U4LBG4,A0A3N4IGK1,A6N7Y9,A0A0E9NDK5,T1KZ60,A0A250WXN5,A0A2G8JLH3,L2GUF2,A0A1W0E4B5,A0A2J7QB22,S4RYE2,A0A2K3CW87,A0A388KES6,A0A226EFL3,A0A3S3PD82,A0A1S3J512,A0A1J1HRI1,Q9JMB7,Q5TW24,A0A401PRI6,Q96J94,A0A2B4RHN2,A0A397UU01,K7ISV0,A0A024FT57,H3HCL6,A0A0G4IME3,E9FUN9,A0A1S3CYL5,A0A1Y1YHC8,F4S231,A0A1D8PMK0,A0A2G5B1D8,Q5BD61,J9JZ66,A0A0C2XG51,A0A165QYQ9,T0SAU8,A0A1Q3ENA6,A8P0D4,F4NYW7,A0A409Y6G2,A0A0L0HAB7,A0A1J8PPA3,M5FQK2,A0A2R6NSC2,V2WTL2,G4T5G9,K5X5Z7,1Z26,3DLB,5AWH,5G5T,5I4A,7R8K,A0A1T4Y3A2,A0A2G9DT08,Q9L1X1,A0A1H3LE92,A0A496APJ8,A0A062U2W9,H0HWQ5,A0A1V9G9U4,A0A1I2ZGP1,A0A317EJY3,A0A1I2BD20,F8ERC7,S7VLM7,A0A1A5X8H4,A0A1I2T6Q1,A0A1R3T9N6,A0A0Q2M2Z1,H8KXJ0,A0A2D1U4H7,A0A0B7I4Z6,A0LL61,A0A139WY18,A0A1J1EK56,A0A2T1E1K4,A0A1Q8ZD62,A0A4Q6XKV6,A0A1Z3HNN4,A0A239JE83,A0A2N4XBY2,Q53W94,R5JEI2,A0A0Q0ZC47,A0A2T0XH18,A0A1V4CHV0,A0A1K1RQP7,A0A0P0NGR6,A0A1X7IML5,A0A0A2LKJ7,K1L112,A0A0U3AL92,A0A1H3A054,E0UCX3,B9LVW4,A0A0C1VHB4,A0A0C5JKF3,A5D4D9,A0A142Y7A9,A0A432MEQ5,A0A372DKU2,A0A4R3EV39,A0A1P8WP90,A0A222F7P0,A0A1C9VH88,A0A2T2YMB1,A0A329TD61,A0A101R2A0,A0A1E3XF49,A0A1U9ND56,A0A4R7BQC4,A0A1Q1FPH0,E0TGY3,A0A259TUP4,F6EYI8,A0A2S9Q9J0,A0A4Q2UIU6,A0A1H0LH25,A0A318LG42,H1YCU5,L0JS08,A0A1Q5ZS75,A0A345E7N0,M0AF24,A0A1W2A082,A0A1H3X247,M0D2X3,A0A2R5G167,A0A346PK63,A0A1H2RBI2,A0A1C3ZXN2,B9LVP8,M5RSF0,W0JW77,B7K585,F8D8G0,A0A343TL88,L0AJX6,A0A2A5QS34,A0A3P3RGE5,A0A329TBQ3,A0A285N2A8,A0A0W1S8B8,A0A1V4C8L7,L9VRQ2,E4NRV1,A0A1I6HGN0,A0A1I0NI68,,",366,37
"16","C.H3.3","C.S5.6",135,67,68,1.40572870939421,"4F3T,4KRE,5VM9,6OON,7KX7,C4LVV2,S4RWI0,D2VMG4,A0A074TLL7,A0A3M7S814,A0A158P1R9,G7DVX0,E3KLI3,B7Q5I1,A0A177URI1,W2T741,A0A1W0E4B5,A0A388KES6,A0A075AN09,U5HIG6,A0A2B4RHN2,A0A2T7PFL8,A0A1S3CYL5,A0A2G5B1D8,A0A3S1A0C3,M8AEW7,A0A1D1W4K0,W4YU94,A7BJS5,A0A1J8PPA3,X1WG39,A0A016WPN3,Q9QZ81,G5EES3,A0A0K0EFP6,Q8CJG0,A0A1D5NTU6,A0A0V0YLH8,A0A139WDH0,B7QCC4,A0A0B2UV00,M7BCJ9,E9GN30,Q7PZ41,A0A077Z361,R7U9I3,A0A0K0JDP1,A0A0N4UKJ1,A0A498N3A3,A0A3M0IQP5,A0A0L8GBV4,Q32KD4,A0A1J1JBJ0,E0W4C3,A0A482XDA9,J9K2Z4,A0A2J7Q8V4,T1IBM6,V3ZRX0,A0A210QKF7,A0A423TSS1,A0A267E8R7,A0A1D2N447,T1KTE4,A0A2C9JGZ6,A0A1V9X9F0,T1FY40,1Z26,6QZK,E8N0K8,A0A328VKE4,E0ST67,K9TPA9,A0A142XB92,A0A326U7G5,A0A1Q4R485,K9U8J6,K9RC91,A0A0D8ZUC0,A0A139XGN8,A0A1T4Y3A2,A0YYT3,A0A2T1EFY0,G6FTN0,A0A433NB65,A0A1Z4L0A1,A0A2T1G8M7,K9VUN0,A0A0P6X5X2,K9ZDE3,B0JXD6,A0A2T1LS63,A0A1Z4K1Y3,A0A0P4UVI8,A0A1J0AGK2,K9PFF9,A0A496APJ8,A0A062U2W9,H0HWQ5,A0A1V9G9U4,A0A1I2ZGP1,A0A317EJY3,F8ERC7,S7VLM7,I3TE64,A0A0B7I4Z6,A0A139WY18,A0A2T1E1K4,A0A1Q8ZD62,A0A4Q6XKV6,A0A239JE83,A0A2N4XBY2,R5JEI2,A0A2T0XH18,A0A1K1RQP7,A0A1X7IML5,A0A0A2LKJ7,K1L112,Q31N05,R5NJJ8,A0A432MEQ5,A0A3R7KLK4,A0A2T2YMB1,E0TGY3,A0A2S9Q9J0,A0A4Q2UIU6,A0A1H3X247,A0A2R5G167,B9LVP8,M5RSF0,W0JW77,L0AJX6,A0A2A5QS34,A0A343JEE2,A0A285N2A8,,",366,37
"18","C.L2.1","C.S2.2",125,67,58,1.33826556870818,"4KRE,5GUH,6OON,A0A0N4X8S8,Q389P5,T1H8B3,I0YVB2,C1DZY0,A0A1U7LLR0,E3KLI3,A0A139AUH8,W2T741,A0A2J7QB22,A0A388KES6,A0A1J1HRI1,C4V9J2,A0A075AN09,G2QEV0,A0A397UU01,A0A2T7PFL8,A0A0G4IME3,A0A1Y1YHC8,T1GSU4,F4S231,Q5BD61,A0A1C7M8P2,A0A4D8YSQ3,A0A158PJG6,A0A158QZT6,A0A165QYQ9,A0A2K1J482,A0A1Q3ENA6,M8AEW7,A8P0D4,A0A409Y6G2,D8PZT7,A7BJS5,A0A1J8PPA3,X1WG39,A0A2R6NSC2,A0A0D8XL16,A0A016WPN3,G5EES3,A0A0K0EFP6,V2WTL2,A0A0V0YLH8,A0A139WDH0,H3DS31,A0A1Y1HWP2,A0A0B2UV00,M7BCJ9,Q7PZ41,R7U9I3,A0A0K0JDP1,A0A0N4UKJ1,A0A3M0IQP5,A0A0L8GBV4,Q32KD4,A0A1J1JBJ0,E0W4C3,J9K2Z4,A0A2J7Q8V4,V3ZRX0,K1PT78,A0A2C9JGZ6,A0A1V9X9F0,T1FY40,5G5T,6QZK,E0ST67,A0A1T4Y3A2,A0A2G9DT08,Q9L1X1,A0A1A5X8H4,A0A1I2T6Q1,A0A1R3T9N6,A0LL61,A0A1V4CHV0,A0A2T1EKT1,A0A0U3AL92,A0A1H3A054,E0UCX3,K9XZC6,Q31N05,A0A0C5JKF3,A5D4D9,A0A142Y7A9,A0A432MEQ5,A0A372DKU2,A0A4R3EV39,A0A1P8WP90,A0A222F7P0,A0A1C9VH88,A0A101R2A0,A0A1U9ND56,A0A4R7BQC4,A0A1Q1FPH0,E0TGY3,A0A2S9Q9J0,A0A4Q2UIU6,A0A1H0LH25,A0A318LG42,H1YCU5,L0JS08,A0A1Q5ZS75,A0A345E7N0,M0AF24,A0A1W2A082,A0A1H3X247,M0D2X3,A0A346PK63,R7RTW6,A0A1H2RBI2,A0A1C3ZXN2,B9LVP8,M5RSF0,W0JW77,F8D8G0,L0AJX6,A0A2A5QS34,A0A343JEE2,A0A3P3RGE5,A0A285N2A8,A0A1V4C8L7,A0A1I0NI68,,",366,37
"19","C.L20.6","C.L23.9",139,67,72,1.6532960199005,"4F1N,4KRE,5GUH,5VM9,6KR6,6OON,7KX7,A0A163JTZ6,A0A2P6N8X7,A8BCK6,A0A0G4H2S4,R1FDF0,D2VMG4,A0A0D1ZAJ4,Q1K660,F4PH46,A0A164ZA52,A0A383WDW5,Q54G64,S7WCF7,R7QGN7,A0A2C5Z0M1,A0CB11,R9ACY5,D3BMP8,W7XD45,A0A1U7LLR0,A0A4S2MWZ7,A0A158P1R9,V6R0U9,G4N9J3,B7Q5I1,U4LBG4,O74957,A0A3N4IGK1,A0A250WXN5,A0A2G8JLH3,A0A2J7QB22,S4RYE2,A0A2K3CW87,A0A388KES6,A0A3S3PD82,A0A0L0TEV1,A0A1S3J512,A0A1J1HRI1,A0A075AN09,Q5TW24,A0A2B4RHN2,G2QEV0,K7ISV0,A0A024FT57,H3HCL6,E9FUN9,A0A1S3CYL5,Q5BD61,J9JZ66,R7YY92,A0A074YJ47,A8P0D4,F4NYW7,A0A0L0HAB7,D8PZT7,M5FQK2,A0A2R6NSC2,V2WTL2,A0A482XDA9,K5X5Z7,1YVU,1Z26,3DLB,5G5T,5I4A,A0A328VKE4,E0ST67,C4L1M1,A0A0M2PXX3,K9TPA9,A0A1C0UUC4,A0A2Z6E1D5,A0A142XB92,A0A326U7G5,A0A3D8L290,A0A1Q4R485,K9U8J6,A0A097QRL6,K9RC91,A0A0D8ZUC0,A0A139XGN8,A0A0B0H9B4,A0YYT3,G6FTN0,R6KUL9,A0A433NB65,A0A1Z4L0A1,K9UQR0,A0A2T1G8M7,K9VUN0,B7GJX9,B0JXD6,A0A2T1LS63,A0A1Z4K1Y3,A0A0P4UVI8,A0A0V7ZCG4,K9PFF9,K9UEV4,A0A235B542,R5XQK4,A0A496APJ8,Q8DKB1,A0A1Z3HNN4,Q53W94,E0UCX3,K9XZC6,R5NJJ8,Q2JI93,A0A432MEQ5,A0A3R7KLK4,A0A329TD61,A0A1H3DGN3,A0A1Q1FPH0,L0JS08,A0A345E7N0,M0AF24,A0A1H3X247,M0D2X3,A0A346PK63,W0JW77,F8D8G0,A0A343TL88,A0A343JEE2,A0A3P3RGE5,A0A329TBQ3,A0A285N2A8,A0A0W1S8B8,A0A1V4C8L7,L9VRQ2,E4NRV1,A0A1I6HGN0,A0A1I0NI68,,",366,37
"24","C.H9.11","C.S7.2",166,68,98,2.11104441776711,"4F1N,4F3T,6KR6,6OON,7SWF,A0A163JTZ6,Q389P5,A0A0G4H2S4,D2VMG4,A0A0D1ZAJ4,Q1K660,F4PH46,A0A164ZA52,Q54G64,I0YVB2,R7QGN7,A0A2C5Z0M1,R9ACY5,D3BMP8,A0A1Z5TVE5,W7XD45,A0A1U7LLR0,A0A4S2MWZ7,A0A158P1R9,V6R0U9,G4N9J3,B7Q5I1,A0A1E3QC61,D5GGK8,S8ANP9,A0A139AUH8,L2GMR6,U4LBG4,O74957,A0A3N4IGK1,A0A0E9NDK5,T1KZ60,A0A250WXN5,L2GUF2,A0A1W0E4B5,A0A388KES6,A0A226EFL3,A0A0L0TEV1,A0A1J1HRI1,C4V9J2,U5HIG6,A0A397UU01,H3HCL6,A0A0G4IME3,A0A1S3CYL5,A0A1Y1YHC8,A0A1D8PMK0,A0A2G5B1D8,A0A1C7M8P2,J9JZ66,T0SAU8,A8P0D4,F4NYW7,A0A409Y6G2,A0A0L0HAB7,D8PZT7,D8SNM6,A0A2R6NSC2,V2WTL2,A0A1Y1HWP2,F6YK55,K5X5Z7,A0A3Q0KUG5,1Z26,5G5T,5I4A,6QZK,A0A1I7IXT4,A0A2W1JZ37,A0A2S7WBN3,A0A328VKE4,A0A420DFE6,E0ST67,A0A4V1VDY2,A0A368P5I0,A0A4R1RMM2,A0A1Y2RDH8,Q11QW7,A0A1M5ZSR3,A0A0K8QX04,A0A1L3JHM3,A0A1W6MIP2,A0A2U2J9E0,A0A326U7G5,A0A3D8L290,A0A097QRL6,A0A1T4Y3A2,B6YTQ5,A0A1N6SSK9,A0A2G9DT08,Q9L1X1,A0A060HNJ0,A0A062U2W9,A0A317EJY3,S7VLM7,A0A1A5X8H4,A0A1R3T9N6,H8KXJ0,D3S0S6,A0A2D1U4H7,I3TE64,A0A0B7I4Z6,A0A1J1EK56,A0A4Q6XKV6,A0A239JE83,A0A2N4XBY2,Q53W94,R5JEI2,A0A0Q0ZC47,A0A2T0XH18,A0A1K1RQP7,A0A2T1EKT1,A0A1N6LUI7,A0A0P0NGR6,A0A1X7IML5,A0A0A2LKJ7,K1L112,A0A0U3AL92,A0A1H3A054,E0UCX3,K9XZC6,B9LVW4,A0A0C1VHB4,A0A0C5JKF3,R5NJJ8,A5D4D9,Q2JI93,A0A142Y7A9,A0A372DKU2,A0A3R7KLK4,C1F5Q7,A0A4R3EV39,A0A1C9VH88,A0A2T2YMB1,A0A329TD61,A0A101R2A0,A0A1E3XF49,A0A1H3DGN3,E0TGY3,A0A259TUP4,F6EYI8,A0A2S9Q9J0,A0A1H0LH25,A0A318LG42,M0AF24,A0A0C1XUA0,M0D2X3,A0A2R5G167,A0A346PK63,B7K585,F8D8G0,A0A343TL88,A0A2A5QS34,A0A3P3RGE5,A0A329TBQ3,A0A0W1S8B8,A0A1V4C8L7,L9VRQ2,E4NRV1,A0A1I6HGN0,A0A1I0NI68,,",366,37
"25","C.L9.1","C.L9.3",186,68,118,1.15453639082752,"4F1N,4F3T,7SWF,A0A0N4X8S8,A0A2P6N8X7,A2DPV7,Q1K660,A0A164ZA52,S7WCF7,I0YVB2,R7QGN7,A0A2C5Z0M1,A0A1U7LLR0,A0A4S2MWZ7,V6R0U9,A0A1E3QC61,A0A139AUH8,U4LBG4,O74957,A0A3N4IGK1,A0A0E9NDK5,A0A250WXN5,L2GUF2,A0A2K3CW87,A0A388KES6,A0A0L0TEV1,A0A1J1HRI1,A0A075AN09,G2QEV0,K7ISV0,A0A0G4IME3,E9FUN9,D7FQK3,A0A1Y1YHC8,A0A2G5B1D8,A0A1C7M8P2,A0A4D8YSQ3,A0A158PJG6,A0A0C2XG51,T0SAU8,A0A2K1J482,A0A1Q3ENA6,O04379,A0A371I3C8,M8AEW7,A0A2K3NY65,A0A409Y6G2,D8PZT7,A0A1D1W4K0,A7RQ46,D8SNM6,M5FQK2,Q69VD5,A0A2R6NSC2,Q9QZ81,Q8CJG0,V2WTL2,A0A1Y1HWP2,M7BCJ9,A0A1X7V1N5,A0A3M0IQP5,A0A1J1JBJ0,A0A482XDA9,T1IBM6,A0A423TSS1,A0A1D2N447,A0A1V9X9F0,K5X5Z7,1Z26,5AWH,5G5T,E8N0K8,A0A328VKE4,K9TPA9,A0A2Z6E1D5,A0A0F4NXW8,L8D0R3,A0A326U7G5,A0A1Q4R485,K9U8J6,A0A097QRL6,K9RC91,A0A0D8ZUC0,A0A139XGN8,A0A1T4Y3A2,Q5P0R2,B6YTQ5,A0YYT3,A0A2T1EFY0,G6FTN0,A0A433NB65,A0A1Z4L0A1,K9UQR0,A0A2T1G8M7,K9VUN0,K9ZDE3,B0JXD6,A0A2T1LS63,A0A1Z4K1Y3,A0A2Z6E0R7,A0A0P4UVI8,A0A0V7ZCG4,A0A1J0AGK2,K9PFF9,A0A2G9DT08,K9UEV4,Q9L1X1,A0A1H3LE92,A0A496APJ8,A0A1V9G9U4,F8ERC7,S7VLM7,A0A1A5X8H4,A0A1I2T6Q1,A0A1R3T9N6,A0A0Q2M2Z1,H8KXJ0,A0A2D1U4H7,I3TE64,A0A0B7I4Z6,A0LL61,A0A139WY18,A0A2T1E1K4,A0A1Q8ZD62,A0A4Q6XKV6,A0A1Z3HNN4,A0A239JE83,A0A2N4XBY2,R5JEI2,A0A0Q0ZC47,A0A2T0XH18,A0A1V4CHV0,A0A1K1RQP7,A0A1N6LUI7,A0A0P0NGR6,A0A1X7IML5,A0A0A2LKJ7,K1L112,A0A0U3AL92,A0A1H3A054,B9LVW4,A0A0C5JKF3,R5NJJ8,A5D4D9,A0A142Y7A9,A0A432MEQ5,A0A372DKU2,C1F5Q7,A0A4R3EV39,A0A1P8WP90,A0A222F7P0,A0A1C9VH88,A0A2T2YMB1,A0A101R2A0,A0A1U9ND56,A0A4R7BQC4,E0TGY3,A0A259TUP4,F6EYI8,A0A2S9Q9J0,A0A4Q2UIU6,A0A1H0LH25,A0A318LG42,L0JS08,M0AF24,M0D2X3,A0A2R5G167,A0A346PK63,R7RTW6,M5RSF0,W0JW77,B7K585,F8D8G0,A0A343TL88,L0AJX6,A0A2A5QS34,A0A343JEE2,A0A3P3RGE5,A0A329TBQ3,A0A285N2A8,A0A0W1S8B8,A0A1V4C8L7,L9VRQ2,E4NRV1,A0A1I6HGN0,A0A1I0NI68,,",366,37
"26","N.H8.9","N.S2.2",124,68,56,1.70850840336134,"5GUH,6OON,7KX7,7SWF,A0A2P6N8X7,A8BCK6,A2DPV7,A0A0G4H2S4,T1H8B3,D2VMG4,Q1K660,Q54G64,A0CB11,A0A1U7LLR0,A0A4S2MWZ7,K1VVQ6,E3KLI3,D5GGK8,S8ANP9,A0A177URI1,A6N7Y9,A0A0E9NDK5,T1KZ60,A0A1W0E4B5,A0A2J7QB22,S4RYE2,A0A388KES6,A0A226EFL3,A0A3S3PD82,A0A1S3J512,A0A1J1HRI1,Q9JMB7,Q5TW24,Q96J94,G2QEV0,K7ISV0,A0A0G4IME3,E9FUN9,A0A1Y1YHC8,F4S231,A0A1D8PMK0,A0A1C7M8P2,A0A4D8YSQ3,R7YY92,A0A3S1A0C3,O04379,A0A371I3C8,M8AEW7,A8P0D4,A0A0L0HAB7,D8PZT7,A0A1J8PPA3,M5FQK2,Q69VD5,A0A2R6NSC2,G5EES3,A0A0K0EFP6,A0A1D5NTU6,V2WTL2,A0A0V0YLH8,G4T5G9,A0A0B2UV00,A0A0K0JDP1,A0A498N3A3,A0A0L8GBV4,T1KTE4,A0A2C9JGZ6,K5X5Z7,1YVU,5AWH,5G5T,7R8K,H0HWQ5,A0A317EJY3,F8ERC7,S7VLM7,H8KXJ0,A0A2D1U4H7,A0A0B7I4Z6,Q8DKB1,A0A1J1EK56,A0A4Q6XKV6,A0A239JE83,A0A2N4XBY2,Q53W94,R5JEI2,A0A2T0XH18,A0A1K1RQP7,A0A2T1EKT1,A0A0P0NGR6,A0A1X7IML5,A0A0A2LKJ7,A0A0U3AL92,A0A1H3A054,E0UCX3,K9XZC6,A0A0C1VHB4,Q31N05,A0A0C5JKF3,R5NJJ8,Q2JI93,A0A372DKU2,A0A1C9VH88,A0A2T2YMB1,A0A329TD61,A0A1Q1FPH0,H1YCU5,L0JS08,A0A1Q5ZS75,M0D2X3,A0A2R5G167,A0A1C3ZXN2,M5RSF0,W0JW77,B7K585,A0A343TL88,A0A343JEE2,A0A3P3RGE5,A0A329TBQ3,A0A285N2A8,A0A0W1S8B8,L9VRQ2,E4NRV1,A0A1I6HGN0,,",366,37
"27","C.H10.6","C.S9.6",137,69,68,1.97389173060529,"5VM9,6KR6,6OON,7SWF,A0A163JTZ6,J9D5G4,A8BCK6,A2DPV7,A0A0G4H2S4,D2VMG4,A0A074TLL7,A0A0D1ZAJ4,Q1K660,F4PH46,A0A164ZA52,A0A383WDW5,A0A2C5Z0M1,A0CB11,R9ACY5,D3BMP8,A0A1Z5TVE5,W7XD45,A0A1U7LLR0,A0A4S2MWZ7,K1VVQ6,G7DVX0,V6R0U9,G4N9J3,A0A1E3QC61,D5GGK8,S8ANP9,A0A139AUH8,U4LBG4,A0A177URI1,O74957,A0A3N4IGK1,A0A0E9NDK5,T1KZ60,S4RYE2,A0A2K3CW87,A0A226EFL3,A0A1S3J512,G0QTT2,C4V9J2,Q9JMB7,Q5TW24,U5HIG6,Q96J94,A0A397UU01,K7ISV0,A0A024FT57,H3HCL6,E9FUN9,A0A1S3CYL5,D7FQK3,Q5BD61,A0A0C2XG51,A0A165QYQ9,R7YY92,A0A3S1A0C3,A0A074YJ47,A0A1Q3ENA6,A8P0D4,A0A409Y6G2,A0A1J8PPA3,V2WTL2,G4T5G9,A0A1X7V1N5,K5X5Z7,1Z26,5AWH,5I4A,7R8K,A0A2S7WBN3,A0A420DFE6,A0A4V1VDY2,A0A368P5I0,A0A4R1RMM2,A0A1Y2RDH8,Q11QW7,A0A2Z6E1D5,B1XJG0,A0A3D8L290,A0A097QRL6,K9RC91,A0A0D8ZUC0,A0A139XGN8,B6YTQ5,K9UQR0,K9ZDE3,A0A1Z4K1Y3,A0A2Z6E0R7,A0A0V7ZCG4,A0A1J0AGK2,K9UEV4,A0A1H3LE92,A0A062U2W9,F8ERC7,A0A1R3T9N6,A0A0Q2M2Z1,D3S0S6,I3TE64,A0LL61,Q8DKB1,A0A1J1EK56,Q53W94,A0A2T1EKT1,A0A1X7IML5,E0UCX3,K9XZC6,A0A0C1VHB4,Q31N05,A0A0C5JKF3,Q2JI93,A0A1C9VH88,A0A329TD61,L0JS08,M0AF24,A0A1H3X247,A0A0C1XUA0,M0D2X3,A0A346PK63,A0A1H2RBI2,W0JW77,F8D8G0,A0A343TL88,L0AJX6,A0A2A5QS34,A0A3P3RGE5,A0A329TBQ3,A0A285N2A8,A0A0W1S8B8,A0A1V4C8L7,L9VRQ2,E4NRV1,A0A1I6HGN0,A0A1I0NI68,,",366,37
"30","C.L4.1","C.L8.1",118,69,49,2.28852410529429,"4F1N,4KRE,5VM9,6OON,7SWF,J9D5G4,S4RWI0,A0A0D1ZAJ4,A0A164ZA52,S7WCF7,R7QGN7,A0A1Z5TVE5,G7DVX0,A0A1E3QC61,L2GMR6,A6N7Y9,A0A0E9NDK5,A0A2G8JLH3,A0A1W0E4B5,A0A2K3CW87,C4V9J2,Q9JMB7,A0A075AN09,Q5TW24,Q96J94,A0A2B4RHN2,G2QEV0,A0A397UU01,A0A024FT57,H3HCL6,D7FQK3,A0A1Y1YHC8,A0A1D8PMK0,A0A2G5B1D8,Q5BD61,A0A4D8YSQ3,A0A0C2XG51,T0SAU8,R7YY92,A0A2K1J482,A0A1Q3ENA6,O04379,A0A371I3C8,M8AEW7,A8P0D4,A0A2K3NY65,F4NYW7,D8PZT7,A7BJS5,A0A1J8PPA3,A0A2R6NSC2,A0A1D5NTU6,V2WTL2,A0A139WDH0,A0A0R3W9Q7,H3DS31,B7QCC4,E9GN30,A0A1X7V1N5,A0A0N4UKJ1,A0A1J1JBJ0,A0A3P7EJD6,A0A210QKF7,K1PT78,A0A226D7A9,F6YK55,A0A2C9JGZ6,A0A1V9X9F0,K5X5Z7,1YVU,1Z26,5AWH,5G5T,5I4A,7R8K,E8N0K8,A0A328VKE4,A0A1Y2RDH8,K9TPA9,A0A1Q4R485,K9U8J6,K9RC91,A0A0D8ZUC0,A0A139XGN8,A0A1T4Y3A2,A0A2T1EFY0,R6KUL9,A0A2T1G8M7,A0A2T1LS63,A0A1N6SSK9,A0A0V7ZCG4,A0A1J0AGK2,K9UEV4,A0A060HNJ0,R5XQK4,A0A062U2W9,A0A1A5X8H4,A0A1R3T9N6,A0A0Q2M2Z1,A0LL61,A0A1J1EK56,Q53W94,A0A1V4CHV0,A0A2T1EKT1,A5D4D9,A0A142Y7A9,A0A4R3EV39,A0A222F7P0,A0A1U9ND56,A0A4R7BQC4,E0TGY3,A0A259TUP4,F6EYI8,A0A2S9Q9J0,A0A4Q2UIU6,H1YCU5,A0A1Q5ZS75,A0A1H3X247,,",366,37
"32","N.H8.5","N.L24.1",122,69,53,2.05892808312825,"4F1N,5GUH,5VM9,6KR6,7KX7,A0A0N4X8S8,A0A2P6N8X7,A8BCK6,T1H8B3,D2VMG4,A0A0D1ZAJ4,F4PH46,Q54G64,I0YVB2,R7QGN7,A0A2C5Z0M1,A0CB11,R9ACY5,D3BMP8,A0A1Z5TVE5,A0A4S2MWZ7,A0A158P1R9,G7DVX0,V6R0U9,E3KLI3,D5GGK8,S8ANP9,O74957,A0A3N4IGK1,A6N7Y9,A0A0E9NDK5,T1KZ60,A0A2G8JLH3,S4RYE2,A0A1S3J512,A0A1J1HRI1,Q5TW24,U5HIG6,A0A2B4RHN2,G2QEV0,K7ISV0,A0A024FT57,H3HCL6,E9FUN9,A0A1S3CYL5,D7FQK3,F4S231,A0A1D8PMK0,Q5BD61,A0A1C7M8P2,A0A4D8YSQ3,J9JZ66,A0A0C2XG51,T0SAU8,R7YY92,A0A074YJ47,A0A2K1J482,A0A1Q3ENA6,A8P0D4,A0A2K3NY65,F4NYW7,A0A409Y6G2,A0A1J8PPA3,M5FQK2,A0A2R6NSC2,V2WTL2,A0A1Y1HWP2,G4T5G9,K5X5Z7,1YVU,1Z26,3DLB,6QZK,7R8K,A0A1I3LMA1,A0A3D8L290,A0A0B0H9B4,R6KUL9,B7GJX9,A0A1N6SSK9,A0A060HNJ0,A0A235B542,R5XQK4,A0A1H3LE92,A0A1I2ZGP1,A0A317EJY3,F8ERC7,A0A0Q2M2Z1,Q8DKB1,A0A2T1EKT1,E0UCX3,K9XZC6,B9LVW4,A0A0C1VHB4,Q31N05,R5NJJ8,Q2JI93,A0A329TD61,A0A1E3XF49,A0A259TUP4,F6EYI8,A0A2S9Q9J0,L0JS08,M0AF24,M0D2X3,A0A346PK63,R7RTW6,A0A1H2RBI2,A0A1C3ZXN2,W0JW77,A0A343TL88,L0AJX6,A0A2A5QS34,A0A343JEE2,A0A3P3RGE5,A0A329TBQ3,A0A285N2A8,A0A0W1S8B8,L9VRQ2,E4NRV1,A0A1I6HGN0,A0A1I0NI68,,",366,37
"33","N.L3.1","N.S2.4",121,69,52,2.15621516164994,"4F3T,6OON,7KX7,7SWF,C4LVV2,S4RWI0,C1DZY0,A0CB11,A0A1U7LLR0,G7DVX0,V6R0U9,G4N9J3,E3KLI3,L2GMR6,O74957,T1KZ60,L2GUF2,A0A1W0E4B5,A0A226EFL3,A0A3S3PD82,A0A0L0TEV1,A0A1J1HRI1,C4V9J2,U5HIG6,G2QEV0,A0A397UU01,A0A2T7PFL8,A0A1Y1YHC8,A0A1D8PMK0,A0A2G5B1D8,Q5BD61,A0A4D8YSQ3,A0A158PJG6,A0A0C2XG51,A0A158QZT6,A0A3S1A0C3,A0A074YJ47,A0A2K1J482,O04379,A0A371I3C8,M8AEW7,F4NYW7,A0A0L0HAB7,D8PZT7,A0A1D1W4K0,A7RQ46,W4YU94,D8SNM6,Q69VD5,A0A2R6NSC2,A0A016WPN3,Q9QZ81,Q8CJG0,A0A1D5NTU6,A0A0V0YLH8,A0A0R3W9Q7,H3DS31,A0A0B2UV00,M7BCJ9,R7U9I3,A0A0K0JDP1,A0A0N4UKJ1,A0A498N3A3,A0A3M0IQP5,A0A210QKF7,K1PT78,A0A267E8R7,F6YK55,A0A2C9JGZ6,1Z26,3DLB,5AWH,7R8K,A0A326U7G5,A0A1Q4R485,A0A433NB65,K9ZDE3,F8ERC7,S7VLM7,D3S0S6,I3TE64,A0A0B7I4Z6,A0A4Q6XKV6,A0A239JE83,A0A2N4XBY2,A0A0Q0ZC47,A0A2T0XH18,A0A1K1RQP7,A0A1X7IML5,A0A0A2LKJ7,K1L112,A0A0U3AL92,A0A1H3A054,A0A0C5JKF3,R5NJJ8,A0A142Y7A9,A0A372DKU2,A0A3R7KLK4,C1F5Q7,A0A1C9VH88,A0A329TD61,A0A1E3XF49,A0A1H3DGN3,A0A1Q1FPH0,H1YCU5,L0JS08,A0A1Q5ZS75,A0A345E7N0,M0AF24,A0A1H3X247,A0A0C1XUA0,M0D2X3,R7RTW6,A0A1C3ZXN2,B9LVP8,W0JW77,F8D8G0,L0AJX6,A0A2A5QS34,A0A285N2A8,A0A1I0NI68,,",366,37
"37","C.L1.2","C.L1.4",173,71,102,1.61177851422259,"6KR6,7KX7,A0A163JTZ6,A0A196SDB4,Q389P5,A2DPV7,T1H8B3,S4RWI0,D2VMG4,A0A074TLL7,Q1K660,F4PH46,A0A164ZA52,Q54G64,S7WCF7,I0YVB2,R7QGN7,A0A1Z5TVE5,A0A1U7LLR0,A0A4S2MWZ7,K1VVQ6,A0A158P1R9,G7DVX0,V6R0U9,E3KLI3,B7Q5I1,A0A1E3QC61,D5GGK8,S8ANP9,U4LBG4,O74957,A0A3N4IGK1,A6N7Y9,A0A0E9NDK5,T1KZ60,A0A2G8JLH3,A0A2J7QB22,A0A388KES6,A0A3S3PD82,A0A1S3J512,C4V9J2,Q9JMB7,Q5TW24,U5HIG6,A0A401PRI6,Q96J94,G2QEV0,A0A397UU01,A0A2T7PFL8,K7ISV0,E9FUN9,A0A1S3CYL5,A0A1Y1YHC8,A0A1D8PMK0,A0A4D8YSQ3,J9JZ66,R7YY92,A0A074YJ47,A0A2K1J482,A8P0D4,F4NYW7,A0A0L0HAB7,D8PZT7,A7RQ46,X1WG39,A0A2R6NSC2,A0A0V0YLH8,A0A077Z361,R7U9I3,A0A2C9JGZ6,T1FY40,1Z26,5AWH,5G5T,6QZK,E8N0K8,A0A328VKE4,K9TPA9,A0A326U7G5,K9U8J6,K9RC91,A0A0D8ZUC0,A0A139XGN8,A0A1T4Y3A2,A0YYT3,A0A2T1EFY0,G6FTN0,A0A433NB65,A0A1Z4L0A1,K9UQR0,A0A2T1G8M7,K9VUN0,K9ZDE3,B0JXD6,A0A2T1LS63,A0A1Z4K1Y3,A0A0P4UVI8,A0A0V7ZCG4,A0A1J0AGK2,K9PFF9,A0A2G9DT08,K9UEV4,Q9L1X1,A0A496APJ8,A0A1V9G9U4,S7VLM7,A0A1A5X8H4,A0A1I2T6Q1,A0A1R3T9N6,H8KXJ0,D3S0S6,A0A2D1U4H7,A0A0B7I4Z6,A0A139WY18,A0A2T1E1K4,A0A1Q8ZD62,A0A4Q6XKV6,A0A1Z3HNN4,A0A239JE83,A0A2N4XBY2,R5JEI2,A0A0Q0ZC47,A0A2T0XH18,A0A1V4CHV0,A0A1K1RQP7,A0A1N6LUI7,A0A0P0NGR6,A0A1X7IML5,A0A0A2LKJ7,K1L112,A0A0U3AL92,A0A1H3A054,A0A0C5JKF3,A5D4D9,A0A372DKU2,C1F5Q7,A0A4R3EV39,A0A1P8WP90,A0A222F7P0,A0A1C9VH88,A0A2T2YMB1,A0A101R2A0,A0A1E3XF49,A0A1U9ND56,A0A4R7BQC4,A0A1Q1FPH0,E0TGY3,A0A259TUP4,F6EYI8,A0A2S9Q9J0,A0A4Q2UIU6,A0A1H0LH25,A0A318LG42,H1YCU5,L0JS08,A0A1Q5ZS75,M0AF24,A0A1W2A082,A0A1H3X247,A0A0C1XUA0,M0D2X3,A0A2R5G167,A0A346PK63,R7RTW6,A0A1H2RBI2,A0A1C3ZXN2,B7K585,A0A343TL88,A0A329TBQ3,A0A0W1S8B8,L9VRQ2,E4NRV1,A0A1I6HGN0,,",366,37
"43","C.S14.3","N.S21.3",121,72,49,1.68537414965986,"4F3T,5GUH,5VM9,6KR6,6OON,7SWF,A0A163JTZ6,T1H8B3,R1FDF0,D2VMG4,S7WCF7,C1DZY0,A0A2C5Z0M1,A0CB11,R9ACY5,W7XD45,A0A1U7LLR0,A0A4S2MWZ7,K1VVQ6,A0A158P1R9,B7Q5I1,A0A1E3QC61,D5GGK8,A0A139AUH8,U4LBG4,A6N7Y9,A0A0E9NDK5,A0A250WXN5,A0A2G8JLH3,Q5KAT1,A0A2J7QB22,A0A226EFL3,A0A3S3PD82,A0A1S3J512,A0A1J1HRI1,Q9JMB7,Q96J94,K7ISV0,E9FUN9,D7FQK3,A0A1Y1YHC8,A0A1C7M8P2,A0A4D8YSQ3,A0A0C2XG51,A0A165QYQ9,T0SAU8,A0A3S1A0C3,A0A2K1J482,A0A1Q3ENA6,O04379,A0A371I3C8,M8AEW7,A0A2K3NY65,A0A409Y6G2,A0A1D1W4K0,A7RQ46,W4YU94,D8SNM6,A0A1J8PPA3,X1WG39,M5FQK2,Q69VD5,A0A0R3W9Q7,A0A1Y1HWP2,G4T5G9,M7BCJ9,A0A498N3A3,A0A3M0IQP5,A0A3P7EJD6,A0A267E8R7,A0A2C9JGZ6,A0A3Q0KUG5,1Z26,5G5T,6QZK,A0A1I7IXT4,A0A2W1JZ37,A0A2S7WBN3,A0A420DFE6,A0A4V1VDY2,A0A368P5I0,A0A1W6MIP2,A0A2U2J9E0,A0A1T4Y3A2,A0A1V9G9U4,A0A1I2T6Q1,A0A1R3T9N6,A0LL61,A0A1J1EK56,A0A1Z3HNN4,Q53W94,A5D4D9,A0A3R7KLK4,A0A4R3EV39,A0A1P8WP90,A0A222F7P0,A0A1E3XF49,A0A1H3DGN3,A0A1Q1FPH0,E0TGY3,A0A1H0LH25,A0A318LG42,H1YCU5,A0A1Q5ZS75,M0AF24,A0A1W2A082,A0A0C1XUA0,A0A346PK63,A0A1H2RBI2,A0A1C3ZXN2,B9LVP8,F8D8G0,A0A343TL88,A0A3P3RGE5,A0A329TBQ3,A0A0W1S8B8,A0A1V4C8L7,L9VRQ2,E4NRV1,A0A1I6HGN0,A0A1I0NI68,,",366,37
"49","C.S8.4","C.S9.5",113,73,40,1.4222602739726,"4F1N,5GUH,6KR6,7KX7,7SWF,A0A0N4X8S8,C4LVV2,A8BCK6,A0A0G4H2S4,T1H8B3,D2VMG4,A0A074TLL7,A0A0D1ZAJ4,Q1K660,F4PH46,A0A3M7S814,Q54G64,A0A2C5Z0M1,A0CB11,D3BMP8,W7XD45,A0A158P1R9,V6R0U9,G4N9J3,B7Q5I1,D5GGK8,L2GMR6,A0A3N4IGK1,A6N7Y9,T1KZ60,A0A2G8JLH3,W2T741,A0A2J7QB22,S4RYE2,A0A388KES6,A0A226EFL3,A0A3S3PD82,A0A0L0TEV1,A0A1S3J512,A0A1J1HRI1,C4V9J2,Q9JMB7,A0A075AN09,Q5TW24,U5HIG6,A0A401PRI6,Q96J94,A0A2B4RHN2,K7ISV0,A0A024FT57,A0A0G4IME3,E9FUN9,D7FQK3,A0A1Y1YHC8,Q5BD61,A0A1C7M8P2,A0A4D8YSQ3,A0A158PJG6,J9JZ66,A0A158QZT6,T0SAU8,R7YY92,A0A074YJ47,A8P0D4,D8PZT7,A0A2R6NSC2,A0A0D8XL16,A0A016WPN3,V2WTL2,A0A0R3W9Q7,A0A0L8GBV4,A0A3P7EJD6,K5X5Z7,5AWH,6QZK,A0A328VKE4,A0A1M5ZSR3,A0A0K8QX04,K9TPA9,A0A326U7G5,A0A1Q4R485,K9U8J6,K9RC91,A0A0D8ZUC0,A0A139XGN8,A0A1T4Y3A2,A0YYT3,A0A2T1EFY0,G6FTN0,A0A433NB65,A0A1Z4L0A1,A0A2T1G8M7,A0A2T1LS63,A0A1Z4K1Y3,A0A0P4UVI8,A0A1J0AGK2,K9PFF9,A0A2G9DT08,A0A496APJ8,A0A1V9G9U4,I3TE64,A0A0B7I4Z6,A0A139WY18,A0A2T1E1K4,A0A1Q8ZD62,A0A1Z3HNN4,A5D4D9,A0A101R2A0,A0A1U9ND56,A0A4R7BQC4,A0A4Q2UIU6,A0A318LG42,F8D8G0,,",366,37
"55","C.L3.2","C.S1.1",120,75,45,1.59777777777778,"4KRE,5GUH,5VM9,A0A163JTZ6,A0A196SDB4,J9D5G4,S4RWI0,A0A074TLL7,A0A0D1ZAJ4,A0A3M7S814,A0A164ZA52,S7WCF7,I0YVB2,R7QGN7,C1DZY0,W7XD45,A0A1U7LLR0,G7DVX0,E3KLI3,B7Q5I1,L2GMR6,A0A177URI1,O74957,L2GUF2,A0A1W0E4B5,A0A388KES6,A0A0L0TEV1,A0A1S3J512,G0QTT2,A0A1J1HRI1,C4V9J2,A0A075AN09,U5HIG6,G2QEV0,A0A397UU01,K7ISV0,A0A024FT57,H3HCL6,A0A0G4IME3,D7FQK3,A0A1Y1YHC8,F4S231,A0A2G5B1D8,Q5BD61,A0A1C7M8P2,A0A4D8YSQ3,A0A0C2XG51,T0SAU8,A0A074YJ47,A0A2K1J482,A0A1Q3ENA6,O04379,A0A371I3C8,M8AEW7,A8P0D4,A0A2K3NY65,F4NYW7,A0A409Y6G2,A0A0L0HAB7,D8PZT7,W4YU94,D8SNM6,A0A1J8PPA3,M5FQK2,Q69VD5,A0A2R6NSC2,Q9QZ81,Q8CJG0,A0A1D5NTU6,V2WTL2,A0A1Y1HWP2,G4T5G9,A0A0L8GBV4,V3ZRX0,A0A210QKF7,1YVU,5AWH,A0A1I7IXT4,A0A2W1JZ37,A0A2S7WBN3,A0A420DFE6,A0A4V1VDY2,A0A368P5I0,A0A4R1RMM2,A0A1Y2RDH8,A0A1M5ZSR3,A0A0K8QX04,A0A1L3JHM3,A0A1W6MIP2,A0A2U2J9E0,A0A0B0H9B4,B7GJX9,A0A235B542,A0A1H3LE92,A0A0Q2M2Z1,A0A0B7I4Z6,A0A4Q6XKV6,A0A239JE83,A0A2N4XBY2,R5JEI2,A0A0Q0ZC47,A0A2T0XH18,A0A1N6LUI7,B9LVW4,M0AF24,M0D2X3,A0A2R5G167,A0A346PK63,M5RSF0,W0JW77,A0A343TL88,L0AJX6,A0A2A5QS34,A0A3P3RGE5,A0A329TBQ3,A0A285N2A8,A0A0W1S8B8,L9VRQ2,E4NRV1,A0A1I6HGN0,,",366,37
"56","N.H8.13","N.S12.5",143,75,68,1.48901960784314,"4F1N,4F3T,4KRE,J9D5G4,C4LVV2,A0A2P6N8X7,A0A0D1ZAJ4,I0YVB2,A0A2C5Z0M1,K1VVQ6,V6R0U9,E3KLI3,A0A139AUH8,A0A177URI1,Q5KAT1,L2GUF2,A0A388KES6,A0A0L0TEV1,G0QTT2,U5HIG6,G2QEV0,A0A397UU01,A0A2T7PFL8,A0A024FT57,H3HCL6,T1GSU4,F4S231,A0A1D8PMK0,A0A2G5B1D8,A0A158PJG6,A0A158QZT6,A0A165QYQ9,A0A3S1A0C3,A0A074YJ47,A0A1Q3ENA6,O04379,M8AEW7,F4NYW7,A0A409Y6G2,A0A0L0HAB7,A0A1D1W4K0,A7RQ46,A7BJS5,D8SNM6,X1WG39,Q9QZ81,G5EES3,Q8CJG0,A0A1D5NTU6,A0A139WDH0,A0A0R3W9Q7,A0A1Y1HWP2,G4T5G9,B7QCC4,M7BCJ9,E9GN30,Q7PZ41,A0A077Z361,R7U9I3,A0A0N4UKJ1,A0A3M0IQP5,A0A0L8GBV4,Q32KD4,A0A1J1JBJ0,A0A482XDA9,J9K2Z4,T1IBM6,A0A210QKF7,A0A423TSS1,K1PT78,A0A1D2N447,F6YK55,T1KTE4,A0A1V9X9F0,T1FY40,1YVU,6QZK,A0A3D8L290,A0A1T4Y3A2,A0A1N6SSK9,A0A060HNJ0,A0A1H3LE92,A0A496APJ8,A0A062U2W9,H0HWQ5,A0A1V9G9U4,A0A1I2BD20,F8ERC7,S7VLM7,A0A1A5X8H4,A0A1I2T6Q1,A0A0Q2M2Z1,H8KXJ0,A0A2D1U4H7,A0A0B7I4Z6,A0LL61,Q8DKB1,A0A139WY18,A0A1Q8ZD62,A0A4Q6XKV6,A0A239JE83,A0A2N4XBY2,R5JEI2,A0A1V4CHV0,A0A2T1EKT1,A0A1N6LUI7,A0A0P0NGR6,A0A1X7IML5,A0A0U3AL92,A0A1H3A054,E0UCX3,K9XZC6,A0A0C1VHB4,Q31N05,A0A0C5JKF3,A5D4D9,Q2JI93,A0A142Y7A9,A0A372DKU2,A0A3R7KLK4,A0A1C9VH88,A0A2T2YMB1,A0A1E3XF49,A0A1U9ND56,A0A4R7BQC4,A0A1H3DGN3,A0A1Q1FPH0,A0A259TUP4,F6EYI8,A0A2S9Q9J0,A0A4Q2UIU6,H1YCU5,L0JS08,A0A1Q5ZS75,A0A345E7N0,M0AF24,A0A1W2A082,A0A1H3X247,A0A0C1XUA0,M0D2X3,A0A346PK63,A0A1C3ZXN2,A0A343JEE2,,",366,37
"59","N.S12.5","N.S2.2",126,75,51,1.74745098039216,"7SWF,Q389P5,A8BCK6,T1H8B3,D2VMG4,A0A0D1ZAJ4,Q1K660,A0A164ZA52,A0A383WDW5,R7QGN7,C1DZY0,A0CB11,D3BMP8,A0A1Z5TVE5,G7DVX0,V6R0U9,G4N9J3,E3KLI3,A0A1E3QC61,S8ANP9,A0A139AUH8,L2GMR6,O74957,A0A3N4IGK1,A0A250WXN5,Q5KAT1,A0A1W0E4B5,A0A2K3CW87,C4V9J2,U5HIG6,A0A397UU01,H3HCL6,A0A0G4IME3,A0A1S3CYL5,A0A1Y1YHC8,F4S231,A0A1D8PMK0,Q5BD61,A0A158PJG6,A0A158QZT6,A0A165QYQ9,T0SAU8,A0A1Q3ENA6,A8P0D4,A0A409Y6G2,A0A0L0HAB7,A0A1J8PPA3,M5FQK2,Q69VD5,A0A0D8XL16,A0A016WPN3,Q9QZ81,G5EES3,A0A0K0EFP6,Q8CJG0,A0A1D5NTU6,A0A0V0YLH8,A0A139WDH0,A0A0R3W9Q7,H3DS31,A0A1Y1HWP2,G4T5G9,A0A0B2UV00,M7BCJ9,E9GN30,A0A077Z361,A0A0K0JDP1,A0A0N4UKJ1,A0A498N3A3,A0A3M0IQP5,A0A0L8GBV4,A0A423TSS1,F6YK55,T1KTE4,A0A1V9X9F0,5I4A,6QZK,K9RC91,A0A0D8ZUC0,A0A2T1EFY0,G6FTN0,R6KUL9,A0A433NB65,A0A1Z4L0A1,K9ZDE3,A0A1Z4K1Y3,A0A0V7ZCG4,A0A1J0AGK2,K9PFF9,A0A060HNJ0,A0A317EJY3,A0A1I2BD20,F8ERC7,S7VLM7,H8KXJ0,A0A2D1U4H7,A0A0B7I4Z6,A0A4Q6XKV6,A0A239JE83,A0A2N4XBY2,R5JEI2,A0A0Q0ZC47,A0A2T0XH18,A0A1K1RQP7,A0A1N6LUI7,A0A0P0NGR6,A0A1X7IML5,A0A0A2LKJ7,K1L112,A0A1H3A054,R5NJJ8,A0A372DKU2,C1F5Q7,A0A1P8WP90,A0A1C9VH88,A0A2T2YMB1,A0A101R2A0,L0JS08,A0A345E7N0,M0AF24,M0D2X3,A0A346PK63,W0JW77,L0AJX6,A0A2A5QS34,A0A343JEE2,,",366,37
"64","C.H10.10","C.S9.6",134,77,57,1.18421052631579,"4F3T,4KRE,6OON,A0A163JTZ6,A8BCK6,A0A3M7S814,R7QGN7,A0A1U7LLR0,A0A158P1R9,G7DVX0,E3KLI3,A0A250WXN5,Q5KAT1,W2T741,A0A075AN09,G2QEV0,A0A397UU01,A0A2T7PFL8,A0A0G4IME3,A0A1Y1YHC8,Q5BD61,A0A158PJG6,T0SAU8,R7YY92,A0A074YJ47,F4NYW7,A0A0L0HAB7,A0A1D1W4K0,A7RQ46,W4YU94,A7BJS5,X1WG39,A0A0D8XL16,A0A016WPN3,Q9QZ81,G5EES3,A0A0K0EFP6,Q8CJG0,A0A1D5NTU6,A0A0V0YLH8,A0A139WDH0,A0A0R3W9Q7,H3DS31,B7QCC4,A0A0B2UV00,M7BCJ9,E9GN30,Q7PZ41,A0A077Z361,R7U9I3,A0A1X7V1N5,A0A0K0JDP1,A0A0N4UKJ1,A0A498N3A3,A0A3M0IQP5,A0A0L8GBV4,Q32KD4,A0A1J1JBJ0,E0W4C3,A0A482XDA9,A0A3P7EJD6,J9K2Z4,A0A2J7Q8V4,T1IBM6,V3ZRX0,A0A210QKF7,A0A423TSS1,K1PT78,A0A267E8R7,A0A1D2N447,A0A226D7A9,F6YK55,T1KTE4,A0A2C9JGZ6,A0A1V9X9F0,A0A3Q0KUG5,T1FY40,A0A1I7IXT4,A0A2W1JZ37,A0A2S7WBN3,A0A420DFE6,A0A4V1VDY2,A0A368P5I0,A0A4R1RMM2,A0A1Y2RDH8,A0A1M5ZSR3,A0A0K8QX04,A0A1W6MIP2,A0A2U2J9E0,A0A2Z6E1D5,A0A1T4Y3A2,B0JXD6,A0A0P4UVI8,A0A2G9DT08,K9UEV4,Q9L1X1,A0A496APJ8,A0A1V9G9U4,A0A1A5X8H4,A0A1I2T6Q1,A0A1R3T9N6,H8KXJ0,A0A2D1U4H7,Q8DKB1,A0A139WY18,A0A2T1E1K4,A0A4Q6XKV6,A0A1Z3HNN4,A0A239JE83,A0A2N4XBY2,R5JEI2,A0A2T0XH18,A0A1V4CHV0,A0A0U3AL92,A0A0C5JKF3,A5D4D9,A0A142Y7A9,A0A372DKU2,C1F5Q7,A0A1P8WP90,A0A1C9VH88,A0A2T2YMB1,A0A329TD61,A0A101R2A0,A0A259TUP4,A0A1H0LH25,A0A318LG42,A0A1H3X247,B9LVP8,A0A343TL88,A0A329TBQ3,A0A0W1S8B8,E4NRV1,A0A1I6HGN0,,",366,37
"65","C.H10.6","C.L28.5",139,77,62,2.17396313364055,"5GUH,6KR6,7KX7,A0A163JTZ6,A0A196SDB4,A2DPV7,A0A0G4H2S4,D2VMG4,F4PH46,A0A383WDW5,Q54G64,S7WCF7,R7QGN7,A0A2C5Z0M1,R9ACY5,W7XD45,A0A1U7LLR0,K1VVQ6,A0A158P1R9,G4N9J3,B7Q5I1,A0A1E3QC61,A0A139AUH8,U4LBG4,A0A177URI1,O74957,A0A3N4IGK1,A6N7Y9,A0A0E9NDK5,T1KZ60,A0A2G8JLH3,L2GUF2,A0A1W0E4B5,A0A2J7QB22,S4RYE2,A0A2K3CW87,A0A388KES6,A0A226EFL3,A0A3S3PD82,A0A0L0TEV1,A0A1S3J512,G0QTT2,A0A1J1HRI1,C4V9J2,Q9JMB7,Q5TW24,U5HIG6,A0A401PRI6,Q96J94,A0A2B4RHN2,G2QEV0,A0A397UU01,K7ISV0,A0A0G4IME3,E9FUN9,A0A1S3CYL5,A0A1Y1YHC8,A0A1D8PMK0,Q5BD61,A0A4D8YSQ3,A0A0C2XG51,R7YY92,A0A074YJ47,A0A2K1J482,O04379,M8AEW7,A8P0D4,A0A2K3NY65,F4NYW7,A0A0L0HAB7,D8PZT7,D8SNM6,M5FQK2,Q69VD5,A0A2R6NSC2,V2WTL2,A0A1Y1HWP2,5AWH,A0A1I7IXT4,A0A2W1JZ37,A0A2S7WBN3,A0A420DFE6,A0A4V1VDY2,A0A368P5I0,A0A4R1RMM2,A0A1Y2RDH8,A0A1M5ZSR3,A0A0K8QX04,A0A1L3JHM3,A0A1W6MIP2,A0A1C0UUC4,A0A2U2J9E0,A0A1T4Y3A2,A0A2G9DT08,Q9L1X1,A0A060HNJ0,A0A1A5X8H4,A0A1I2T6Q1,A0A1R3T9N6,A0A0B7I4Z6,A0LL61,A0A1J1EK56,A0A4Q6XKV6,A0A239JE83,A0A2N4XBY2,Q53W94,R5JEI2,A0A0Q0ZC47,A0A1V4CHV0,A0A1N6LUI7,A0A0P0NGR6,A0A1X7IML5,A0A0U3AL92,A0A1H3A054,A0A0C5JKF3,A5D4D9,A0A142Y7A9,A0A432MEQ5,A0A372DKU2,C1F5Q7,A0A4R3EV39,A0A1P8WP90,A0A222F7P0,A0A1C9VH88,A0A2T2YMB1,A0A101R2A0,A0A1U9ND56,A0A4R7BQC4,E0TGY3,A0A259TUP4,F6EYI8,A0A2S9Q9J0,A0A4Q2UIU6,A0A1H0LH25,A0A318LG42,A0A2R5G167,A0A346PK63,M5RSF0,B7K585,,",366,37
"68","N.S17.3","N.S19.1",153,77,76,1.16293574846206,"4F1N,5VM9,7SWF,A0A0N4X8S8,A0A196SDB4,J9D5G4,Q389P5,A0A2P6N8X7,D2VMG4,A0A0D1ZAJ4,Q1K660,A0A164ZA52,Q54G64,R7QGN7,A0A2C5Z0M1,A0CB11,R9ACY5,D3BMP8,A0A1U7LLR0,A0A4S2MWZ7,K1VVQ6,A0A158P1R9,V6R0U9,G4N9J3,E3KLI3,A0A1E3QC61,D5GGK8,S8ANP9,A0A139AUH8,L2GMR6,U4LBG4,O74957,A0A3N4IGK1,A0A0E9NDK5,Q5KAT1,W2T741,A0A1W0E4B5,A0A2K3CW87,A0A388KES6,A0A226EFL3,A0A0L0TEV1,A0A1S3J512,C4V9J2,A0A075AN09,U5HIG6,A0A397UU01,A0A024FT57,H3HCL6,A0A0G4IME3,D7FQK3,A0A1Y1YHC8,A0A2G5B1D8,A0A1C7M8P2,A0A4D8YSQ3,A0A158PJG6,A0A158QZT6,A0A165QYQ9,T0SAU8,A0A2K1J482,A0A1Q3ENA6,O04379,A0A371I3C8,M8AEW7,A0A2K3NY65,F4NYW7,A0A409Y6G2,A0A0L0HAB7,D8SNM6,A0A1J8PPA3,Q69VD5,A0A0D8XL16,A0A016WPN3,A0A1Y1HWP2,G4T5G9,A0A1X7V1N5,F6YK55,K5X5Z7,1YVU,5G5T,5I4A,6QZK,E0ST67,C4L1M1,A0A0M2PXX3,A0A1C0UUC4,B1XJG0,A0A1T4Y3A2,A0A1N6SSK9,A0A2G9DT08,Q9L1X1,A0A060HNJ0,A0A1V9G9U4,S7VLM7,A0A1A5X8H4,A0A1I2T6Q1,A0A1R3T9N6,H8KXJ0,D3S0S6,I3TE64,A0A0B7I4Z6,A0LL61,Q8DKB1,A0A1Q8ZD62,A0A4Q6XKV6,A0A2N4XBY2,Q53W94,A0A0Q0ZC47,A0A2T0XH18,A0A1V4CHV0,A0A1K1RQP7,A0A2T1EKT1,A0A0P0NGR6,A0A1X7IML5,A0A0A2LKJ7,A0A0U3AL92,A0A1H3A054,E0UCX3,K9XZC6,A0A0C1VHB4,Q31N05,R5NJJ8,A5D4D9,Q2JI93,A0A372DKU2,A0A4R3EV39,A0A329TD61,A0A101R2A0,A0A1E3XF49,A0A1U9ND56,A0A4R7BQC4,A0A1Q1FPH0,A0A259TUP4,F6EYI8,A0A2S9Q9J0,A0A1H0LH25,A0A318LG42,H1YCU5,L0JS08,A0A1Q5ZS75,A0A345E7N0,M0AF24,A0A1H3X247,A0A0C1XUA0,M0D2X3,B9LVP8,W0JW77,B7K585,F8D8G0,L0AJX6,A0A2A5QS34,A0A343JEE2,A0A285N2A8,A0A1V4C8L7,,",366,37
"70","C.H9.5","C.L24.4",132,78,54,2.20299145299145,"4F1N,4KRE,6KR6,7SWF,R1FDF0,A0A0D1ZAJ4,A0A164ZA52,A0A383WDW5,S7WCF7,I0YVB2,R7QGN7,A0A2C5Z0M1,A0CB11,R9ACY5,W7XD45,A0A1U7LLR0,K1VVQ6,A0A158P1R9,G7DVX0,V6R0U9,E3KLI3,A0A1E3QC61,D5GGK8,S8ANP9,A0A139AUH8,L2GMR6,U4LBG4,T1KZ60,A0A250WXN5,A0A2G8JLH3,L2GUF2,W2T741,A0A1W0E4B5,S4RYE2,A0A2K3CW87,A0A388KES6,G0QTT2,A0A1J1HRI1,C4V9J2,Q9JMB7,A0A075AN09,Q5TW24,U5HIG6,Q96J94,A0A2B4RHN2,A0A397UU01,K7ISV0,A0A024FT57,H3HCL6,E9FUN9,A0A1S3CYL5,A0A1Y1YHC8,F4S231,A0A1D8PMK0,A0A1C7M8P2,A0A158PJG6,A0A0C2XG51,A0A158QZT6,T0SAU8,R7YY92,A0A1Q3ENA6,O04379,A0A371I3C8,A8P0D4,A0A2K3NY65,A0A1D1W4K0,D8SNM6,A0A1J8PPA3,A0A0D8XL16,A0A016WPN3,G5EES3,A0A0K0EFP6,V2WTL2,A0A1Y1HWP2,G4T5G9,A0A0K0JDP1,A0A0N4UKJ1,K5X5Z7,1YVU,1Z26,3DLB,5G5T,5I4A,6QZK,A0A4R1RMM2,A0A0K8QX04,A0A1L3JHM3,B1XJG0,A0A097QRL6,A0A0P6X5X2,A0A1H3LE92,A0A062U2W9,H0HWQ5,A0A317EJY3,A0A1I2BD20,F8ERC7,A0A0Q2M2Z1,I3TE64,Q8DKB1,A0A1J1EK56,Q53W94,A0A2T1EKT1,K9XZC6,B9LVW4,A0A0C1VHB4,Q31N05,R5NJJ8,Q2JI93,A0A1Q1FPH0,L0JS08,M0AF24,A0A1W2A082,A0A1H3X247,M0D2X3,A0A346PK63,R7RTW6,A0A1C3ZXN2,B9LVP8,W0JW77,F8D8G0,A0A343TL88,L0AJX6,A0A2A5QS34,A0A3P3RGE5,A0A329TBQ3,A0A285N2A8,A0A0W1S8B8,A0A1V4C8L7,L9VRQ2,E4NRV1,A0A1I6HGN0,A0A1I0NI68,,",366,37
"74","N.S12.3","N.S20.2",143,78,65,1.49871794871795,"5GUH,7SWF,A0A163JTZ6,A0A0G4H2S4,T1H8B3,R1FDF0,D2VMG4,A0A0D1ZAJ4,Q1K660,A0A164ZA52,A0A383WDW5,Q54G64,S7WCF7,R7QGN7,A0A2C5Z0M1,A0CB11,R9ACY5,A0A1Z5TVE5,W7XD45,A0A1U7LLR0,K1VVQ6,G7DVX0,V6R0U9,G4N9J3,E3KLI3,B7Q5I1,A0A1E3QC61,L2GMR6,U4LBG4,A0A177URI1,O74957,A6N7Y9,A0A0E9NDK5,A0A1W0E4B5,S4RYE2,A0A2K3CW87,A0A3S3PD82,A0A1S3J512,G0QTT2,A0A1J1HRI1,C4V9J2,Q9JMB7,A0A075AN09,U5HIG6,A0A401PRI6,Q96J94,A0A397UU01,A0A2T7PFL8,K7ISV0,A0A024FT57,E9FUN9,A0A1Y1YHC8,A0A1D8PMK0,A0A2G5B1D8,A0A1C7M8P2,A0A0C2XG51,A0A1Q3ENA6,A0A409Y6G2,A0A0L0HAB7,D8PZT7,A0A1D1W4K0,D8SNM6,A0A1J8PPA3,M5FQK2,Q69VD5,A0A2R6NSC2,V2WTL2,A0A0V0YLH8,A0A1Y1HWP2,G4T5G9,A0A0B2UV00,A0A077Z361,A0A1X7V1N5,A0A0K0JDP1,A0A0N4UKJ1,A0A498N3A3,A0A423TSS1,K5X5Z7,5G5T,6QZK,E8N0K8,A0A1Q4R485,A0A097QRL6,K9RC91,A0A139XGN8,A0YYT3,A0A2T1EFY0,A0A1Z4L0A1,A0A2T1G8M7,K9ZDE3,B0JXD6,A0A1Z4K1Y3,K9PFF9,A0A1H3LE92,A0A496APJ8,H0HWQ5,A0A1I2ZGP1,A0A317EJY3,A0A1I2BD20,A0A1I2T6Q1,H8KXJ0,A0A2D1U4H7,A0A0B7I4Z6,A0LL61,A0A4Q6XKV6,A0A1Z3HNN4,A0A239JE83,A0A2N4XBY2,R5JEI2,A0A0Q0ZC47,A0A2T0XH18,A0A1K1RQP7,A0A1N6LUI7,A0A0P0NGR6,A0A0A2LKJ7,K1L112,A0A0U3AL92,A0A1H3A054,B9LVW4,A0A0C5JKF3,R5NJJ8,A0A142Y7A9,A0A372DKU2,A0A3R7KLK4,A0A1P8WP90,A0A1C9VH88,A0A1U9ND56,A0A1H3DGN3,H1YCU5,L0JS08,A0A1Q5ZS75,A0A345E7N0,A0A0C1XUA0,R7RTW6,A0A1H2RBI2,W0JW77,F8D8G0,L0AJX6,A0A2A5QS34,A0A343JEE2,A0A285N2A8,A0A1V4C8L7,A0A1I0NI68,,",366,37
"77","C.H10.1","C.H9.9",172,80,92,1.29211956521739,"4KRE,6OON,7SWF,J9D5G4,Q389P5,C4LVV2,A0A2P6N8X7,A2DPV7,R1FDF0,A0A3M7S814,R7QGN7,C1DZY0,A0A1Z5TVE5,G4N9J3,A0A139AUH8,L2GMR6,W2T741,A0A1W0E4B5,C4V9J2,U5HIG6,A0A401PRI6,A0A397UU01,A0A2T7PFL8,K7ISV0,A0A024FT57,H3HCL6,T1GSU4,A0A158PJG6,A0A158QZT6,A0A3S1A0C3,A0A1D1W4K0,A7RQ46,W4YU94,A7BJS5,X1WG39,A0A0D8XL16,A0A016WPN3,Q9QZ81,G5EES3,A0A0K0EFP6,Q8CJG0,A0A1D5NTU6,A0A0V0YLH8,A0A139WDH0,A0A0R3W9Q7,H3DS31,B7QCC4,A0A0B2UV00,M7BCJ9,E9GN30,Q7PZ41,A0A077Z361,R7U9I3,A0A1X7V1N5,A0A0K0JDP1,A0A0N4UKJ1,A0A498N3A3,A0A3M0IQP5,A0A0L8GBV4,Q32KD4,A0A1J1JBJ0,E0W4C3,A0A482XDA9,A0A3P7EJD6,J9K2Z4,A0A2J7Q8V4,T1IBM6,V3ZRX0,A0A210QKF7,A0A423TSS1,K1PT78,A0A267E8R7,A0A1D2N447,A0A226D7A9,F6YK55,T1KTE4,A0A2C9JGZ6,A0A1V9X9F0,A0A3Q0KUG5,T1FY40,1YVU,1Z26,5G5T,6QZK,A0A1I7IXT4,A0A2W1JZ37,A0A2S7WBN3,A0A420DFE6,A0A368P5I0,C4L1M1,A0A4R1RMM2,A0A1Y2RDH8,Q11QW7,A0A1M5ZSR3,A0A0K8QX04,A0A0M2PXX3,A0A1L3JHM3,A0A1W6MIP2,A0A1C0UUC4,A0A2Z6E1D5,B1XJG0,A0A3D8L290,H1KXR6,A0A1Q4R485,A0A097QRL6,A0A1T4Y3A2,B6YTQ5,A0A0B0H9B4,R6KUL9,B7GJX9,A0A1N6SSK9,A0A2G9DT08,K9UEV4,Q9L1X1,A0A060HNJ0,A0A235B542,A0A1H3LE92,A0A062U2W9,H0HWQ5,A0A1A5X8H4,A0A1I2T6Q1,A0A1R3T9N6,D3S0S6,Q8DKB1,A0A239JE83,A0A1V4CHV0,A0A2T1EKT1,A0A0P0NGR6,E0UCX3,A0A0C1VHB4,Q31N05,A0A0C5JKF3,R5NJJ8,A5D4D9,Q2JI93,A0A142Y7A9,A0A372DKU2,A0A3R7KLK4,C1F5Q7,A0A4R3EV39,A0A222F7P0,A0A1C9VH88,A0A329TD61,A0A101R2A0,A0A1U9ND56,A0A4R7BQC4,A0A1H3DGN3,A0A1Q1FPH0,E0TGY3,A0A259TUP4,F6EYI8,A0A2S9Q9J0,L0JS08,A0A345E7N0,A0A1W2A082,A0A1H3X247,R7RTW6,B9LVP8,M5RSF0,W0JW77,B7K585,A0A343TL88,A0A343JEE2,A0A3P3RGE5,A0A329TBQ3,A0A285N2A8,A0A0W1S8B8,A0A1V4C8L7,L9VRQ2,E4NRV1,A0A1I6HGN0,A0A1I0NI68,,",366,37
"80","N.H3.8","N.S11.11",155,80,75,1.97125,"4F1N,5GUH,6KR6,C4LVV2,A2DPV7,A0A0G4H2S4,T1H8B3,R1FDF0,A0A074TLL7,Q1K660,F4PH46,A0A164ZA52,Q54G64,S7WCF7,I0YVB2,R7QGN7,A0A2C5Z0M1,A0CB11,D3BMP8,W7XD45,A0A1U7LLR0,A0A4S2MWZ7,K1VVQ6,A0A158P1R9,G7DVX0,V6R0U9,G4N9J3,A0A1E3QC61,S8ANP9,A0A177URI1,O74957,A6N7Y9,T1KZ60,A0A250WXN5,A0A2G8JLH3,Q5KAT1,A0A1W0E4B5,A0A2J7QB22,S4RYE2,A0A2K3CW87,A0A388KES6,A0A226EFL3,A0A3S3PD82,A0A1S3J512,G0QTT2,A0A1J1HRI1,C4V9J2,Q9JMB7,Q5TW24,U5HIG6,A0A401PRI6,Q96J94,A0A2B4RHN2,A0A397UU01,K7ISV0,A0A024FT57,H3HCL6,A0A0G4IME3,A0A1S3CYL5,D7FQK3,A0A1D8PMK0,A0A2G5B1D8,J9JZ66,A0A0C2XG51,T0SAU8,R7YY92,A0A074YJ47,A8P0D4,F4NYW7,A0A0L0HAB7,A7RQ46,D8SNM6,X1WG39,V2WTL2,A0A0R3W9Q7,A0A1Y1HWP2,M7BCJ9,A0A1X7V1N5,A0A3M0IQP5,K5X5Z7,3DLB,5G5T,5I4A,6QZK,E8N0K8,A0A3D8L290,A0A2G9DT08,Q9L1X1,A0A496APJ8,A0A062U2W9,H0HWQ5,A0A317EJY3,A0A1I2BD20,F8ERC7,S7VLM7,A0A1I2T6Q1,A0A1R3T9N6,H8KXJ0,A0A2D1U4H7,A0LL61,Q8DKB1,A0A139WY18,A0A1J1EK56,A0A4Q6XKV6,A0A2N4XBY2,Q53W94,A0A0Q0ZC47,A0A2T1EKT1,A0A1N6LUI7,A0A0P0NGR6,A0A1X7IML5,B9LVW4,A0A0C1VHB4,Q31N05,R5NJJ8,Q2JI93,A0A142Y7A9,A0A432MEQ5,A0A3R7KLK4,A0A1P8WP90,A0A222F7P0,A0A2T2YMB1,A0A329TD61,A0A1E3XF49,A0A4R7BQC4,A0A1H3DGN3,A0A1Q1FPH0,F6EYI8,A0A4Q2UIU6,H1YCU5,L0JS08,A0A1Q5ZS75,A0A345E7N0,M0AF24,A0A1W2A082,A0A1H3X247,A0A0C1XUA0,M0D2X3,A0A2R5G167,A0A346PK63,A0A1H2RBI2,A0A1C3ZXN2,B9LVP8,W0JW77,B7K585,F8D8G0,A0A343TL88,A0A343JEE2,A0A3P3RGE5,A0A329TBQ3,A0A285N2A8,A0A0W1S8B8,L9VRQ2,E4NRV1,A0A1I6HGN0,,",366,37
"81","C.H1.12","C.H5.5",179,81,98,1.88290501385739,"4F1N,4F3T,5VM9,7SWF,A0A163JTZ6,J9D5G4,A2DPV7,T1H8B3,D2VMG4,Q1K660,F4PH46,A0A164ZA52,A0A383WDW5,S7WCF7,I0YVB2,R7QGN7,A0A2C5Z0M1,A0CB11,R9ACY5,A0A1Z5TVE5,W7XD45,A0A158P1R9,G7DVX0,V6R0U9,G4N9J3,E3KLI3,B7Q5I1,A0A1E3QC61,D5GGK8,L2GMR6,U4LBG4,A0A177URI1,O74957,A0A3N4IGK1,A6N7Y9,A0A0E9NDK5,A0A2G8JLH3,Q5KAT1,L2GUF2,A0A1W0E4B5,A0A2J7QB22,S4RYE2,A0A2K3CW87,A0A0L0TEV1,G0QTT2,C4V9J2,Q9JMB7,A0A075AN09,U5HIG6,A0A401PRI6,Q96J94,A0A2B4RHN2,G2QEV0,A0A397UU01,K7ISV0,A0A1S3CYL5,A0A1Y1YHC8,F4S231,A0A1D8PMK0,A0A2G5B1D8,Q5BD61,A0A1C7M8P2,J9JZ66,A0A0C2XG51,A0A165QYQ9,T0SAU8,A0A1Q3ENA6,O04379,A8P0D4,F4NYW7,A0A409Y6G2,A0A0L0HAB7,D8PZT7,A0A1J8PPA3,M5FQK2,A0A2R6NSC2,V2WTL2,A0A0V0YLH8,A0A1X7V1N5,K5X5Z7,T1FY40,1YVU,3DLB,5G5T,5I4A,7R8K,E8N0K8,C4L1M1,A0A4R1RMM2,A0A1I3LMA1,K9TPA9,A0A2Z6E1D5,A0A142XB92,L8D0R3,A0A326U7G5,A0A1Q4R485,K9U8J6,K9RC91,A0A0D8ZUC0,A0A139XGN8,A0YYT3,A0A2T1EFY0,G6FTN0,R6KUL9,A0A433NB65,A0A1Z4L0A1,K9UQR0,A0A2T1G8M7,K9VUN0,B7GJX9,A0A0P6X5X2,K9ZDE3,B0JXD6,A0A2T1LS63,A0A1Z4K1Y3,A0A1N6SSK9,A0A0P4UVI8,A0A0V7ZCG4,A0A1J0AGK2,K9PFF9,A0A2G9DT08,K9UEV4,Q9L1X1,A0A235B542,A0A1V9G9U4,A0A1I2BD20,F8ERC7,S7VLM7,A0A1A5X8H4,A0A1I2T6Q1,A0A1R3T9N6,H8KXJ0,A0A2D1U4H7,A0LL61,A0A1J1EK56,A0A1Q8ZD62,A0A4Q6XKV6,A0A239JE83,A0A2N4XBY2,Q53W94,R5JEI2,A0A1V4CHV0,A0A1N6LUI7,A0A1X7IML5,E0UCX3,K9XZC6,Q31N05,A5D4D9,A0A432MEQ5,A0A3R7KLK4,C1F5Q7,A0A4R3EV39,A0A1P8WP90,A0A222F7P0,A0A2T2YMB1,A0A101R2A0,A0A1U9ND56,A0A4R7BQC4,A0A1H3DGN3,E0TGY3,A0A259TUP4,A0A2S9Q9J0,A0A1H0LH25,A0A318LG42,L0JS08,A0A345E7N0,A0A1W2A082,A0A1H3X247,A0A0C1XUA0,A0A1H2RBI2,B9LVP8,M5RSF0,B7K585,A0A343TL88,A0A329TBQ3,A0A285N2A8,L9VRQ2,E4NRV1,A0A1I6HGN0,,",366,37
"85","C.S5.4","C.S5.6",158,82,76,1.21646341463415,"4F3T,4KRE,6OON,7KX7,S4RWI0,D2VMG4,A0A3M7S814,Q54G64,D3BMP8,A0A158P1R9,B7Q5I1,A0A2G8JLH3,W2T741,C4V9J2,Q9JMB7,A0A401PRI6,Q96J94,A0A2B4RHN2,A0A2T7PFL8,A0A024FT57,H3HCL6,E9FUN9,A0A1S3CYL5,D7FQK3,A0A1D8PMK0,A0A1C7M8P2,A0A4D8YSQ3,A0A0C2XG51,A0A158QZT6,A0A074YJ47,A0A1Q3ENA6,O04379,A0A371I3C8,M8AEW7,A0A2K3NY65,A0A409Y6G2,D8PZT7,A0A1D1W4K0,W4YU94,A7BJS5,A0A1J8PPA3,X1WG39,A0A016WPN3,Q9QZ81,G5EES3,A0A0K0EFP6,Q8CJG0,A0A0V0YLH8,A0A139WDH0,H3DS31,G4T5G9,B7QCC4,A0A0B2UV00,M7BCJ9,E9GN30,Q7PZ41,A0A077Z361,R7U9I3,A0A1X7V1N5,A0A0K0JDP1,A0A0N4UKJ1,A0A498N3A3,A0A3M0IQP5,A0A0L8GBV4,Q32KD4,E0W4C3,A0A482XDA9,A0A3P7EJD6,T1IBM6,V3ZRX0,A0A210QKF7,A0A423TSS1,K1PT78,A0A267E8R7,A0A1D2N447,A0A226D7A9,F6YK55,T1KTE4,A0A2C9JGZ6,A0A1V9X9F0,A0A3Q0KUG5,T1FY40,1YVU,3DLB,5I4A,7R8K,E8N0K8,A0A328VKE4,E0ST67,A0A1Y2RDH8,Q11QW7,A0A0M2PXX3,K9TPA9,A0A2Z6E1D5,A0A3D8L290,H1KXR6,A0A1Q4R485,K9U8J6,K9RC91,A0A0D8ZUC0,A0A139XGN8,A0A1T4Y3A2,A0YYT3,A0A2T1EFY0,R6KUL9,K9VUN0,A0A0P6X5X2,A0A2G9DT08,K9UEV4,Q9L1X1,R5XQK4,A0A496APJ8,A0A1V9G9U4,F8ERC7,A0A1I2T6Q1,A0A1R3T9N6,A0A0Q2M2Z1,H8KXJ0,A0A2D1U4H7,A0A139WY18,A0A1J1EK56,A0A1Z3HNN4,A0A2T1EKT1,A0A0U3AL92,A0A1H3A054,A0A0C5JKF3,A5D4D9,A0A372DKU2,A0A3R7KLK4,A0A4R3EV39,A0A222F7P0,A0A1C9VH88,A0A101R2A0,A0A1E3XF49,A0A1U9ND56,A0A4R7BQC4,A0A1H3DGN3,E0TGY3,A0A259TUP4,F6EYI8,A0A2S9Q9J0,A0A4Q2UIU6,A0A1H0LH25,A0A318LG42,A0A1W2A082,A0A1H3X247,A0A0C1XUA0,A0A2R5G167,A0A1H2RBI2,A0A1C3ZXN2,B9LVP8,A0A343TL88,A0A3P3RGE5,A0A329TBQ3,A0A0W1S8B8,L9VRQ2,E4NRV1,A0A1I6HGN0,,",366,37
"89","C.H4.4","C.L10.1",122,83,39,2.11955514365153,"4F1N,4KRE,6OON,7SWF,S4RWI0,A0A0D1ZAJ4,Q1K660,A0A3M7S814,A0A164ZA52,A0A2C5Z0M1,R9ACY5,A0A1Z5TVE5,W7XD45,A0A1U7LLR0,A0A4S2MWZ7,V6R0U9,G4N9J3,A0A1E3QC61,D5GGK8,S8ANP9,U4LBG4,O74957,A0A0E9NDK5,W2T741,A0A388KES6,A0A0L0TEV1,G0QTT2,U5HIG6,A0A024FT57,H3HCL6,A0A0G4IME3,T1GSU4,Q5BD61,A0A4D8YSQ3,A0A158PJG6,A0A0C2XG51,A0A158QZT6,T0SAU8,R7YY92,A0A3S1A0C3,A0A2K1J482,A0A1Q3ENA6,O04379,A0A371I3C8,A0A2K3NY65,A0A409Y6G2,A0A1D1W4K0,A7RQ46,W4YU94,D8SNM6,A0A1J8PPA3,X1WG39,M5FQK2,Q69VD5,A0A0D8XL16,A0A016WPN3,Q8CJG0,A0A1D5NTU6,A0A0V0YLH8,A0A1Y1HWP2,G4T5G9,B7QCC4,A0A0B2UV00,M7BCJ9,A0A077Z361,A0A1X7V1N5,A0A0K0JDP1,A0A0N4UKJ1,A0A498N3A3,A0A3M0IQP5,A0A0L8GBV4,A0A1J1JBJ0,A0A482XDA9,A0A3P7EJD6,J9K2Z4,T1IBM6,V3ZRX0,A0A423TSS1,F6YK55,T1KTE4,A0A2C9JGZ6,A0A1V9X9F0,T1FY40,5G5T,5I4A,6QZK,A0A4R1RMM2,A0A1Y2RDH8,A0A1L3JHM3,A0A2Z6E1D5,A0A0F4NXW8,L8D0R3,Q5P0R2,A0A2Z6E0R7,S7VLM7,A0A0Q2M2Z1,A0A0B7I4Z6,A0A4Q6XKV6,A0A239JE83,A0A2N4XBY2,A0A0Q0ZC47,A0A2T0XH18,A0A1K1RQP7,A0A0P0NGR6,A0A1X7IML5,A0A0A2LKJ7,K1L112,R5NJJ8,A0A3R7KLK4,A0A329TD61,A0A1E3XF49,A0A1H3DGN3,H1YCU5,A0A1Q5ZS75,A0A345E7N0,A0A1W2A082,A0A0C1XUA0,R7RTW6,A0A1H2RBI2,A0A1C3ZXN2,B9LVP8,A0A343JEE2,,",366,37
"93","C.H7.13","C.S8.2",128,84,44,2.19588744588745,"4F1N,4F3T,4KRE,6OON,7KX7,7SWF,A0A163JTZ6,A0A0N4X8S8,A0A196SDB4,J9D5G4,C4LVV2,A0A2P6N8X7,A2DPV7,T1H8B3,D2VMG4,A0A0D1ZAJ4,Q1K660,A0A164ZA52,Q54G64,S7WCF7,I0YVB2,R7QGN7,A0A2C5Z0M1,D3BMP8,W7XD45,A0A4S2MWZ7,V6R0U9,G4N9J3,E3KLI3,B7Q5I1,L2GMR6,A0A177URI1,O74957,A6N7Y9,T1KZ60,L2GUF2,W2T741,A0A1W0E4B5,A0A2K3CW87,A0A226EFL3,G0QTT2,A0A1J1HRI1,C4V9J2,Q9JMB7,A0A075AN09,U5HIG6,A0A401PRI6,Q96J94,A0A2B4RHN2,G2QEV0,K7ISV0,A0A024FT57,H3HCL6,A0A0G4IME3,E9FUN9,A0A1S3CYL5,D7FQK3,A0A1Y1YHC8,A0A1D8PMK0,A0A2G5B1D8,Q5BD61,A0A4D8YSQ3,A0A158PJG6,A0A158QZT6,A0A165QYQ9,T0SAU8,A0A074YJ47,A0A2K1J482,O04379,A0A371I3C8,M8AEW7,A0A2K3NY65,A0A409Y6G2,A0A1D1W4K0,D8SNM6,M5FQK2,Q69VD5,A0A0D8XL16,A0A016WPN3,G5EES3,A0A0R3W9Q7,A0A1X7V1N5,A0A3P7EJD6,A0A3Q0KUG5,3DLB,5I4A,A0A2W1JZ37,A0A2S7WBN3,A0A420DFE6,C4L1M1,A0A1Y2RDH8,A0A1M5ZSR3,A0A1W6MIP2,A0A2U2J9E0,A0A142XB92,A0A326U7G5,A0A3D8L290,K9U8J6,K9RC91,B6YTQ5,A0A0B0H9B4,R6KUL9,A0A2T1G8M7,K9VUN0,B7GJX9,A0A0P6X5X2,A0A0P4UVI8,A0A0V7ZCG4,A0A060HNJ0,A0A235B542,A0A496APJ8,A0A1V9G9U4,A0A139WY18,A0A2T1E1K4,A0A1Q8ZD62,A0A1Z3HNN4,A0A432MEQ5,A0A2R5G167,R7RTW6,M5RSF0,A0A343TL88,A0A343JEE2,A0A3P3RGE5,A0A329TBQ3,A0A0W1S8B8,L9VRQ2,E4NRV1,A0A1I6HGN0,,",366,37
"97","C.H5.15","C.L28.2",167,86,81,1.09732988802756,"4F1N,5GUH,5VM9,6KR6,6OON,7KX7,7SWF,A0A196SDB4,Q389P5,A8BCK6,A2DPV7,A0A0G4H2S4,D2VMG4,Q1K660,F4PH46,A0A383WDW5,Q54G64,C1DZY0,W7XD45,A0A1U7LLR0,A0A158P1R9,B7Q5I1,U4LBG4,O74957,A6N7Y9,T1KZ60,A0A2G8JLH3,L2GUF2,W2T741,A0A2J7QB22,S4RYE2,A0A226EFL3,A0A3S3PD82,A0A1S3J512,G0QTT2,Q9JMB7,A0A401PRI6,Q96J94,A0A2B4RHN2,A0A397UU01,K7ISV0,A0A024FT57,H3HCL6,A0A1S3CYL5,D7FQK3,A0A1Y1YHC8,A0A1D8PMK0,A0A4D8YSQ3,J9JZ66,A0A2K1J482,A0A1Q3ENA6,A0A2K3NY65,F4NYW7,A0A409Y6G2,A0A0L0HAB7,A0A1D1W4K0,A7RQ46,A7BJS5,A0A1J8PPA3,X1WG39,A0A0D8XL16,A0A016WPN3,G5EES3,A0A0K0EFP6,Q8CJG0,A0A0V0YLH8,A0A139WDH0,A0A0R3W9Q7,H3DS31,M7BCJ9,A0A077Z361,A0A1X7V1N5,A0A0K0JDP1,A0A0N4UKJ1,A0A498N3A3,A0A3M0IQP5,A0A0L8GBV4,Q32KD4,A0A1J1JBJ0,E0W4C3,T1IBM6,A0A423TSS1,A0A267E8R7,T1KTE4,A0A2C9JGZ6,A0A1V9X9F0,1YVU,5AWH,6QZK,A0A1I7IXT4,A0A2W1JZ37,A0A2S7WBN3,A0A420DFE6,A0A4V1VDY2,A0A368P5I0,A0A4R1RMM2,A0A1Y2RDH8,Q11QW7,A0A0M2PXX3,A0A1L3JHM3,A0A1W6MIP2,A0A1C0UUC4,A0A2U2J9E0,B1XJG0,A0A3D8L290,A0A1T4Y3A2,R6KUL9,A0A1J0AGK2,A0A2G9DT08,Q9L1X1,A0A060HNJ0,A0A235B542,A0A1A5X8H4,A0A1I2T6Q1,A0A1R3T9N6,H8KXJ0,A0A2D1U4H7,A0A0B7I4Z6,A0LL61,A0A1J1EK56,A0A4Q6XKV6,A0A239JE83,A0A2N4XBY2,Q53W94,R5JEI2,A0A0Q0ZC47,A0A2T0XH18,A0A1V4CHV0,A0A1K1RQP7,A0A1N6LUI7,A0A0P0NGR6,A0A1X7IML5,A0A0A2LKJ7,K1L112,A0A0U3AL92,A0A1H3A054,E0UCX3,K9XZC6,A0A0C1VHB4,A0A0C5JKF3,R5NJJ8,A5D4D9,A0A142Y7A9,A0A432MEQ5,A0A372DKU2,C1F5Q7,A0A4R3EV39,A0A1P8WP90,A0A222F7P0,A0A1C9VH88,A0A2T2YMB1,A0A101R2A0,A0A1U9ND56,A0A4R7BQC4,E0TGY3,A0A259TUP4,F6EYI8,A0A2S9Q9J0,A0A4Q2UIU6,A0A1H0LH25,A0A318LG42,A0A2R5G167,A0A346PK63,R7RTW6,M5RSF0,B7K585,A0A343JEE2,,",366,37
"99","C.L3.14","C.L3.9",166,86,80,1.71889534883721,"4F1N,4F3T,4KRE,5VM9,6OON,A0A196SDB4,S4RWI0,A0A074TLL7,A0A3M7S814,G7DVX0,W2T741,A0A075AN09,Q5TW24,A0A2T7PFL8,A0A024FT57,H3HCL6,T1GSU4,F4S231,A0A4D8YSQ3,A0A158PJG6,A0A0C2XG51,A0A158QZT6,T0SAU8,A0A3S1A0C3,A0A2K1J482,A0A1Q3ENA6,O04379,A0A371I3C8,M8AEW7,A0A2K3NY65,A0A409Y6G2,A0A1D1W4K0,A7RQ46,W4YU94,A7BJS5,D8SNM6,A0A1J8PPA3,X1WG39,M5FQK2,Q69VD5,A0A0D8XL16,A0A016WPN3,Q9QZ81,G5EES3,A0A0K0EFP6,Q8CJG0,A0A1D5NTU6,A0A0V0YLH8,A0A139WDH0,A0A0R3W9Q7,H3DS31,A0A1Y1HWP2,G4T5G9,B7QCC4,A0A0B2UV00,M7BCJ9,E9GN30,Q7PZ41,A0A077Z361,R7U9I3,A0A1X7V1N5,A0A0K0JDP1,A0A0N4UKJ1,A0A498N3A3,A0A3M0IQP5,A0A0L8GBV4,Q32KD4,A0A1J1JBJ0,E0W4C3,A0A3P7EJD6,J9K2Z4,A0A2J7Q8V4,T1IBM6,V3ZRX0,A0A210QKF7,A0A423TSS1,K1PT78,A0A267E8R7,A0A1D2N447,A0A226D7A9,F6YK55,T1KTE4,A0A2C9JGZ6,A0A1V9X9F0,A0A3Q0KUG5,T1FY40,3DLB,5AWH,5I4A,A0A1I7IXT4,A0A2W1JZ37,A0A2S7WBN3,A0A420DFE6,A0A4V1VDY2,A0A368P5I0,C4L1M1,A0A4R1RMM2,A0A1Y2RDH8,A0A1M5ZSR3,A0A1L3JHM3,A0A1W6MIP2,A0A142XB92,A0A1Q4R485,A0A1N6SSK9,A0A2G9DT08,Q9L1X1,A0A060HNJ0,A0A496APJ8,A0A1V9G9U4,S7VLM7,A0A1A5X8H4,A0A1I2T6Q1,A0A1R3T9N6,H8KXJ0,A0A2D1U4H7,A0A0B7I4Z6,A0LL61,Q8DKB1,A0A139WY18,A0A2T1E1K4,A0A1Q8ZD62,A0A4Q6XKV6,A0A1Z3HNN4,A0A239JE83,A0A2N4XBY2,R5JEI2,A0A0Q0ZC47,A0A2T0XH18,A0A1V4CHV0,A0A1K1RQP7,A0A1N6LUI7,A0A0P0NGR6,A0A1X7IML5,A0A0A2LKJ7,K1L112,A0A0U3AL92,A0A1H3A054,A0A0C5JKF3,A5D4D9,A0A142Y7A9,A0A432MEQ5,A0A372DKU2,A0A3R7KLK4,A0A1P8WP90,A0A222F7P0,A0A1C9VH88,A0A2T2YMB1,A0A329TD61,A0A101R2A0,A0A1E3XF49,A0A1U9ND56,A0A4R7BQC4,A0A1Q1FPH0,A0A4Q2UIU6,A0A1H0LH25,A0A318LG42,A0A345E7N0,A0A346PK63,M5RSF0,F8D8G0,A0A343TL88,A0A3P3RGE5,A0A0W1S8B8,L9VRQ2,E4NRV1,A0A1I6HGN0,,",366,37
"101","C.H5.12","C.S6.3",156,87,69,1.36231884057971,"4KRE,5VM9,6KR6,6OON,A0A2P6N8X7,A8BCK6,S4RWI0,A0A074TLL7,F4PH46,A0A3M7S814,I0YVB2,D3BMP8,O74957,A0A2G8JLH3,W2T741,A0A388KES6,A0A1S3J512,A0A075AN09,Q5TW24,G2QEV0,A0A2T7PFL8,F4S231,Q5BD61,A0A4D8YSQ3,A0A0C2XG51,A0A158QZT6,R7YY92,A0A3S1A0C3,A0A074YJ47,O04379,A0A371I3C8,M8AEW7,A8P0D4,A0A2K3NY65,A0A409Y6G2,D8PZT7,A0A1D1W4K0,W4YU94,A7BJS5,A0A1J8PPA3,X1WG39,M5FQK2,A0A0D8XL16,A0A016WPN3,Q9QZ81,G5EES3,A0A0K0EFP6,Q8CJG0,A0A1D5NTU6,V2WTL2,A0A0V0YLH8,A0A139WDH0,A0A0R3W9Q7,H3DS31,B7QCC4,A0A0B2UV00,E9GN30,Q7PZ41,A0A077Z361,R7U9I3,A0A1X7V1N5,A0A0K0JDP1,A0A0N4UKJ1,A0A498N3A3,A0A0L8GBV4,Q32KD4,A0A1J1JBJ0,E0W4C3,A0A482XDA9,A0A3P7EJD6,J9K2Z4,A0A2J7Q8V4,T1IBM6,V3ZRX0,A0A210QKF7,A0A423TSS1,K1PT78,A0A267E8R7,A0A1D2N447,A0A226D7A9,F6YK55,T1KTE4,A0A2C9JGZ6,A0A1V9X9F0,K5X5Z7,A0A3Q0KUG5,T1FY40,1YVU,1Z26,5AWH,5G5T,6QZK,A0A1I7IXT4,A0A2W1JZ37,A0A2S7WBN3,A0A420DFE6,E0ST67,A0A4V1VDY2,A0A368P5I0,A0A4R1RMM2,A0A1Y2RDH8,A0A0K8QX04,A0A1I3LMA1,A0A1L3JHM3,A0A2U2J9E0,A0A2Z6E1D5,B1XJG0,A0A1T4Y3A2,Q5P0R2,B6YTQ5,K9UQR0,A0A2T1G8M7,A0A0P6X5X2,A0A1J0AGK2,A0A2G9DT08,Q9L1X1,S7VLM7,A0A1A5X8H4,A0A1I2T6Q1,A0A1R3T9N6,A0A0Q2M2Z1,A0LL61,Q8DKB1,A0A1V4CHV0,A0A0U3AL92,A0A1H3A054,E0UCX3,K9XZC6,A0A0C1VHB4,Q31N05,A0A0C5JKF3,Q2JI93,A0A142Y7A9,A0A372DKU2,A0A4R3EV39,A0A222F7P0,A0A1C9VH88,A0A101R2A0,A0A1U9ND56,A0A4R7BQC4,E0TGY3,A0A259TUP4,A0A4Q2UIU6,A0A1H0LH25,A0A318LG42,A0A1W2A082,A0A0C1XUA0,A0A346PK63,A0A1H2RBI2,W0JW77,B7K585,A0A285N2A8,A0A0W1S8B8,L9VRQ2,E4NRV1,A0A1I6HGN0,,",366,37
"104","C.H1.12","C.H5.9",169,88,81,1.57863355780022,"4F3T,4KRE,6OON,7KX7,J9D5G4,C4LVV2,A0A2P6N8X7,A8BCK6,T1H8B3,D2VMG4,A0A0D1ZAJ4,Q1K660,F4PH46,A0A3M7S814,A0A164ZA52,R7QGN7,R9ACY5,D3BMP8,A0A1Z5TVE5,W7XD45,A0A1U7LLR0,A0A4S2MWZ7,V6R0U9,B7Q5I1,D5GGK8,S8ANP9,L2GMR6,A0A0E9NDK5,T1KZ60,A0A2G8JLH3,A0A1W0E4B5,A0A2J7QB22,S4RYE2,A0A226EFL3,A0A0L0TEV1,A0A1S3J512,G0QTT2,A0A1J1HRI1,C4V9J2,A0A075AN09,Q5TW24,A0A2B4RHN2,A0A2T7PFL8,K7ISV0,A0A0G4IME3,A0A1S3CYL5,T1GSU4,J9JZ66,A0A0C2XG51,A0A158QZT6,T0SAU8,R7YY92,A0A3S1A0C3,A0A1Q3ENA6,A0A1D1W4K0,A7RQ46,A7BJS5,X1WG39,M5FQK2,A0A0D8XL16,A0A139WDH0,A0A0R3W9Q7,H3DS31,B7QCC4,A0A0B2UV00,E9GN30,Q7PZ41,A0A1X7V1N5,A0A0K0JDP1,A0A0N4UKJ1,A0A0L8GBV4,Q32KD4,A0A1J1JBJ0,E0W4C3,A0A3P7EJD6,J9K2Z4,A0A2J7Q8V4,T1IBM6,V3ZRX0,A0A210QKF7,A0A423TSS1,K1PT78,A0A267E8R7,A0A226D7A9,T1KTE4,A0A2C9JGZ6,A0A1V9X9F0,A0A3Q0KUG5,1Z26,3DLB,5AWH,5I4A,E8N0K8,E0ST67,C4L1M1,A0A1I3LMA1,K9TPA9,K9U8J6,K9RC91,A0A139XGN8,A0A1T4Y3A2,Q5P0R2,A0YYT3,R6KUL9,A0A433NB65,A0A1Z4L0A1,A0A2T1G8M7,B7GJX9,A0A0P6X5X2,A0A1Z4K1Y3,K9PFF9,A0A2G9DT08,Q9L1X1,A0A235B542,R5XQK4,A0A1R3T9N6,A0A0Q2M2Z1,A0LL61,A0A139WY18,A0A1J1EK56,A0A2T1E1K4,A0A1Z3HNN4,A0A1V4CHV0,A0A2T1EKT1,A0A1N6LUI7,A0A0C1VHB4,Q31N05,R5NJJ8,A5D4D9,Q2JI93,A0A142Y7A9,A0A432MEQ5,A0A3R7KLK4,A0A4R3EV39,A0A1P8WP90,A0A222F7P0,A0A329TD61,A0A101R2A0,A0A4R7BQC4,E0TGY3,A0A259TUP4,F6EYI8,A0A2S9Q9J0,A0A4Q2UIU6,A0A1H0LH25,A0A318LG42,L0JS08,A0A345E7N0,M0AF24,A0A1H3X247,A0A0C1XUA0,M0D2X3,A0A2R5G167,A0A1H2RBI2,B9LVP8,M5RSF0,W0JW77,B7K585,F8D8G0,A0A343TL88,L0AJX6,A0A2A5QS34,A0A3P3RGE5,A0A329TBQ3,A0A285N2A8,A0A0W1S8B8,A0A1V4C8L7,L9VRQ2,E4NRV1,,",366,37
"107","C.L2.1","C.L2.6",178,88,90,2.19305555555556,"4F3T,4KRE,5VM9,6KR6,7KX7,7SWF,J9D5G4,S4RWI0,A0A3M7S814,I0YVB2,C1DZY0,A0CB11,R9ACY5,W7XD45,B7Q5I1,L2GMR6,A6N7Y9,A0A2G8JLH3,W2T741,A0A1W0E4B5,A0A2J7QB22,S4RYE2,A0A1S3J512,G0QTT2,Q9JMB7,A0A401PRI6,Q96J94,A0A2B4RHN2,A0A2T7PFL8,K7ISV0,A0A0G4IME3,A0A2G5B1D8,A0A4D8YSQ3,A0A158PJG6,A0A0C2XG51,A0A158QZT6,A0A165QYQ9,A0A3S1A0C3,A0A074YJ47,A0A2K1J482,A0A1Q3ENA6,O04379,A0A371I3C8,M8AEW7,A0A2K3NY65,A0A409Y6G2,D8SNM6,A0A1J8PPA3,X1WG39,M5FQK2,Q69VD5,A0A0D8XL16,A0A016WPN3,Q9QZ81,G5EES3,A0A0K0EFP6,Q8CJG0,A0A1D5NTU6,A0A0V0YLH8,A0A0R3W9Q7,H3DS31,A0A1Y1HWP2,G4T5G9,B7QCC4,A0A0B2UV00,M7BCJ9,E9GN30,A0A077Z361,A0A1X7V1N5,A0A0K0JDP1,A0A0N4UKJ1,A0A498N3A3,A0A3M0IQP5,A0A0L8GBV4,A0A3P7EJD6,V3ZRX0,A0A210QKF7,A0A423TSS1,K1PT78,A0A267E8R7,A0A1D2N447,A0A226D7A9,T1KTE4,A0A2C9JGZ6,A0A1V9X9F0,K5X5Z7,A0A3Q0KUG5,T1FY40,1YVU,5G5T,6QZK,A0A1I7IXT4,A0A2W1JZ37,A0A2S7WBN3,A0A420DFE6,A0A4V1VDY2,A0A368P5I0,A0A4R1RMM2,A0A1Y2RDH8,Q11QW7,A0A1M5ZSR3,A0A0K8QX04,A0A0M2PXX3,K9TPA9,A0A1L3JHM3,A0A1W6MIP2,A0A2U2J9E0,A0A2Z6E1D5,A0A0F4NXW8,L8D0R3,B1XJG0,A0A1Q4R485,K9U8J6,A0A0D8ZUC0,A0A139XGN8,Q5P0R2,A0YYT3,A0A2T1EFY0,A0A433NB65,A0A1Z4L0A1,K9UQR0,A0A2T1G8M7,K9VUN0,K9ZDE3,A0A2T1LS63,A0A1Z4K1Y3,A0A2Z6E0R7,A0A0V7ZCG4,A0A1J0AGK2,K9PFF9,K9UEV4,A0A496APJ8,A0A1V9G9U4,A0A0Q2M2Z1,Q8DKB1,A0A139WY18,A0A2T1E1K4,A0A1Q8ZD62,A0A1Z3HNN4,A0A2T1EKT1,A0A0C1VHB4,Q31N05,R5NJJ8,Q2JI93,A0A372DKU2,A0A3R7KLK4,A0A1E3XF49,A0A1H3DGN3,A0A1Q1FPH0,H1YCU5,L0JS08,A0A1Q5ZS75,A0A345E7N0,M0AF24,A0A1W2A082,A0A1H3X247,A0A0C1XUA0,M0D2X3,A0A346PK63,R7RTW6,A0A1H2RBI2,A0A1C3ZXN2,B9LVP8,W0JW77,F8D8G0,A0A343TL88,L0AJX6,A0A2A5QS34,A0A343JEE2,A0A3P3RGE5,A0A329TBQ3,A0A285N2A8,A0A0W1S8B8,A0A1V4C8L7,L9VRQ2,E4NRV1,A0A1I6HGN0,A0A1I0NI68,,",366,37
"110","C.L23.11","C.S13.1",145,89,56,2.05477528089888,"4F1N,6KR6,7KX7,A0A163JTZ6,A0A196SDB4,Q389P5,C4LVV2,Q1K660,F4PH46,A0A3M7S814,A0A164ZA52,S7WCF7,R7QGN7,A0A2C5Z0M1,A0CB11,R9ACY5,D3BMP8,A0A1Z5TVE5,W7XD45,A0A1U7LLR0,A0A4S2MWZ7,A0A158P1R9,G7DVX0,V6R0U9,G4N9J3,E3KLI3,B7Q5I1,D5GGK8,S8ANP9,A0A139AUH8,L2GMR6,U4LBG4,A0A177URI1,O74957,A0A3N4IGK1,A6N7Y9,A0A0E9NDK5,T1KZ60,A0A250WXN5,Q5KAT1,L2GUF2,W2T741,S4RYE2,A0A0L0TEV1,A0A1S3J512,G0QTT2,A0A1J1HRI1,Q9JMB7,A0A075AN09,A0A401PRI6,Q96J94,G2QEV0,A0A397UU01,A0A024FT57,H3HCL6,A0A0G4IME3,E9FUN9,A0A1Y1YHC8,F4S231,A0A1D8PMK0,A0A2G5B1D8,Q5BD61,A0A1C7M8P2,J9JZ66,A0A158QZT6,A0A165QYQ9,T0SAU8,R7YY92,A0A074YJ47,A0A2K1J482,A0A1Q3ENA6,A0A371I3C8,A8P0D4,F4NYW7,A0A409Y6G2,A0A0L0HAB7,D8PZT7,D8SNM6,A0A1J8PPA3,M5FQK2,A0A2R6NSC2,Q9QZ81,V2WTL2,A0A0V0YLH8,A0A1Y1HWP2,G4T5G9,E0W4C3,K1PT78,K5X5Z7,1YVU,A0A1I7IXT4,A0A420DFE6,C4L1M1,A0A1Y2RDH8,Q11QW7,A0A1M5ZSR3,A0A1W6MIP2,A0A2Z6E1D5,B1XJG0,A0A0B0H9B4,B7GJX9,A0A0P6X5X2,A0A1N6SSK9,A0A2G9DT08,Q9L1X1,A0A235B542,R5XQK4,A0A062U2W9,A0A1V9G9U4,A0A1I2ZGP1,F8ERC7,A0A1I2T6Q1,A0A1R3T9N6,A0A0Q2M2Z1,D3S0S6,Q8DKB1,A0A139WY18,A0A1J1EK56,A0A1Z3HNN4,Q53W94,R5JEI2,A0A2T1EKT1,E0UCX3,K9XZC6,A0A0C1VHB4,A5D4D9,Q2JI93,A0A222F7P0,E0TGY3,M0AF24,M0D2X3,A0A346PK63,R7RTW6,B7K585,F8D8G0,A0A343TL88,A0A3P3RGE5,A0A329TBQ3,A0A285N2A8,A0A0W1S8B8,A0A1V4C8L7,L9VRQ2,E4NRV1,A0A1I6HGN0,A0A1I0NI68,,",366,37
"116","C.H9.8","C.S11.3",158,91,67,1.479088076103,"4F1N,5GUH,5VM9,A0A163JTZ6,A0A0N4X8S8,A0A2P6N8X7,D2VMG4,A0A074TLL7,F4PH46,A0A3M7S814,A0A383WDW5,Q54G64,S7WCF7,R7QGN7,C1DZY0,D3BMP8,W7XD45,A0A1U7LLR0,K1VVQ6,A0A158P1R9,G4N9J3,B7Q5I1,A0A139AUH8,L2GMR6,U4LBG4,O74957,A6N7Y9,A0A0E9NDK5,A0A250WXN5,Q5KAT1,L2GUF2,A0A226EFL3,A0A3S3PD82,A0A0L0TEV1,A0A1J1HRI1,Q9JMB7,Q5TW24,U5HIG6,A0A401PRI6,Q96J94,A0A397UU01,A0A024FT57,A0A0G4IME3,E9FUN9,A0A1S3CYL5,D7FQK3,A0A1Y1YHC8,T1GSU4,Q5BD61,A0A4D8YSQ3,J9JZ66,T0SAU8,A0A074YJ47,A0A2K1J482,A0A1Q3ENA6,O04379,A0A371I3C8,M8AEW7,A8P0D4,A0A2K3NY65,A0A409Y6G2,D8PZT7,W4YU94,A7BJS5,D8SNM6,A0A1J8PPA3,M5FQK2,Q69VD5,V2WTL2,A0A0V0YLH8,A0A139WDH0,A0A1Y1HWP2,B7QCC4,E9GN30,Q7PZ41,A0A077Z361,R7U9I3,Q32KD4,A0A1J1JBJ0,E0W4C3,A0A482XDA9,J9K2Z4,A0A2J7Q8V4,T1IBM6,A0A423TSS1,K1PT78,A0A1D2N447,A0A226D7A9,F6YK55,A0A1V9X9F0,T1FY40,5AWH,5G5T,5I4A,A0A1I7IXT4,A0A2W1JZ37,A0A2S7WBN3,A0A328VKE4,A0A420DFE6,A0A4V1VDY2,A0A368P5I0,A0A4R1RMM2,A0A1Y2RDH8,Q11QW7,A0A1M5ZSR3,A0A1L3JHM3,A0A1W6MIP2,A0A2U2J9E0,A0A3D8L290,A0A1Q4R485,A0A1T4Y3A2,B6YTQ5,A0A2T1EFY0,A0A2G9DT08,Q9L1X1,A0A496APJ8,A0A1A5X8H4,A0A1I2T6Q1,A0A1R3T9N6,I3TE64,A0A0B7I4Z6,A0LL61,Q8DKB1,A0A139WY18,A0A2T1E1K4,A0A1Q8ZD62,R5JEI2,A0A1V4CHV0,A0A1K1RQP7,A0A1N6LUI7,A0A0U3AL92,A0A1H3A054,Q31N05,A0A0C5JKF3,A5D4D9,A0A142Y7A9,A0A432MEQ5,A0A372DKU2,C1F5Q7,A0A4R3EV39,A0A1P8WP90,A0A222F7P0,A0A1C9VH88,A0A2T2YMB1,A0A101R2A0,A0A1U9ND56,A0A4R7BQC4,E0TGY3,A0A259TUP4,F6EYI8,A0A2S9Q9J0,A0A4Q2UIU6,A0A1H0LH25,A0A318LG42,A0A2R5G167,M5RSF0,B7K585,A0A343JEE2,,",366,37
"118","N.L22.1","N.S17.3",155,91,64,1.58980082417582,"4F3T,4KRE,5VM9,6OON,7SWF,A0A2P6N8X7,R1FDF0,S4RWI0,A0A074TLL7,F4PH46,A0A3M7S814,A0A164ZA52,A0A383WDW5,Q54G64,C1DZY0,R9ACY5,A0A1Z5TVE5,W7XD45,A0A1U7LLR0,G7DVX0,E3KLI3,D5GGK8,S8ANP9,A0A177URI1,O74957,A6N7Y9,A0A0E9NDK5,T1KZ60,A0A2K3CW87,A0A226EFL3,A0A3S3PD82,G0QTT2,A0A075AN09,A0A401PRI6,G2QEV0,A0A2T7PFL8,T1GSU4,F4S231,A0A1D8PMK0,A0A4D8YSQ3,T0SAU8,A0A3S1A0C3,A0A1Q3ENA6,A0A2K3NY65,F4NYW7,A0A409Y6G2,A0A1D1W4K0,A7RQ46,W4YU94,A7BJS5,A0A1J8PPA3,X1WG39,M5FQK2,A0A2R6NSC2,Q9QZ81,A0A0K0EFP6,Q8CJG0,A0A1D5NTU6,A0A139WDH0,A0A0R3W9Q7,G4T5G9,B7QCC4,M7BCJ9,E9GN30,Q7PZ41,R7U9I3,A0A1X7V1N5,A0A0N4UKJ1,A0A498N3A3,A0A3M0IQP5,A0A0L8GBV4,Q32KD4,A0A1J1JBJ0,E0W4C3,A0A482XDA9,A0A3P7EJD6,J9K2Z4,A0A2J7Q8V4,T1IBM6,V3ZRX0,A0A210QKF7,A0A423TSS1,K1PT78,A0A1D2N447,A0A226D7A9,T1KTE4,A0A2C9JGZ6,A0A1V9X9F0,K5X5Z7,A0A3Q0KUG5,T1FY40,5G5T,5I4A,E0ST67,Q11QW7,B1XJG0,A0A0P6X5X2,A0A496APJ8,S7VLM7,A0A1A5X8H4,A0A1I2T6Q1,H8KXJ0,D3S0S6,A0A2D1U4H7,A0A0B7I4Z6,A0A139WY18,A0A1J1EK56,A0A2T1E1K4,A0A1Q8ZD62,A0A4Q6XKV6,A0A1Z3HNN4,A0A239JE83,A0A2N4XBY2,Q53W94,R5JEI2,A0A2T0XH18,A0A1V4CHV0,A0A1K1RQP7,A0A0P0NGR6,A0A1X7IML5,A0A0A2LKJ7,K1L112,A0A0U3AL92,E0UCX3,K9XZC6,Q31N05,A5D4D9,Q2JI93,A0A142Y7A9,A0A372DKU2,A0A1P8WP90,A0A2T2YMB1,A0A329TD61,A0A1E3XF49,A0A1U9ND56,A0A4R7BQC4,A0A1Q1FPH0,E0TGY3,F6EYI8,A0A4Q2UIU6,A0A1H0LH25,A0A1W2A082,A0A1H3X247,A0A0C1XUA0,M0D2X3,A0A2R5G167,A0A346PK63,R7RTW6,A0A1C3ZXN2,B9LVP8,B7K585,F8D8G0,A0A343JEE2,A0A1V4C8L7,A0A1I0NI68,,",366,37
"120","C.H8.13","C.S12.2",198,92,106,2.12223133716161,"4F3T,4KRE,6OON,7SWF,A0A0N4X8S8,J9D5G4,A0A2P6N8X7,A8BCK6,A2DPV7,T1H8B3,R1FDF0,S4RWI0,Q1K660,F4PH46,A0A3M7S814,S7WCF7,I0YVB2,A0A2C5Z0M1,A0A1U7LLR0,A0A4S2MWZ7,G7DVX0,L2GMR6,U4LBG4,O74957,A0A3N4IGK1,A0A0E9NDK5,T1KZ60,Q5KAT1,A0A2J7QB22,A0A388KES6,A0A226EFL3,A0A3S3PD82,A0A1J1HRI1,C4V9J2,Q9JMB7,Q5TW24,U5HIG6,A0A2T7PFL8,H3HCL6,A0A0G4IME3,A0A1S3CYL5,D7FQK3,T1GSU4,F4S231,A0A2G5B1D8,A0A0C2XG51,A0A3S1A0C3,A0A1D1W4K0,A7RQ46,W4YU94,A7BJS5,X1WG39,Q9QZ81,G5EES3,A0A0K0EFP6,Q8CJG0,A0A1D5NTU6,V2WTL2,A0A0V0YLH8,A0A139WDH0,A0A0R3W9Q7,H3DS31,B7QCC4,M7BCJ9,E9GN30,Q7PZ41,A0A077Z361,R7U9I3,A0A1X7V1N5,A0A498N3A3,A0A3M0IQP5,A0A0L8GBV4,Q32KD4,A0A1J1JBJ0,E0W4C3,A0A482XDA9,A0A3P7EJD6,J9K2Z4,A0A2J7Q8V4,T1IBM6,V3ZRX0,A0A210QKF7,A0A423TSS1,K1PT78,A0A267E8R7,A0A1D2N447,A0A226D7A9,F6YK55,A0A2C9JGZ6,A0A1V9X9F0,A0A3Q0KUG5,T1FY40,3DLB,5AWH,6QZK,E8N0K8,A0A328VKE4,E0ST67,C4L1M1,A0A0K8QX04,A0A1I3LMA1,K9TPA9,A0A2Z6E1D5,A0A0F4NXW8,L8D0R3,B1XJG0,A0A326U7G5,A0A1Q4R485,K9U8J6,A0A097QRL6,K9RC91,A0A0D8ZUC0,A0A139XGN8,A0A1T4Y3A2,Q5P0R2,A0A0B0H9B4,A0YYT3,A0A2T1EFY0,G6FTN0,A0A433NB65,A0A1Z4L0A1,K9UQR0,A0A2T1G8M7,K9VUN0,B7GJX9,A0A0P6X5X2,K9ZDE3,B0JXD6,A0A2T1LS63,A0A1Z4K1Y3,A0A2Z6E0R7,A0A1N6SSK9,A0A0P4UVI8,A0A0V7ZCG4,A0A1J0AGK2,K9PFF9,A0A2G9DT08,K9UEV4,A0A235B542,A0A1H3LE92,A0A496APJ8,A0A1V9G9U4,F8ERC7,S7VLM7,A0A1A5X8H4,A0A1I2T6Q1,A0A1R3T9N6,A0A0B7I4Z6,A0LL61,A0A139WY18,A0A1J1EK56,A0A2T1E1K4,A0A1Q8ZD62,A0A1Z3HNN4,A0A239JE83,Q53W94,A0A1V4CHV0,A0A2T1EKT1,A0A0P0NGR6,K9XZC6,A0A0C1VHB4,A0A0C5JKF3,R5NJJ8,A5D4D9,A0A372DKU2,A0A222F7P0,A0A1C9VH88,A0A329TD61,A0A101R2A0,A0A1E3XF49,A0A4R7BQC4,A0A1Q1FPH0,E0TGY3,A0A259TUP4,F6EYI8,A0A2S9Q9J0,A0A4Q2UIU6,H1YCU5,L0JS08,A0A345E7N0,M0AF24,A0A1W2A082,A0A1H3X247,M0D2X3,A0A346PK63,R7RTW6,A0A1H2RBI2,A0A1C3ZXN2,B9LVP8,W0JW77,A0A343TL88,A0A343JEE2,A0A3P3RGE5,A0A329TBQ3,A0A0W1S8B8,L9VRQ2,E4NRV1,A0A1I6HGN0,,",366,37
"124","N.S11.9","N.S9.2",131,93,38,1.4804753820034,"C4LVV2,A2DPV7,T1H8B3,R1FDF0,S4RWI0,A0A074TLL7,A0A0D1ZAJ4,A0A3M7S814,A0A164ZA52,C1DZY0,D3BMP8,W7XD45,A0A1U7LLR0,A0A4S2MWZ7,G7DVX0,E3KLI3,A0A1E3QC61,S8ANP9,L2GMR6,U4LBG4,A0A177URI1,O74957,Q5KAT1,W2T741,A0A1W0E4B5,A0A2K3CW87,A0A388KES6,A0A0L0TEV1,A0A075AN09,G2QEV0,A0A397UU01,A0A024FT57,H3HCL6,D7FQK3,A0A1Y1YHC8,T1GSU4,F4S231,A0A2G5B1D8,Q5BD61,A0A158PJG6,A0A158QZT6,A0A165QYQ9,T0SAU8,A0A1Q3ENA6,A8P0D4,F4NYW7,A0A409Y6G2,A0A0L0HAB7,A0A1D1W4K0,W4YU94,A7BJS5,A0A1J8PPA3,X1WG39,A0A0D8XL16,A0A016WPN3,Q9QZ81,G5EES3,A0A0K0EFP6,Q8CJG0,A0A1D5NTU6,A0A0V0YLH8,A0A139WDH0,A0A0R3W9Q7,H3DS31,A0A1Y1HWP2,G4T5G9,B7QCC4,A0A0B2UV00,M7BCJ9,E9GN30,Q7PZ41,A0A077Z361,R7U9I3,A0A1X7V1N5,A0A0K0JDP1,A0A0N4UKJ1,A0A498N3A3,A0A3M0IQP5,A0A0L8GBV4,Q32KD4,A0A1J1JBJ0,E0W4C3,A0A3P7EJD6,J9K2Z4,A0A2J7Q8V4,V3ZRX0,A0A210QKF7,K1PT78,A0A226D7A9,T1KTE4,A0A2C9JGZ6,A0A1V9X9F0,A0A3Q0KUG5,3DLB,5I4A,6QZK,Q11QW7,F8ERC7,S7VLM7,A0A2D1U4H7,A0A1J1EK56,Q53W94,A0A4R3EV39,A0A1P8WP90,A0A329TD61,A0A1U9ND56,A0A1Q1FPH0,A0A259TUP4,F6EYI8,A0A2S9Q9J0,A0A4Q2UIU6,H1YCU5,A0A345E7N0,A0A1W2A082,A0A1H3X247,A0A0C1XUA0,A0A2R5G167,A0A346PK63,A0A1H2RBI2,B9LVP8,M5RSF0,B7K585,A0A343TL88,A0A3P3RGE5,A0A329TBQ3,A0A285N2A8,A0A0W1S8B8,L9VRQ2,E4NRV1,A0A1I6HGN0,A0A1I0NI68,,",366,37
"127","C.H9.5","C.S12.5",193,94,99,1.30915538362347,"4F3T,4KRE,5VM9,6KR6,6OON,J9D5G4,Q389P5,A8BCK6,A0A3M7S814,A0A164ZA52,Q54G64,R7QGN7,C1DZY0,A0A2C5Z0M1,D3BMP8,A0A1Z5TVE5,W7XD45,A0A4S2MWZ7,G7DVX0,A0A1E3QC61,D5GGK8,A0A139AUH8,O74957,A0A3N4IGK1,A6N7Y9,A0A0E9NDK5,A0A250WXN5,L2GUF2,W2T741,A0A2J7QB22,A0A388KES6,A0A226EFL3,G0QTT2,Q9JMB7,A0A401PRI6,Q96J94,G2QEV0,A0A2T7PFL8,D7FQK3,T1GSU4,A0A1D8PMK0,A0A2G5B1D8,A0A1C7M8P2,A0A158PJG6,A0A158QZT6,A0A165QYQ9,R7YY92,A0A3S1A0C3,F4NYW7,A0A409Y6G2,A0A1D1W4K0,A7RQ46,W4YU94,A7BJS5,X1WG39,A0A0D8XL16,A0A016WPN3,Q9QZ81,G5EES3,A0A0K0EFP6,Q8CJG0,A0A1D5NTU6,A0A0V0YLH8,A0A139WDH0,H3DS31,A0A1Y1HWP2,A0A0B2UV00,M7BCJ9,E9GN30,Q7PZ41,R7U9I3,A0A0K0JDP1,A0A0N4UKJ1,A0A498N3A3,A0A3M0IQP5,A0A0L8GBV4,Q32KD4,A0A1J1JBJ0,E0W4C3,A0A482XDA9,J9K2Z4,A0A2J7Q8V4,T1IBM6,V3ZRX0,A0A210QKF7,A0A423TSS1,K1PT78,A0A1D2N447,A0A226D7A9,F6YK55,T1KTE4,A0A2C9JGZ6,A0A1V9X9F0,A0A3Q0KUG5,1YVU,3DLB,5AWH,6QZK,7R8K,A0A1I7IXT4,A0A2W1JZ37,A0A2S7WBN3,A0A420DFE6,A0A4V1VDY2,C4L1M1,A0A0M2PXX3,A0A1C0UUC4,A0A2U2J9E0,A0A0F4NXW8,A0A142XB92,L8D0R3,A0A3D8L290,A0A1Q4R485,K9U8J6,K9RC91,A0A1T4Y3A2,A0A0B0H9B4,R6KUL9,A0A1Z4L0A1,B7GJX9,A0A1N6SSK9,A0A0V7ZCG4,K9PFF9,A0A2G9DT08,Q9L1X1,A0A060HNJ0,R5XQK4,A0A062U2W9,H0HWQ5,A0A1I2ZGP1,A0A317EJY3,A0A1I2BD20,F8ERC7,S7VLM7,A0A1R3T9N6,H8KXJ0,A0A2D1U4H7,A0A0B7I4Z6,Q8DKB1,A0A4Q6XKV6,A0A1Z3HNN4,A0A239JE83,A0A2N4XBY2,R5JEI2,A0A0Q0ZC47,A0A2T0XH18,A0A1K1RQP7,A0A1X7IML5,A0A0A2LKJ7,K1L112,K9XZC6,A0A0C1VHB4,A0A0C5JKF3,R5NJJ8,A5D4D9,A0A432MEQ5,A0A372DKU2,C1F5Q7,A0A4R3EV39,A0A1P8WP90,A0A222F7P0,A0A2T2YMB1,A0A329TD61,A0A101R2A0,A0A1E3XF49,A0A1Q1FPH0,E0TGY3,A0A259TUP4,A0A4Q2UIU6,A0A1H0LH25,A0A318LG42,H1YCU5,L0JS08,A0A1Q5ZS75,M0AF24,A0A1H3X247,A0A0C1XUA0,M0D2X3,A0A346PK63,R7RTW6,A0A1H2RBI2,A0A1C3ZXN2,B9LVP8,M5RSF0,W0JW77,F8D8G0,L0AJX6,A0A2A5QS34,A0A343JEE2,A0A3P3RGE5,A0A285N2A8,A0A1V4C8L7,A0A1I0NI68,,",366,37
"129","C.S5.1","C.S5.3",132,94,38,1.21724524076148,"4F3T,4KRE,6OON,7SWF,A0A163JTZ6,A0A0N4X8S8,A0A196SDB4,J9D5G4,Q389P5,A8BCK6,T1H8B3,S4RWI0,A0A074TLL7,A0A3M7S814,I0YVB2,R7QGN7,C1DZY0,A0A2C5Z0M1,A0CB11,R9ACY5,A0A4S2MWZ7,A0A158P1R9,G7DVX0,V6R0U9,G4N9J3,E3KLI3,D5GGK8,S8ANP9,A0A139AUH8,U4LBG4,A0A177URI1,A0A3N4IGK1,T1KZ60,W2T741,G0QTT2,A0A075AN09,A0A397UU01,A0A2T7PFL8,H3HCL6,A0A1S3CYL5,A0A1Y1YHC8,Q5BD61,A0A0C2XG51,T0SAU8,A0A3S1A0C3,A0A074YJ47,A0A1Q3ENA6,F4NYW7,A0A1D1W4K0,W4YU94,A7BJS5,A0A1J8PPA3,X1WG39,A0A2R6NSC2,A0A0D8XL16,A0A016WPN3,Q9QZ81,G5EES3,Q8CJG0,A0A1D5NTU6,A0A0V0YLH8,A0A139WDH0,A0A0R3W9Q7,B7QCC4,A0A0B2UV00,M7BCJ9,Q7PZ41,A0A077Z361,R7U9I3,A0A0K0JDP1,A0A0N4UKJ1,A0A498N3A3,A0A3M0IQP5,A0A0L8GBV4,Q32KD4,A0A1J1JBJ0,E0W4C3,A0A482XDA9,A0A3P7EJD6,J9K2Z4,A0A2J7Q8V4,T1IBM6,V3ZRX0,A0A210QKF7,K1PT78,A0A267E8R7,A0A1D2N447,A0A226D7A9,F6YK55,T1KTE4,A0A2C9JGZ6,A0A1V9X9F0,A0A3Q0KUG5,T1FY40,5I4A,C4L1M1,Q11QW7,A0A0M2PXX3,A0A1C0UUC4,L8D0R3,H1KXR6,A0A1T4Y3A2,K9UQR0,A0A0P6X5X2,A0A1N6SSK9,K9UEV4,A0A235B542,A0A496APJ8,A0A1I2T6Q1,D3S0S6,I3TE64,A0A0B7I4Z6,A0LL61,A0A4Q6XKV6,A0A1Z3HNN4,A0A0Q0ZC47,A0A1K1RQP7,A0A1N6LUI7,A0A0A2LKJ7,A0A0U3AL92,A0A1H3A054,A0A0C5JKF3,A0A142Y7A9,A0A372DKU2,A0A3R7KLK4,A0A222F7P0,A0A1C9VH88,A0A2T2YMB1,A0A1U9ND56,A0A4R7BQC4,A0A1H3DGN3,E0TGY3,,",366,37
"136","C.H3.6","C.S5.4",158,96,62,1.51680107526882,"4F1N,5GUH,7KX7,7SWF,A0A163JTZ6,A0A196SDB4,Q389P5,C4LVV2,A0A2P6N8X7,A8BCK6,T1H8B3,A0A0D1ZAJ4,Q1K660,A0A164ZA52,A0A383WDW5,Q54G64,S7WCF7,I0YVB2,R7QGN7,C1DZY0,A0A2C5Z0M1,A0CB11,R9ACY5,A0A1Z5TVE5,A0A1U7LLR0,A0A4S2MWZ7,K1VVQ6,G7DVX0,V6R0U9,G4N9J3,E3KLI3,B7Q5I1,A0A1E3QC61,D5GGK8,S8ANP9,A0A139AUH8,U4LBG4,O74957,A0A3N4IGK1,A0A0E9NDK5,T1KZ60,Q5KAT1,L2GUF2,A0A2J7QB22,S4RYE2,A0A388KES6,A0A226EFL3,A0A3S3PD82,A0A0L0TEV1,A0A1J1HRI1,C4V9J2,Q9JMB7,A0A075AN09,Q5TW24,U5HIG6,A0A401PRI6,Q96J94,G2QEV0,A0A397UU01,A0A024FT57,H3HCL6,A0A0G4IME3,E9FUN9,A0A1S3CYL5,D7FQK3,A0A1Y1YHC8,F4S231,A0A1D8PMK0,Q5BD61,A0A1C7M8P2,A0A4D8YSQ3,A0A158PJG6,A0A0C2XG51,A0A165QYQ9,T0SAU8,R7YY92,A0A074YJ47,A0A2K1J482,A0A1Q3ENA6,O04379,A0A371I3C8,M8AEW7,A8P0D4,A0A2K3NY65,F4NYW7,A0A409Y6G2,A0A0L0HAB7,D8PZT7,D8SNM6,A0A1J8PPA3,M5FQK2,A0A2R6NSC2,V2WTL2,A0A1Y1HWP2,G4T5G9,K5X5Z7,5AWH,E8N0K8,A0A328VKE4,C4L1M1,Q11QW7,A0A0M2PXX3,A0A1I3LMA1,K9TPA9,A0A142XB92,A0A326U7G5,A0A3D8L290,A0A1Q4R485,K9RC91,A0A0D8ZUC0,A0A139XGN8,A0A1T4Y3A2,A0A2T1EFY0,A0A2T1G8M7,K9VUN0,A0A1N6SSK9,A0A0P4UVI8,A0A0V7ZCG4,A0A1J0AGK2,A0A2G9DT08,K9UEV4,A0A235B542,A0A1H3LE92,A0A496APJ8,S7VLM7,A0A1I2T6Q1,I3TE64,A0A0B7I4Z6,A0LL61,A0A139WY18,A0A4Q6XKV6,A0A1Z3HNN4,A0A239JE83,A0A2N4XBY2,Q53W94,A0A0Q0ZC47,A0A2T0XH18,A0A1K1RQP7,A0A1X7IML5,A0A0A2LKJ7,K1L112,F6EYI8,A0A2S9Q9J0,A0A4Q2UIU6,A0A1H3X247,B9LVP8,M5RSF0,W0JW77,A0A343TL88,L0AJX6,A0A2A5QS34,A0A3P3RGE5,A0A329TBQ3,A0A285N2A8,A0A0W1S8B8,L9VRQ2,E4NRV1,A0A1I6HGN0,,",366,37
"141","N.L25.2","N.S2.4",149,96,53,1.75707547169811,"4KRE,5GUH,6KR6,6OON,Q389P5,C4LVV2,A8BCK6,A2DPV7,A0A0G4H2S4,S4RWI0,D2VMG4,A0A074TLL7,A0A0D1ZAJ4,A0A164ZA52,A0A2C5Z0M1,A0CB11,A0A1Z5TVE5,W7XD45,A0A1U7LLR0,A0A4S2MWZ7,K1VVQ6,G7DVX0,V6R0U9,E3KLI3,A0A1E3QC61,D5GGK8,S8ANP9,A0A139AUH8,O74957,A0A3N4IGK1,L2GUF2,A0A2K3CW87,A0A388KES6,A0A226EFL3,A0A0L0TEV1,G0QTT2,A0A1J1HRI1,C4V9J2,A0A075AN09,Q5TW24,U5HIG6,A0A2B4RHN2,A0A397UU01,A0A2T7PFL8,A0A0G4IME3,A0A1Y1YHC8,A0A2G5B1D8,Q5BD61,A0A1C7M8P2,A0A158PJG6,A0A0C2XG51,A0A158QZT6,A0A165QYQ9,R7YY92,A0A3S1A0C3,A0A074YJ47,A0A1Q3ENA6,A0A409Y6G2,A0A0L0HAB7,D8PZT7,A7RQ46,A0A1J8PPA3,X1WG39,M5FQK2,A0A2R6NSC2,A0A0D8XL16,A0A016WPN3,Q9QZ81,G5EES3,A0A0K0EFP6,Q8CJG0,A0A1D5NTU6,A0A0V0YLH8,A0A0R3W9Q7,H3DS31,A0A1Y1HWP2,A0A0B2UV00,M7BCJ9,A0A077Z361,R7U9I3,A0A1X7V1N5,A0A0K0JDP1,A0A0N4UKJ1,A0A498N3A3,A0A3M0IQP5,A0A0L8GBV4,A0A3P7EJD6,V3ZRX0,A0A210QKF7,K1PT78,A0A267E8R7,F6YK55,A0A2C9JGZ6,K5X5Z7,A0A3Q0KUG5,T1FY40,1YVU,A0A326U7G5,A0A1Q4R485,K9UQR0,K9ZDE3,B0JXD6,K9UEV4,S7VLM7,H8KXJ0,A0A2D1U4H7,A0A0B7I4Z6,A0LL61,A0A4Q6XKV6,A0A239JE83,A0A2N4XBY2,R5JEI2,A0A0Q0ZC47,A0A2T0XH18,A0A1V4CHV0,A0A1K1RQP7,A0A1N6LUI7,A0A0P0NGR6,A0A1X7IML5,A0A0A2LKJ7,K1L112,R5NJJ8,A5D4D9,A0A372DKU2,C1F5Q7,A0A1C9VH88,A0A2T2YMB1,A0A101R2A0,A0A1U9ND56,A0A4R7BQC4,E0TGY3,F6EYI8,H1YCU5,L0JS08,A0A1Q5ZS75,M0AF24,M0D2X3,A0A346PK63,R7RTW6,A0A1C3ZXN2,B9LVP8,A0A343TL88,A0A3P3RGE5,A0A329TBQ3,A0A0W1S8B8,A0A1V4C8L7,L9VRQ2,E4NRV1,A0A1I6HGN0,,",366,37
"142","N.L26.2","N.S2.2",145,96,49,2.36001275510204,"4F3T,4KRE,Q389P5,C4LVV2,A2DPV7,T1H8B3,S4RWI0,A0A0D1ZAJ4,Q1K660,F4PH46,A0A164ZA52,A0A383WDW5,Q54G64,C1DZY0,A0A2C5Z0M1,R9ACY5,D3BMP8,A0A1Z5TVE5,W7XD45,A0A1U7LLR0,A0A4S2MWZ7,V6R0U9,B7Q5I1,A0A1E3QC61,D5GGK8,S8ANP9,A0A177URI1,O74957,A0A3N4IGK1,A0A0E9NDK5,T1KZ60,Q5KAT1,A0A1W0E4B5,A0A2K3CW87,A0A388KES6,A0A3S3PD82,A0A0L0TEV1,C4V9J2,G2QEV0,A0A2T7PFL8,A0A024FT57,H3HCL6,A0A0G4IME3,D7FQK3,A0A1Y1YHC8,A0A1D8PMK0,Q5BD61,A0A158PJG6,A0A158QZT6,T0SAU8,R7YY92,A0A3S1A0C3,O04379,A0A371I3C8,M8AEW7,A8P0D4,F4NYW7,A0A0L0HAB7,A0A1D1W4K0,A7RQ46,W4YU94,A7BJS5,X1WG39,Q69VD5,A0A0D8XL16,A0A016WPN3,Q9QZ81,G5EES3,A0A0K0EFP6,Q8CJG0,A0A1D5NTU6,A0A0V0YLH8,A0A0R3W9Q7,H3DS31,A0A1Y1HWP2,A0A0B2UV00,M7BCJ9,A0A077Z361,R7U9I3,A0A1X7V1N5,A0A0K0JDP1,A0A0N4UKJ1,A0A498N3A3,A0A3M0IQP5,A0A0L8GBV4,E0W4C3,A0A482XDA9,A0A3P7EJD6,V3ZRX0,A0A210QKF7,A0A423TSS1,K1PT78,A0A267E8R7,F6YK55,A0A2C9JGZ6,A0A3Q0KUG5,3DLB,5AWH,A0A326U7G5,A0A1Q4R485,K9U8J6,K9RC91,A0A0D8ZUC0,A0A139XGN8,A0YYT3,A0A2T1EFY0,G6FTN0,A0A433NB65,A0A1Z4L0A1,K9UQR0,A0A2T1G8M7,K9ZDE3,A0A1Z4K1Y3,A0A0P4UVI8,A0A0V7ZCG4,A0A1J0AGK2,K9PFF9,K9UEV4,H0HWQ5,A0A317EJY3,A0A1I2BD20,F8ERC7,Q8DKB1,A0A1J1EK56,Q53W94,A0A2T1EKT1,K9XZC6,A0A0C1VHB4,Q2JI93,A0A3R7KLK4,A0A329TD61,A0A1E3XF49,H1YCU5,L0JS08,A0A1Q5ZS75,M0AF24,A0A0C1XUA0,M0D2X3,A0A2R5G167,A0A346PK63,A0A1C3ZXN2,W0JW77,L0AJX6,A0A2A5QS34,A0A1I0NI68,,",366,37
"146","C.H4.4","C.S5.5",160,98,62,1.47350230414747,"4KRE,5GUH,5VM9,6KR6,A0A163JTZ6,J9D5G4,C4LVV2,T1H8B3,S4RWI0,D2VMG4,A0A0D1ZAJ4,A0A164ZA52,S7WCF7,A0A2C5Z0M1,A0CB11,D3BMP8,A0A1Z5TVE5,W7XD45,A0A1U7LLR0,V6R0U9,B7Q5I1,A0A139AUH8,L2GMR6,U4LBG4,A0A3N4IGK1,A0A0E9NDK5,T1KZ60,L2GUF2,W2T741,A0A1W0E4B5,A0A2J7QB22,A0A388KES6,A0A1J1HRI1,C4V9J2,Q9JMB7,A0A075AN09,Q5TW24,U5HIG6,Q96J94,G2QEV0,A0A2T7PFL8,K7ISV0,A0A024FT57,A0A0G4IME3,A0A1S3CYL5,A0A1Y1YHC8,Q5BD61,A0A4D8YSQ3,J9JZ66,A0A0C2XG51,A0A158QZT6,A0A165QYQ9,R7YY92,A0A3S1A0C3,A0A074YJ47,A0A2K1J482,O04379,A0A371I3C8,M8AEW7,A8P0D4,A0A2K3NY65,A7RQ46,A7BJS5,D8SNM6,M5FQK2,Q69VD5,A0A0D8XL16,A0A016WPN3,A0A0K0EFP6,A0A0V0YLH8,H3DS31,A0A1Y1HWP2,A0A0B2UV00,E9GN30,Q7PZ41,A0A077Z361,R7U9I3,A0A0K0JDP1,A0A0N4UKJ1,A0A0L8GBV4,Q32KD4,A0A1J1JBJ0,E0W4C3,A0A482XDA9,J9K2Z4,T1IBM6,V3ZRX0,A0A210QKF7,A0A423TSS1,K1PT78,A0A267E8R7,A0A1D2N447,A0A226D7A9,T1KTE4,A0A2C9JGZ6,K5X5Z7,A0A3Q0KUG5,T1FY40,5G5T,5I4A,E8N0K8,Q11QW7,A0A0M2PXX3,K9TPA9,A0A1C0UUC4,A0A1Q4R485,K9U8J6,K9RC91,A0A0D8ZUC0,A0A139XGN8,A0YYT3,A0A2T1EFY0,G6FTN0,A0A433NB65,A0A1Z4L0A1,K9UQR0,A0A2T1G8M7,K9VUN0,K9ZDE3,B0JXD6,A0A2T1LS63,A0A1Z4K1Y3,A0A0P4UVI8,A0A0V7ZCG4,A0A1J0AGK2,K9PFF9,K9UEV4,A0A060HNJ0,R5XQK4,A0A1H3LE92,A0A496APJ8,A0A1A5X8H4,A0A0B7I4Z6,A0A139WY18,A0A2T1E1K4,A0A1Q8ZD62,A0A4Q6XKV6,A0A1Z3HNN4,A0A239JE83,A0A2N4XBY2,A0A2T0XH18,A0A1K1RQP7,A0A1N6LUI7,A0A1X7IML5,A0A0A2LKJ7,K1L112,R5NJJ8,A5D4D9,A0A432MEQ5,C1F5Q7,A0A4R3EV39,A0A222F7P0,A0A1E3XF49,A0A2R5G167,A0A346PK63,M5RSF0,F8D8G0,A0A0W1S8B8,A0A1V4C8L7,L9VRQ2,,",366,37
"147","C.H9.12","C.S11.5",213,98,115,1.38589174800355,"4F1N,4F3T,4KRE,5GUH,5VM9,6OON,7KX7,A0A0N4X8S8,A0A196SDB4,J9D5G4,C4LVV2,A0A2P6N8X7,R1FDF0,D2VMG4,F4PH46,A0A3M7S814,A0A383WDW5,S7WCF7,R7QGN7,A0A158P1R9,G7DVX0,E3KLI3,B7Q5I1,L2GMR6,A6N7Y9,T1KZ60,A0A2G8JLH3,L2GUF2,A0A2J7QB22,A0A2K3CW87,A0A1S3J512,Q9JMB7,A0A075AN09,U5HIG6,A0A401PRI6,Q96J94,A0A2B4RHN2,G2QEV0,A0A2T7PFL8,K7ISV0,E9FUN9,A0A1S3CYL5,D7FQK3,T1GSU4,F4S231,Q5BD61,J9JZ66,A0A0C2XG51,A0A165QYQ9,A0A3S1A0C3,A0A074YJ47,A0A1Q3ENA6,A0A409Y6G2,A0A1D1W4K0,A7RQ46,W4YU94,A7BJS5,A0A1J8PPA3,X1WG39,M5FQK2,Q9QZ81,Q8CJG0,A0A1D5NTU6,A0A0V0YLH8,A0A139WDH0,A0A0R3W9Q7,G4T5G9,B7QCC4,M7BCJ9,E9GN30,Q7PZ41,A0A077Z361,R7U9I3,A0A1X7V1N5,A0A498N3A3,A0A3M0IQP5,A0A0L8GBV4,Q32KD4,A0A1J1JBJ0,E0W4C3,A0A482XDA9,A0A3P7EJD6,J9K2Z4,A0A2J7Q8V4,T1IBM6,V3ZRX0,A0A210QKF7,A0A423TSS1,K1PT78,A0A267E8R7,A0A1D2N447,A0A226D7A9,F6YK55,T1KTE4,A0A2C9JGZ6,A0A1V9X9F0,A0A3Q0KUG5,T1FY40,1YVU,5AWH,5I4A,6QZK,A0A1I7IXT4,A0A2W1JZ37,A0A2S7WBN3,A0A328VKE4,A0A420DFE6,A0A4V1VDY2,A0A368P5I0,C4L1M1,A0A4R1RMM2,A0A1Y2RDH8,Q11QW7,A0A1M5ZSR3,A0A0K8QX04,A0A0M2PXX3,A0A1L3JHM3,A0A1W6MIP2,A0A1C0UUC4,A0A2U2J9E0,L8D0R3,A0A326U7G5,A0A3D8L290,A0A1Q4R485,A0A1T4Y3A2,Q5P0R2,A0A0B0H9B4,A0A2T1EFY0,R6KUL9,B7GJX9,A0A2Z6E0R7,A0A1J0AGK2,A0A2G9DT08,Q9L1X1,A0A060HNJ0,A0A235B542,R5XQK4,A0A1H3LE92,A0A496APJ8,A0A1V9G9U4,A0A1I2BD20,A0A1A5X8H4,A0A1I2T6Q1,A0A1R3T9N6,H8KXJ0,D3S0S6,A0A2D1U4H7,I3TE64,A0A0B7I4Z6,A0A139WY18,A0A2T1E1K4,A0A1Q8ZD62,A0A1Z3HNN4,A0A239JE83,R5JEI2,A0A0Q0ZC47,A0A2T0XH18,A0A1V4CHV0,A0A1K1RQP7,A0A1N6LUI7,A0A0A2LKJ7,K1L112,A0A1H3A054,K9XZC6,B9LVW4,A0A0C5JKF3,R5NJJ8,A5D4D9,A0A142Y7A9,A0A432MEQ5,A0A372DKU2,C1F5Q7,A0A4R3EV39,A0A222F7P0,A0A1C9VH88,A0A2T2YMB1,A0A329TD61,A0A101R2A0,A0A1E3XF49,A0A1U9ND56,A0A4R7BQC4,A0A1Q1FPH0,E0TGY3,A0A259TUP4,F6EYI8,A0A2S9Q9J0,A0A4Q2UIU6,A0A1H0LH25,A0A318LG42,L0JS08,A0A345E7N0,M0AF24,A0A0C1XUA0,M0D2X3,A0A2R5G167,R7RTW6,B9LVP8,M5RSF0,W0JW77,B7K585,A0A343TL88,L0AJX6,A0A2A5QS34,A0A343JEE2,A0A3P3RGE5,A0A329TBQ3,A0A285N2A8,A0A0W1S8B8,A0A1V4C8L7,L9VRQ2,E4NRV1,A0A1I6HGN0,A0A1I0NI68,,",366,37
"153","C.H6.6","C.S11.1",143,100,43,3.15779069767442,"4F3T,4KRE,5VM9,6KR6,6OON,7SWF,A0A163JTZ6,A0A0G4H2S4,D2VMG4,S7WCF7,A0A1U7LLR0,A0A4S2MWZ7,G7DVX0,A0A1E3QC61,S8ANP9,L2GMR6,O74957,A0A3N4IGK1,A0A0E9NDK5,W2T741,A0A1W0E4B5,A0A0L0TEV1,C4V9J2,A0A075AN09,A0A397UU01,A0A2T7PFL8,A0A024FT57,T1GSU4,A0A1C7M8P2,A0A4D8YSQ3,A0A158PJG6,A0A0C2XG51,A0A158QZT6,A0A165QYQ9,T0SAU8,A0A3S1A0C3,A0A2K1J482,A0A1Q3ENA6,O04379,A0A371I3C8,M8AEW7,A0A2K3NY65,F4NYW7,A0A409Y6G2,A0A0L0HAB7,D8PZT7,A0A1D1W4K0,A7RQ46,W4YU94,A7BJS5,A0A1J8PPA3,X1WG39,M5FQK2,Q69VD5,A0A2R6NSC2,A0A0D8XL16,A0A016WPN3,Q9QZ81,G5EES3,A0A0K0EFP6,Q8CJG0,A0A1D5NTU6,V2WTL2,A0A0V0YLH8,A0A0R3W9Q7,A0A1Y1HWP2,G4T5G9,B7QCC4,A0A0B2UV00,M7BCJ9,E9GN30,Q7PZ41,A0A077Z361,A0A1X7V1N5,A0A0K0JDP1,A0A0N4UKJ1,A0A498N3A3,A0A3M0IQP5,A0A0L8GBV4,Q32KD4,A0A1J1JBJ0,E0W4C3,A0A482XDA9,A0A3P7EJD6,J9K2Z4,A0A2J7Q8V4,T1IBM6,V3ZRX0,A0A210QKF7,A0A423TSS1,K1PT78,A0A267E8R7,A0A1D2N447,A0A226D7A9,T1KTE4,A0A2C9JGZ6,A0A1V9X9F0,K5X5Z7,A0A3Q0KUG5,T1FY40,1YVU,3DLB,5AWH,7R8K,C4L1M1,A0A1M5ZSR3,A0A0K8QX04,A0A0M2PXX3,A0A1I3LMA1,A0A1C0UUC4,A0A0B0H9B4,R6KUL9,B7GJX9,A0A0P6X5X2,A0A1N6SSK9,A0A060HNJ0,A0A235B542,R5XQK4,A0A1H3LE92,H0HWQ5,A0A1I2ZGP1,A0A317EJY3,A0A1J1EK56,Q53W94,B9LVW4,A0A432MEQ5,A0A3R7KLK4,A0A329TD61,A0A1H3DGN3,A0A1Q1FPH0,A0A345E7N0,M0AF24,A0A1H3X247,M0D2X3,B9LVP8,M5RSF0,L0AJX6,A0A343JEE2,A0A3P3RGE5,A0A329TBQ3,A0A285N2A8,A0A1V4C8L7,A0A1I0NI68,,",366,37
"155","C.L25.2","C.S7.2",204,100,104,2.38269230769231,"4F1N,4F3T,4KRE,5GUH,6OON,7KX7,7SWF,A0A163JTZ6,J9D5G4,Q389P5,C4LVV2,D2VMG4,A0A074TLL7,A0A0D1ZAJ4,Q1K660,A0A3M7S814,A0A164ZA52,Q54G64,S7WCF7,C1DZY0,A0A2C5Z0M1,A0CB11,R9ACY5,D3BMP8,A0A1Z5TVE5,W7XD45,A0A4S2MWZ7,V6R0U9,G4N9J3,A0A1E3QC61,D5GGK8,S8ANP9,A0A139AUH8,L2GMR6,U4LBG4,O74957,A0A3N4IGK1,A6N7Y9,A0A0E9NDK5,A0A250WXN5,A0A2G8JLH3,L2GUF2,A0A1W0E4B5,A0A2J7QB22,S4RYE2,A0A388KES6,A0A3S3PD82,A0A0L0TEV1,A0A1S3J512,G0QTT2,A0A1J1HRI1,C4V9J2,Q5TW24,A0A401PRI6,Q96J94,A0A2B4RHN2,G2QEV0,A0A397UU01,K7ISV0,H3HCL6,A0A0G4IME3,E9FUN9,A0A1S3CYL5,D7FQK3,A0A1Y1YHC8,A0A1D8PMK0,A0A2G5B1D8,Q5BD61,A0A1C7M8P2,A0A4D8YSQ3,J9JZ66,A0A0C2XG51,T0SAU8,R7YY92,A0A2K1J482,A0A1Q3ENA6,O04379,A0A371I3C8,M8AEW7,A8P0D4,A0A2K3NY65,F4NYW7,A0A409Y6G2,A0A0L0HAB7,D8PZT7,D8SNM6,A0A1J8PPA3,M5FQK2,Q69VD5,A0A2R6NSC2,V2WTL2,A0A0R3W9Q7,A0A1Y1HWP2,G4T5G9,A0A1X7V1N5,A0A0L8GBV4,V3ZRX0,A0A210QKF7,K5X5Z7,A0A3Q0KUG5,3DLB,5G5T,5I4A,6QZK,7R8K,A0A1I7IXT4,A0A2W1JZ37,A0A2S7WBN3,A0A328VKE4,A0A420DFE6,A0A4V1VDY2,A0A368P5I0,C4L1M1,A0A4R1RMM2,A0A1Y2RDH8,Q11QW7,A0A1M5ZSR3,A0A0M2PXX3,A0A1L3JHM3,A0A1W6MIP2,A0A1C0UUC4,A0A2Z6E1D5,A0A0F4NXW8,A0A142XB92,L8D0R3,A0A326U7G5,A0A3D8L290,A0A097QRL6,Q5P0R2,B6YTQ5,A0A0B0H9B4,R6KUL9,B7GJX9,A0A1N6SSK9,A0A2G9DT08,Q9L1X1,A0A235B542,R5XQK4,H0HWQ5,S7VLM7,A0A1A5X8H4,A0A1I2T6Q1,A0A1R3T9N6,A0A0Q2M2Z1,H8KXJ0,A0A2D1U4H7,A0A0B7I4Z6,A0LL61,A0A1J1EK56,A0A4Q6XKV6,A0A239JE83,A0A2N4XBY2,Q53W94,R5JEI2,A0A0Q0ZC47,A0A2T0XH18,A0A1V4CHV0,A0A1K1RQP7,A0A2T1EKT1,A0A1N6LUI7,A0A0P0NGR6,A0A1X7IML5,A0A0A2LKJ7,K1L112,A0A0U3AL92,A0A1H3A054,K9XZC6,A0A0C1VHB4,Q31N05,A0A0C5JKF3,R5NJJ8,A5D4D9,A0A142Y7A9,A0A432MEQ5,A0A372DKU2,C1F5Q7,A0A4R3EV39,A0A1P8WP90,A0A222F7P0,A0A1C9VH88,A0A2T2YMB1,A0A101R2A0,A0A1U9ND56,A0A4R7BQC4,E0TGY3,A0A259TUP4,A0A2S9Q9J0,A0A4Q2UIU6,A0A1H0LH25,A0A318LG42,L0JS08,A0A1W2A082,A0A2R5G167,R7RTW6,M5RSF0,W0JW77,B7K585,F8D8G0,L0AJX6,A0A2A5QS34,A0A343JEE2,A0A285N2A8,A0A1V4C8L7,A0A1I0NI68,,",366,37
"157","C.H12.4","C.L9.3",157,101,56,2.54181400282885,"4F1N,4F3T,4KRE,5GUH,5VM9,6OON,7KX7,A0A163JTZ6,A0A196SDB4,J9D5G4,A8BCK6,A2DPV7,A0A0D1ZAJ4,Q1K660,S7WCF7,I0YVB2,C1DZY0,A0A2C5Z0M1,R9ACY5,A0A1Z5TVE5,W7XD45,A0A4S2MWZ7,K1VVQ6,V6R0U9,G4N9J3,B7Q5I1,A0A1E3QC61,D5GGK8,S8ANP9,L2GMR6,U4LBG4,A6N7Y9,A0A250WXN5,L2GUF2,A0A226EFL3,G0QTT2,A0A1J1HRI1,U5HIG6,A0A2T7PFL8,A0A024FT57,H3HCL6,A0A0G4IME3,E9FUN9,D7FQK3,A0A1D8PMK0,Q5BD61,A0A4D8YSQ3,A0A0C2XG51,A0A165QYQ9,R7YY92,A0A074YJ47,A0A2K1J482,A0A1Q3ENA6,O04379,A0A371I3C8,M8AEW7,A0A409Y6G2,A7RQ46,W4YU94,A7BJS5,A0A1J8PPA3,X1WG39,M5FQK2,Q69VD5,A0A2R6NSC2,Q9QZ81,Q8CJG0,A0A1D5NTU6,V2WTL2,A0A139WDH0,A0A0R3W9Q7,A0A1Y1HWP2,B7QCC4,M7BCJ9,E9GN30,Q7PZ41,R7U9I3,A0A1X7V1N5,A0A3M0IQP5,A0A0L8GBV4,Q32KD4,A0A1J1JBJ0,E0W4C3,A0A482XDA9,A0A3P7EJD6,J9K2Z4,A0A2J7Q8V4,T1IBM6,V3ZRX0,A0A210QKF7,A0A423TSS1,A0A267E8R7,A0A1D2N447,A0A226D7A9,F6YK55,T1KTE4,A0A2C9JGZ6,A0A1V9X9F0,K5X5Z7,A0A3Q0KUG5,T1FY40,5AWH,A0A1I7IXT4,A0A2W1JZ37,A0A2S7WBN3,A0A420DFE6,A0A4V1VDY2,A0A368P5I0,A0A4R1RMM2,A0A1Y2RDH8,A0A1L3JHM3,A0A1W6MIP2,A0A1T4Y3A2,A0A2G9DT08,Q9L1X1,A0A496APJ8,A0A1V9G9U4,A0A1A5X8H4,A0A1R3T9N6,A0A0B7I4Z6,A0LL61,A0A139WY18,A0A2T1E1K4,A0A1Q8ZD62,A0A4Q6XKV6,A0A1Z3HNN4,A0A239JE83,A0A2N4XBY2,A0A0Q0ZC47,A0A2T0XH18,A0A1V4CHV0,A0A1K1RQP7,A0A1N6LUI7,A0A0P0NGR6,A0A1X7IML5,A0A0A2LKJ7,K1L112,A0A0U3AL92,A0A1H3A054,A0A0C5JKF3,A5D4D9,A0A142Y7A9,A0A372DKU2,C1F5Q7,A0A4R3EV39,A0A222F7P0,A0A1C9VH88,A0A2T2YMB1,A0A101R2A0,E0TGY3,A0A259TUP4,F6EYI8,A0A2S9Q9J0,A0A4Q2UIU6,A0A1H0LH25,A0A2R5G167,M5RSF0,,",366,37
"158","C.H2.2","C.H3.6",178,101,77,1.62562684839913,"4F3T,5GUH,Q389P5,A0A2P6N8X7,A2DPV7,S4RWI0,A0A074TLL7,F4PH46,A0A3M7S814,Q54G64,C1DZY0,A0A2C5Z0M1,D3BMP8,W7XD45,K1VVQ6,V6R0U9,D5GGK8,S8ANP9,L2GMR6,A6N7Y9,A0A0E9NDK5,A0A250WXN5,Q5KAT1,W2T741,A0A1W0E4B5,S4RYE2,A0A2K3CW87,A0A388KES6,A0A0L0TEV1,A0A075AN09,Q5TW24,A0A401PRI6,A0A2T7PFL8,K7ISV0,A0A024FT57,H3HCL6,T1GSU4,A0A1D8PMK0,A0A2G5B1D8,Q5BD61,A0A1C7M8P2,J9JZ66,A0A158QZT6,A0A165QYQ9,T0SAU8,A0A3S1A0C3,A8P0D4,D8PZT7,A0A1D1W4K0,A7RQ46,W4YU94,A7BJS5,X1WG39,Q69VD5,A0A2R6NSC2,A0A0D8XL16,A0A016WPN3,Q9QZ81,G5EES3,A0A0K0EFP6,Q8CJG0,A0A1D5NTU6,A0A0V0YLH8,A0A139WDH0,A0A0R3W9Q7,H3DS31,B7QCC4,A0A0B2UV00,M7BCJ9,E9GN30,Q7PZ41,A0A077Z361,R7U9I3,A0A1X7V1N5,A0A0K0JDP1,A0A0N4UKJ1,A0A498N3A3,A0A3M0IQP5,A0A0L8GBV4,Q32KD4,A0A1J1JBJ0,E0W4C3,A0A482XDA9,A0A3P7EJD6,J9K2Z4,A0A2J7Q8V4,T1IBM6,V3ZRX0,A0A210QKF7,A0A423TSS1,K1PT78,A0A267E8R7,A0A1D2N447,A0A226D7A9,F6YK55,T1KTE4,A0A2C9JGZ6,A0A1V9X9F0,K5X5Z7,A0A3Q0KUG5,T1FY40,1YVU,5AWH,6QZK,A0A1I7IXT4,A0A2W1JZ37,A0A2S7WBN3,A0A420DFE6,E0ST67,A0A4V1VDY2,A0A368P5I0,A0A4R1RMM2,A0A1Y2RDH8,A0A1M5ZSR3,A0A0M2PXX3,A0A1L3JHM3,A0A2U2J9E0,L8D0R3,A0A1T4Y3A2,R6KUL9,A0A1N6SSK9,A0A235B542,R5XQK4,A0A496APJ8,A0A1V9G9U4,S7VLM7,A0A1A5X8H4,A0A1R3T9N6,D3S0S6,A0A0B7I4Z6,A0A139WY18,A0A2T1E1K4,A0A1Q8ZD62,A0A4Q6XKV6,A0A1Z3HNN4,A0A239JE83,A0A2N4XBY2,R5JEI2,A0A0Q0ZC47,A0A2T0XH18,A0A1V4CHV0,A0A1K1RQP7,A0A0P0NGR6,A0A1X7IML5,A0A0A2LKJ7,K1L112,E0UCX3,K9XZC6,R5NJJ8,A5D4D9,A0A142Y7A9,C1F5Q7,A0A4R3EV39,A0A1P8WP90,A0A222F7P0,A0A1U9ND56,A0A4R7BQC4,E0TGY3,A0A259TUP4,A0A4Q2UIU6,H1YCU5,L0JS08,A0A1Q5ZS75,A0A0C1XUA0,A0A2R5G167,A0A346PK63,A0A1C3ZXN2,B7K585,F8D8G0,A0A343TL88,L0AJX6,A0A2A5QS34,A0A3P3RGE5,A0A329TBQ3,A0A0W1S8B8,L9VRQ2,E4NRV1,A0A1I6HGN0,,",366,37
"159","C.H2.5","C.S3.4",143,101,42,1.26544082979727,"4F3T,4KRE,5GUH,6KR6,6OON,A0A163JTZ6,A8BCK6,S4RWI0,D2VMG4,A0A0D1ZAJ4,Q1K660,A0A3M7S814,A0A164ZA52,A0A383WDW5,R7QGN7,C1DZY0,A0A2C5Z0M1,R9ACY5,A0A4S2MWZ7,G7DVX0,G4N9J3,D5GGK8,L2GMR6,U4LBG4,A0A177URI1,O74957,A0A3N4IGK1,A0A2G8JLH3,L2GUF2,W2T741,A0A1W0E4B5,A0A2K3CW87,A0A388KES6,A0A226EFL3,A0A0L0TEV1,U5HIG6,A0A2B4RHN2,G2QEV0,A0A397UU01,A0A2T7PFL8,K7ISV0,A0A024FT57,H3HCL6,E9FUN9,T1GSU4,J9JZ66,A0A158QZT6,T0SAU8,A0A3S1A0C3,A0A1D1W4K0,A7RQ46,W4YU94,A7BJS5,X1WG39,M5FQK2,A0A0D8XL16,A0A016WPN3,Q9QZ81,G5EES3,A0A0K0EFP6,Q8CJG0,A0A1D5NTU6,A0A0V0YLH8,A0A139WDH0,A0A0R3W9Q7,H3DS31,A0A1Y1HWP2,B7QCC4,A0A0B2UV00,M7BCJ9,E9GN30,Q7PZ41,A0A077Z361,R7U9I3,A0A1X7V1N5,A0A0K0JDP1,A0A0N4UKJ1,A0A498N3A3,A0A3M0IQP5,A0A0L8GBV4,Q32KD4,A0A1J1JBJ0,E0W4C3,A0A482XDA9,A0A3P7EJD6,J9K2Z4,A0A2J7Q8V4,T1IBM6,V3ZRX0,A0A210QKF7,A0A423TSS1,K1PT78,A0A267E8R7,A0A1D2N447,A0A226D7A9,F6YK55,T1KTE4,A0A2C9JGZ6,A0A1V9X9F0,A0A3Q0KUG5,T1FY40,A0A1T4Y3A2,A0A2G9DT08,Q9L1X1,S7VLM7,A0A1A5X8H4,A0A1I2T6Q1,A0A1R3T9N6,A0A0B7I4Z6,A0LL61,A0A4Q6XKV6,A0A239JE83,A0A2N4XBY2,R5JEI2,A0A0Q0ZC47,A0A2T0XH18,A0A1V4CHV0,A0A1K1RQP7,A0A0P0NGR6,A0A1X7IML5,A0A0A2LKJ7,K1L112,R5NJJ8,A5D4D9,A0A142Y7A9,C1F5Q7,A0A4R3EV39,A0A1P8WP90,A0A101R2A0,A0A1U9ND56,A0A4R7BQC4,E0TGY3,A0A1H0LH25,A0A318LG42,L0JS08,A0A345E7N0,A0A2R5G167,A0A346PK63,L0AJX6,A0A2A5QS34,A0A343JEE2,A0A285N2A8,A0A1I0NI68,,",366,37
"164","C.H5.16","C.L3.18",148,102,46,1.67860187553282,"4F1N,4F3T,4KRE,5GUH,7KX7,7SWF,A0A163JTZ6,J9D5G4,A0A0G4H2S4,T1H8B3,R1FDF0,A0A0D1ZAJ4,Q1K660,A0A164ZA52,A0A383WDW5,R7QGN7,A0A2C5Z0M1,R9ACY5,A0A1Z5TVE5,A0A1U7LLR0,K1VVQ6,A0A158P1R9,G7DVX0,V6R0U9,G4N9J3,E3KLI3,A0A139AUH8,L2GMR6,U4LBG4,A0A177URI1,O74957,A6N7Y9,T1KZ60,A0A250WXN5,Q5KAT1,L2GUF2,A0A2J7QB22,S4RYE2,A0A2K3CW87,A0A388KES6,A0A3S3PD82,A0A1S3J512,C4V9J2,Q9JMB7,Q5TW24,U5HIG6,Q96J94,A0A2B4RHN2,G2QEV0,A0A397UU01,A0A024FT57,H3HCL6,A0A0G4IME3,E9FUN9,A0A1S3CYL5,D7FQK3,A0A1Y1YHC8,T1GSU4,F4S231,A0A1D8PMK0,A0A2G5B1D8,Q5BD61,J9JZ66,A0A0C2XG51,T0SAU8,R7YY92,A0A074YJ47,A0A1Q3ENA6,A8P0D4,F4NYW7,A0A409Y6G2,A0A0L0HAB7,D8PZT7,A0A1D1W4K0,A7RQ46,W4YU94,A7BJS5,A0A1J8PPA3,M5FQK2,Q69VD5,A0A0V0YLH8,A0A139WDH0,A0A1Y1HWP2,G4T5G9,B7QCC4,E9GN30,Q7PZ41,A0A077Z361,A0A1X7V1N5,A0A0K0JDP1,A0A0N4UKJ1,Q32KD4,A0A1J1JBJ0,A0A482XDA9,J9K2Z4,A0A2J7Q8V4,T1IBM6,A0A423TSS1,A0A226D7A9,T1KTE4,A0A1V9X9F0,K5X5Z7,1Z26,3DLB,6QZK,A0A328VKE4,A0A1W6MIP2,A0A2Z6E1D5,A0A0F4NXW8,B1XJG0,A0A097QRL6,Q5P0R2,B6YTQ5,A0A2Z6E0R7,A0A1H3LE92,A0A0Q2M2Z1,D3S0S6,I3TE64,Q8DKB1,A0A2T1EKT1,E0UCX3,K9XZC6,B9LVW4,A0A0C1VHB4,Q31N05,R5NJJ8,Q2JI93,L0JS08,A0A345E7N0,M0AF24,M0D2X3,A0A346PK63,R7RTW6,B9LVP8,W0JW77,A0A343TL88,L0AJX6,A0A2A5QS34,A0A343JEE2,A0A3P3RGE5,A0A329TBQ3,A0A285N2A8,A0A0W1S8B8,A0A1V4C8L7,L9VRQ2,E4NRV1,A0A1I6HGN0,A0A1I0NI68,,",366,37
"165","C.L2.1","C.L2.7",241,102,139,2.67121596840175,"4F1N,4F3T,4KRE,5GUH,5VM9,6OON,A0A163JTZ6,J9D5G4,Q389P5,T1H8B3,R1FDF0,S4RWI0,D2VMG4,A0A074TLL7,A0A3M7S814,S7WCF7,A0A4S2MWZ7,K1VVQ6,A0A158P1R9,G7DVX0,A0A1E3QC61,D5GGK8,S8ANP9,L2GMR6,A0A177URI1,A0A3N4IGK1,A0A0E9NDK5,Q5KAT1,L2GUF2,W2T741,A0A2J7QB22,A0A1J1HRI1,C4V9J2,A0A075AN09,A0A397UU01,A0A2T7PFL8,K7ISV0,A0A1S3CYL5,A0A1Y1YHC8,A0A1D8PMK0,A0A2G5B1D8,A0A158PJG6,J9JZ66,A0A0C2XG51,A0A158QZT6,A0A165QYQ9,A0A3S1A0C3,A0A1Q3ENA6,F4NYW7,A0A409Y6G2,A0A0L0HAB7,D8PZT7,W4YU94,A0A1J8PPA3,X1WG39,A0A2R6NSC2,A0A0D8XL16,A0A016WPN3,Q9QZ81,G5EES3,A0A0K0EFP6,Q8CJG0,A0A1D5NTU6,V2WTL2,A0A0V0YLH8,A0A139WDH0,A0A0R3W9Q7,H3DS31,G4T5G9,B7QCC4,A0A0B2UV00,M7BCJ9,E9GN30,Q7PZ41,A0A077Z361,R7U9I3,A0A1X7V1N5,A0A0K0JDP1,A0A0N4UKJ1,A0A498N3A3,A0A3M0IQP5,A0A0L8GBV4,A0A1J1JBJ0,E0W4C3,A0A482XDA9,A0A3P7EJD6,J9K2Z4,A0A2J7Q8V4,T1IBM6,V3ZRX0,A0A210QKF7,A0A423TSS1,K1PT78,A0A267E8R7,A0A1D2N447,A0A226D7A9,F6YK55,T1KTE4,A0A2C9JGZ6,A0A1V9X9F0,A0A3Q0KUG5,T1FY40,1YVU,1Z26,3DLB,5AWH,5G5T,5I4A,E0ST67,C4L1M1,A0A1Y2RDH8,Q11QW7,A0A1M5ZSR3,A0A1I3LMA1,K9TPA9,A0A2Z6E1D5,B1XJG0,A0A1Q4R485,K9U8J6,K9RC91,A0A0D8ZUC0,A0A139XGN8,A0A1T4Y3A2,Q5P0R2,A0A0B0H9B4,A0YYT3,A0A2T1EFY0,G6FTN0,R6KUL9,A0A433NB65,A0A1Z4L0A1,K9UQR0,A0A2T1G8M7,K9VUN0,B7GJX9,K9ZDE3,B0JXD6,A0A2T1LS63,A0A1Z4K1Y3,A0A2Z6E0R7,A0A0P4UVI8,A0A0V7ZCG4,A0A1J0AGK2,K9PFF9,A0A2G9DT08,K9UEV4,Q9L1X1,A0A060HNJ0,A0A1H3LE92,A0A496APJ8,A0A1V9G9U4,S7VLM7,A0A1A5X8H4,A0A1I2T6Q1,A0A1R3T9N6,A0A0Q2M2Z1,H8KXJ0,A0A2D1U4H7,A0A0B7I4Z6,A0LL61,Q8DKB1,A0A139WY18,A0A1J1EK56,A0A2T1E1K4,A0A1Q8ZD62,A0A4Q6XKV6,A0A1Z3HNN4,A0A239JE83,A0A2N4XBY2,Q53W94,R5JEI2,A0A0Q0ZC47,A0A2T0XH18,A0A1V4CHV0,A0A1K1RQP7,A0A1N6LUI7,A0A0P0NGR6,A0A1X7IML5,A0A0A2LKJ7,K1L112,A0A0U3AL92,A0A1H3A054,E0UCX3,K9XZC6,A0A0C1VHB4,Q31N05,A0A0C5JKF3,A5D4D9,Q2JI93,A0A142Y7A9,A0A432MEQ5,A0A372DKU2,C1F5Q7,A0A4R3EV39,A0A1P8WP90,A0A222F7P0,A0A1C9VH88,A0A2T2YMB1,A0A329TD61,A0A101R2A0,A0A1E3XF49,A0A1U9ND56,A0A4R7BQC4,A0A1Q1FPH0,E0TGY3,A0A259TUP4,F6EYI8,A0A2S9Q9J0,A0A4Q2UIU6,A0A1H0LH25,A0A318LG42,H1YCU5,L0JS08,A0A1Q5ZS75,A0A345E7N0,M0AF24,A0A1W2A082,A0A1H3X247,A0A0C1XUA0,M0D2X3,A0A2R5G167,A0A346PK63,A0A1H2RBI2,A0A1C3ZXN2,B9LVP8,M5RSF0,W0JW77,B7K585,F8D8G0,A0A343TL88,L0AJX6,A0A2A5QS34,A0A3P3RGE5,A0A329TBQ3,A0A285N2A8,A0A0W1S8B8,A0A1V4C8L7,L9VRQ2,E4NRV1,A0A1I6HGN0,A0A1I0NI68,,",366,37
"169","C.L11.5","C.S1.1",215,103,112,1.86741504854369,"4F1N,4F3T,5GUH,5VM9,6KR6,7KX7,D2VMG4,A0A074TLL7,A0A0D1ZAJ4,Q1K660,F4PH46,A0A3M7S814,A0A164ZA52,A0A383WDW5,Q54G64,S7WCF7,I0YVB2,R7QGN7,C1DZY0,A0A2C5Z0M1,A0CB11,D3BMP8,W7XD45,A0A4S2MWZ7,K1VVQ6,A0A158P1R9,G7DVX0,V6R0U9,G4N9J3,E3KLI3,A0A1E3QC61,S8ANP9,L2GMR6,A0A177URI1,O74957,A0A3N4IGK1,A6N7Y9,T1KZ60,A0A2G8JLH3,Q5KAT1,L2GUF2,A0A1W0E4B5,A0A2J7QB22,S4RYE2,A0A2K3CW87,A0A226EFL3,A0A3S3PD82,A0A1S3J512,G0QTT2,A0A1J1HRI1,C4V9J2,Q9JMB7,A0A075AN09,Q5TW24,U5HIG6,A0A401PRI6,Q96J94,G2QEV0,K7ISV0,A0A024FT57,A0A0G4IME3,E9FUN9,A0A1S3CYL5,D7FQK3,A0A1Y1YHC8,F4S231,A0A1D8PMK0,A0A2G5B1D8,Q5BD61,A0A1C7M8P2,A0A4D8YSQ3,T0SAU8,A0A074YJ47,A0A2K1J482,O04379,A0A371I3C8,M8AEW7,A8P0D4,A0A2K3NY65,F4NYW7,A0A409Y6G2,A0A0L0HAB7,D8PZT7,A0A1D1W4K0,W4YU94,A0A1J8PPA3,M5FQK2,Q69VD5,A0A2R6NSC2,Q9QZ81,Q8CJG0,A0A1D5NTU6,V2WTL2,A0A0R3W9Q7,G4T5G9,A0A0L8GBV4,A0A3P7EJD6,V3ZRX0,A0A210QKF7,A0A267E8R7,F6YK55,K5X5Z7,A0A3Q0KUG5,1YVU,5AWH,5G5T,5I4A,6QZK,7R8K,A0A1I7IXT4,A0A2W1JZ37,A0A2S7WBN3,A0A420DFE6,E0ST67,A0A4V1VDY2,A0A368P5I0,A0A4R1RMM2,A0A1Y2RDH8,A0A1M5ZSR3,A0A0K8QX04,K9TPA9,A0A1L3JHM3,A0A1W6MIP2,A0A2U2J9E0,A0A0F4NXW8,A0A3D8L290,H1KXR6,K9U8J6,K9RC91,A0A0D8ZUC0,A0A139XGN8,A0A1T4Y3A2,A0A0B0H9B4,A0YYT3,A0A2T1EFY0,G6FTN0,R6KUL9,A0A433NB65,A0A1Z4L0A1,K9UQR0,A0A2T1G8M7,K9VUN0,B7GJX9,K9ZDE3,B0JXD6,A0A2T1LS63,A0A1Z4K1Y3,A0A2Z6E0R7,A0A1N6SSK9,A0A0P4UVI8,A0A0V7ZCG4,K9PFF9,A0A2G9DT08,K9UEV4,Q9L1X1,R5XQK4,A0A062U2W9,H0HWQ5,S7VLM7,A0A1A5X8H4,A0A1I2T6Q1,A0A1R3T9N6,H8KXJ0,A0A2D1U4H7,A0A0B7I4Z6,A0LL61,A0A4Q6XKV6,A0A239JE83,A0A2N4XBY2,R5JEI2,A0A0Q0ZC47,A0A2T0XH18,A0A1V4CHV0,A0A1K1RQP7,A0A2T1EKT1,A0A1N6LUI7,A0A0P0NGR6,A0A1X7IML5,A0A0A2LKJ7,K1L112,A0A0U3AL92,A0A1H3A054,B9LVW4,A0A0C5JKF3,A5D4D9,A0A142Y7A9,A0A432MEQ5,A0A372DKU2,A0A3R7KLK4,C1F5Q7,A0A4R3EV39,A0A1P8WP90,A0A222F7P0,A0A1C9VH88,A0A2T2YMB1,A0A101R2A0,A0A1E3XF49,A0A1U9ND56,A0A4R7BQC4,A0A1H3DGN3,E0TGY3,A0A259TUP4,F6EYI8,A0A2S9Q9J0,A0A4Q2UIU6,A0A1H0LH25,A0A318LG42,H1YCU5,A0A1Q5ZS75,A0A0C1XUA0,A0A2R5G167,B9LVP8,M5RSF0,B7K585,A0A343JEE2,,",366,37
"170","C.L7.3","C.L9.4",157,103,54,1.75116864437253,"4KRE,6OON,7SWF,A0A163JTZ6,J9D5G4,A8BCK6,A2DPV7,T1H8B3,S4RWI0,D2VMG4,A0A0D1ZAJ4,Q1K660,A0A3M7S814,A0A164ZA52,S7WCF7,I0YVB2,A0A2C5Z0M1,A0CB11,A0A1Z5TVE5,W7XD45,A0A4S2MWZ7,G7DVX0,V6R0U9,G4N9J3,E3KLI3,B7Q5I1,A0A1E3QC61,D5GGK8,A0A139AUH8,L2GMR6,U4LBG4,A0A177URI1,O74957,A0A3N4IGK1,A0A0E9NDK5,T1KZ60,A0A250WXN5,A0A2G8JLH3,L2GUF2,A0A1W0E4B5,A0A2J7QB22,S4RYE2,A0A3S3PD82,A0A0L0TEV1,A0A1S3J512,G0QTT2,A0A1J1HRI1,A0A075AN09,Q5TW24,U5HIG6,K7ISV0,A0A024FT57,H3HCL6,A0A0G4IME3,E9FUN9,D7FQK3,F4S231,A0A2G5B1D8,A0A1C7M8P2,J9JZ66,A0A0C2XG51,A0A165QYQ9,T0SAU8,R7YY92,A0A074YJ47,A0A1Q3ENA6,O04379,M8AEW7,A8P0D4,F4NYW7,D8PZT7,A0A1D1W4K0,A7BJS5,A0A1J8PPA3,X1WG39,M5FQK2,Q69VD5,A0A2R6NSC2,Q9QZ81,Q8CJG0,A0A1D5NTU6,A0A139WDH0,G4T5G9,B7QCC4,M7BCJ9,E9GN30,Q7PZ41,A0A498N3A3,A0A3M0IQP5,Q32KD4,A0A1J1JBJ0,E0W4C3,A0A482XDA9,J9K2Z4,A0A2J7Q8V4,T1IBM6,A0A423TSS1,A0A1D2N447,A0A226D7A9,F6YK55,T1KTE4,A0A1V9X9F0,K5X5Z7,1YVU,5AWH,A0A1T4Y3A2,A0A2G9DT08,Q9L1X1,S7VLM7,A0A1I2T6Q1,A0A1R3T9N6,H8KXJ0,A0A2D1U4H7,A0A0B7I4Z6,Q8DKB1,A0A1J1EK56,A0A4Q6XKV6,A0A239JE83,A0A2N4XBY2,Q53W94,R5JEI2,A0A0Q0ZC47,A0A2T0XH18,A0A1K1RQP7,A0A2T1EKT1,A0A1N6LUI7,A0A0P0NGR6,A0A1X7IML5,A0A0A2LKJ7,K1L112,E0UCX3,K9XZC6,A0A0C1VHB4,Q31N05,Q2JI93,A0A142Y7A9,A0A372DKU2,C1F5Q7,A0A4R3EV39,A0A1P8WP90,A0A222F7P0,A0A1C9VH88,A0A2T2YMB1,A0A329TD61,A0A101R2A0,E0TGY3,A0A259TUP4,F6EYI8,A0A2S9Q9J0,A0A4Q2UIU6,A0A1H0LH25,A0A318LG42,A0A345E7N0,A0A1H3X247,M5RSF0,A0A2A5QS34,A0A285N2A8,,",366,37
"172","N.L11.7","N.S11.3",191,103,88,3.04093115622242,"4F1N,4F3T,4KRE,5GUH,5VM9,6KR6,6OON,7KX7,C4LVV2,A2DPV7,T1H8B3,S4RWI0,A0A074TLL7,A0A0D1ZAJ4,Q1K660,F4PH46,A0A164ZA52,Q54G64,S7WCF7,R7QGN7,A0A2C5Z0M1,D3BMP8,A0A1Z5TVE5,W7XD45,A0A4S2MWZ7,A0A158P1R9,V6R0U9,G4N9J3,E3KLI3,B7Q5I1,A0A1E3QC61,D5GGK8,S8ANP9,L2GMR6,U4LBG4,A0A3N4IGK1,A6N7Y9,A0A0E9NDK5,T1KZ60,A0A250WXN5,A0A2G8JLH3,L2GUF2,A0A1W0E4B5,A0A2J7QB22,S4RYE2,A0A2K3CW87,A0A388KES6,A0A226EFL3,A0A3S3PD82,A0A1S3J512,A0A1J1HRI1,Q9JMB7,Q5TW24,U5HIG6,A0A401PRI6,Q96J94,A0A2B4RHN2,G2QEV0,A0A397UU01,K7ISV0,A0A024FT57,H3HCL6,A0A0G4IME3,E9FUN9,A0A1S3CYL5,A0A1Y1YHC8,F4S231,A0A1D8PMK0,A0A2G5B1D8,Q5BD61,A0A1C7M8P2,J9JZ66,A0A0C2XG51,A0A165QYQ9,T0SAU8,R7YY92,A0A074YJ47,A0A1Q3ENA6,A8P0D4,F4NYW7,A0A409Y6G2,A0A0L0HAB7,D8PZT7,A7RQ46,W4YU94,A0A1J8PPA3,M5FQK2,A0A2R6NSC2,Q9QZ81,Q8CJG0,A0A1D5NTU6,V2WTL2,A0A0R3W9Q7,G4T5G9,A0A498N3A3,A0A0L8GBV4,A0A3P7EJD6,A0A210QKF7,K1PT78,A0A267E8R7,K5X5Z7,A0A3Q0KUG5,T1FY40,1Z26,3DLB,5AWH,5G5T,5I4A,6QZK,A0A1T4Y3A2,A0A2G9DT08,Q9L1X1,A0A496APJ8,A0A1V9G9U4,S7VLM7,A0A1A5X8H4,A0A1I2T6Q1,A0A1R3T9N6,A0A0Q2M2Z1,H8KXJ0,A0A2D1U4H7,A0A0B7I4Z6,A0LL61,A0A139WY18,A0A1J1EK56,A0A2T1E1K4,A0A1Q8ZD62,A0A4Q6XKV6,A0A1Z3HNN4,A0A239JE83,A0A2N4XBY2,Q53W94,R5JEI2,A0A0Q0ZC47,A0A2T0XH18,A0A1V4CHV0,A0A1K1RQP7,A0A0P0NGR6,A0A1X7IML5,A0A0A2LKJ7,K1L112,A0A0U3AL92,A0A1H3A054,E0UCX3,A0A0C1VHB4,A0A0C5JKF3,A5D4D9,Q2JI93,A0A142Y7A9,A0A432MEQ5,A0A372DKU2,A0A4R3EV39,A0A1P8WP90,A0A222F7P0,A0A1C9VH88,A0A2T2YMB1,A0A329TD61,A0A101R2A0,A0A1E3XF49,A0A1U9ND56,A0A4R7BQC4,A0A1Q1FPH0,E0TGY3,A0A259TUP4,F6EYI8,A0A2S9Q9J0,A0A4Q2UIU6,A0A1H0LH25,A0A318LG42,L0JS08,A0A345E7N0,M0AF24,A0A1H3X247,M0D2X3,A0A2R5G167,A0A346PK63,R7RTW6,A0A1C3ZXN2,B9LVP8,M5RSF0,B7K585,F8D8G0,A0A343TL88,A0A3P3RGE5,A0A329TBQ3,A0A0W1S8B8,A0A1V4C8L7,L9VRQ2,E4NRV1,A0A1I6HGN0,A0A1I0NI68,,",366,37
"173","N.S11.9","N.S12.3",153,103,50,1.50728155339806,"4KRE,5GUH,5VM9,6KR6,6OON,J9D5G4,C4LVV2,A2DPV7,S4RWI0,A0A3M7S814,R7QGN7,A0A1Z5TVE5,A0A158P1R9,V6R0U9,E3KLI3,D5GGK8,S8ANP9,A0A3N4IGK1,A6N7Y9,A0A0E9NDK5,A0A2G8JLH3,L2GUF2,W2T741,A0A1W0E4B5,A0A226EFL3,A0A3S3PD82,A0A401PRI6,A0A2B4RHN2,A0A2T7PFL8,T1GSU4,F4S231,Q5BD61,A0A1C7M8P2,A0A4D8YSQ3,A0A158PJG6,A0A158QZT6,T0SAU8,R7YY92,A0A3S1A0C3,A0A2K1J482,O04379,A0A371I3C8,M8AEW7,A8P0D4,A0A2K3NY65,F4NYW7,D8PZT7,A0A1D1W4K0,A7RQ46,W4YU94,A7BJS5,D8SNM6,X1WG39,Q69VD5,A0A2R6NSC2,A0A0D8XL16,A0A016WPN3,Q9QZ81,G5EES3,A0A0K0EFP6,Q8CJG0,A0A1D5NTU6,V2WTL2,A0A0V0YLH8,A0A139WDH0,A0A0R3W9Q7,H3DS31,A0A1Y1HWP2,B7QCC4,A0A0B2UV00,M7BCJ9,E9GN30,Q7PZ41,A0A077Z361,R7U9I3,A0A1X7V1N5,A0A0K0JDP1,A0A0N4UKJ1,A0A498N3A3,A0A3M0IQP5,A0A0L8GBV4,Q32KD4,A0A1J1JBJ0,E0W4C3,A0A482XDA9,A0A3P7EJD6,J9K2Z4,A0A2J7Q8V4,T1IBM6,V3ZRX0,A0A210QKF7,A0A423TSS1,K1PT78,A0A267E8R7,A0A1D2N447,A0A226D7A9,F6YK55,T1KTE4,A0A2C9JGZ6,A0A1V9X9F0,K5X5Z7,A0A3Q0KUG5,T1FY40,1YVU,5G5T,5I4A,6QZK,7R8K,C4L1M1,A0A3D8L290,A0A0D8ZUC0,A0A0B0H9B4,B7GJX9,K9UEV4,A0A496APJ8,A0A062U2W9,A0A0Q2M2Z1,H8KXJ0,D3S0S6,A0A4Q6XKV6,A0A239JE83,A0A2N4XBY2,R5JEI2,A0A0Q0ZC47,A0A2T0XH18,A0A1K1RQP7,A0A0P0NGR6,A0A1X7IML5,A0A0A2LKJ7,K1L112,A0A0U3AL92,A0A1H3A054,A0A0C5JKF3,A0A142Y7A9,A0A372DKU2,C1F5Q7,A0A1P8WP90,A0A222F7P0,A0A1C9VH88,A0A1H3DGN3,E0TGY3,A0A4Q2UIU6,A0A1Q5ZS75,A0A2R5G167,A0A346PK63,R7RTW6,A0A1C3ZXN2,M5RSF0,A0A343TL88,A0A3P3RGE5,A0A329TBQ3,A0A0W1S8B8,L9VRQ2,,",366,37
"176","C.H4.4","C.S6.5",199,104,95,1.58066801619433,"4F1N,4F3T,A0A163JTZ6,J9D5G4,Q389P5,C4LVV2,A0A0G4H2S4,S4RWI0,Q1K660,F4PH46,A0A3M7S814,Q54G64,A0A2C5Z0M1,A0A1U7LLR0,A0A4S2MWZ7,A0A158P1R9,V6R0U9,A0A1E3QC61,D5GGK8,S8ANP9,L2GMR6,U4LBG4,O74957,A6N7Y9,A0A2G8JLH3,W2T741,S4RYE2,A0A226EFL3,A0A0L0TEV1,A0A1S3J512,A0A1J1HRI1,Q5TW24,A0A401PRI6,A0A2B4RHN2,A0A2T7PFL8,A0A024FT57,H3HCL6,A0A1S3CYL5,D7FQK3,T1GSU4,A0A1D8PMK0,A0A2G5B1D8,Q5BD61,A0A158PJG6,A0A158QZT6,R7YY92,A0A3S1A0C3,A0A1Q3ENA6,A8P0D4,A0A409Y6G2,D8PZT7,A0A1D1W4K0,A7RQ46,W4YU94,A7BJS5,X1WG39,M5FQK2,A0A2R6NSC2,A0A0D8XL16,A0A016WPN3,Q9QZ81,A0A0K0EFP6,Q8CJG0,A0A1D5NTU6,V2WTL2,A0A0V0YLH8,A0A139WDH0,A0A0R3W9Q7,H3DS31,A0A1Y1HWP2,B7QCC4,A0A0B2UV00,M7BCJ9,E9GN30,Q7PZ41,A0A077Z361,R7U9I3,A0A1X7V1N5,A0A0K0JDP1,A0A0N4UKJ1,A0A498N3A3,A0A3M0IQP5,A0A0L8GBV4,Q32KD4,A0A1J1JBJ0,E0W4C3,A0A482XDA9,A0A3P7EJD6,J9K2Z4,A0A2J7Q8V4,T1IBM6,V3ZRX0,A0A210QKF7,A0A423TSS1,K1PT78,A0A267E8R7,A0A1D2N447,A0A226D7A9,F6YK55,T1KTE4,A0A2C9JGZ6,A0A1V9X9F0,A0A3Q0KUG5,T1FY40,1Z26,5G5T,5I4A,E8N0K8,A0A4R1RMM2,A0A1Y2RDH8,Q11QW7,A0A1M5ZSR3,A0A0K8QX04,K9TPA9,A0A2U2J9E0,A0A326U7G5,A0A3D8L290,K9U8J6,K9RC91,A0A0D8ZUC0,A0A139XGN8,A0A1T4Y3A2,A0YYT3,A0A2T1EFY0,G6FTN0,A0A433NB65,A0A1Z4L0A1,K9UQR0,A0A2T1G8M7,K9VUN0,A0A0P6X5X2,K9ZDE3,B0JXD6,A0A2T1LS63,A0A1Z4K1Y3,A0A0P4UVI8,A0A0V7ZCG4,A0A1J0AGK2,A0A2G9DT08,K9UEV4,Q9L1X1,R5XQK4,A0A496APJ8,S7VLM7,A0A1A5X8H4,A0A1R3T9N6,A0A0Q2M2Z1,D3S0S6,A0A2D1U4H7,I3TE64,A0A0B7I4Z6,A0A139WY18,A0A2T1E1K4,A0A1Q8ZD62,A0A4Q6XKV6,A0A1Z3HNN4,A0A239JE83,A0A2N4XBY2,R5JEI2,A0A0Q0ZC47,A0A2T0XH18,A0A1V4CHV0,A0A1K1RQP7,A0A1N6LUI7,A0A0P0NGR6,A0A1X7IML5,A0A0A2LKJ7,K1L112,A0A1H3A054,A5D4D9,A0A432MEQ5,A0A372DKU2,A0A3R7KLK4,A0A4R3EV39,A0A1P8WP90,A0A222F7P0,A0A1C9VH88,A0A2T2YMB1,A0A329TD61,A0A101R2A0,A0A1U9ND56,A0A4R7BQC4,A0A1H3DGN3,A0A1Q1FPH0,E0TGY3,A0A259TUP4,A0A4Q2UIU6,A0A1H3X247,M0D2X3,A0A2R5G167,B9LVP8,M5RSF0,W0JW77,B7K585,A0A343TL88,A0A0W1S8B8,A0A1V4C8L7,L9VRQ2,A0A1I0NI68,,",366,37
"177","C.H5.8","C.S6.3",178,104,74,1.89553014553015,"4F3T,4KRE,6OON,7SWF,A0A196SDB4,J9D5G4,A2DPV7,A0A0G4H2S4,S4RWI0,A0A0D1ZAJ4,Q1K660,A0A3M7S814,A0A383WDW5,Q54G64,I0YVB2,R9ACY5,A0A1U7LLR0,E3KLI3,L2GMR6,O74957,T1KZ60,W2T741,A0A1W0E4B5,A0A2J7QB22,A0A2K3CW87,C4V9J2,A0A075AN09,U5HIG6,G2QEV0,A0A397UU01,A0A2T7PFL8,A0A0G4IME3,D7FQK3,A0A1Y1YHC8,T1GSU4,F4S231,A0A2G5B1D8,A0A1C7M8P2,A0A158PJG6,A0A158QZT6,T0SAU8,A0A3S1A0C3,A0A2K1J482,O04379,A0A371I3C8,M8AEW7,A8P0D4,A0A2K3NY65,F4NYW7,D8PZT7,A0A1D1W4K0,A7RQ46,W4YU94,A7BJS5,X1WG39,Q69VD5,A0A2R6NSC2,A0A0D8XL16,A0A016WPN3,Q9QZ81,G5EES3,A0A0K0EFP6,Q8CJG0,A0A1D5NTU6,V2WTL2,A0A0V0YLH8,A0A139WDH0,A0A0R3W9Q7,H3DS31,G4T5G9,B7QCC4,A0A0B2UV00,M7BCJ9,E9GN30,Q7PZ41,A0A077Z361,R7U9I3,A0A1X7V1N5,A0A0K0JDP1,A0A0N4UKJ1,A0A498N3A3,A0A3M0IQP5,A0A0L8GBV4,Q32KD4,A0A1J1JBJ0,E0W4C3,A0A482XDA9,A0A3P7EJD6,J9K2Z4,A0A2J7Q8V4,T1IBM6,V3ZRX0,A0A210QKF7,A0A423TSS1,K1PT78,A0A267E8R7,A0A1D2N447,A0A226D7A9,F6YK55,T1KTE4,A0A2C9JGZ6,A0A1V9X9F0,A0A3Q0KUG5,T1FY40,3DLB,5AWH,5G5T,5I4A,A0A328VKE4,A0A1W6MIP2,A0A326U7G5,A0A3D8L290,K9U8J6,K9RC91,A0A0D8ZUC0,Q5P0R2,A0YYT3,A0A2T1EFY0,G6FTN0,A0A433NB65,A0A2T1G8M7,A0A2Z6E0R7,A0A060HNJ0,A0A1H3LE92,A0A496APJ8,A0A1V9G9U4,A0A1A5X8H4,A0A1I2T6Q1,A0A1R3T9N6,A0A2D1U4H7,A0LL61,A0A139WY18,A0A1J1EK56,A0A2T1E1K4,A0A1Q8ZD62,A0A1Z3HNN4,Q53W94,A0A0Q0ZC47,A0A2T0XH18,A0A1V4CHV0,A0A1K1RQP7,A0A2T1EKT1,A0A1N6LUI7,A0A0A2LKJ7,K1L112,A0A0U3AL92,A0A1H3A054,K9XZC6,B9LVW4,Q31N05,A0A0C5JKF3,A0A142Y7A9,A0A432MEQ5,A0A372DKU2,A0A4R3EV39,A0A1P8WP90,A0A222F7P0,A0A1C9VH88,A0A329TD61,A0A1U9ND56,A0A4R7BQC4,A0A1Q1FPH0,F6EYI8,A0A2S9Q9J0,A0A4Q2UIU6,A0A345E7N0,A0A1H3X247,M0D2X3,A0A2R5G167,A0A1H2RBI2,M5RSF0,B7K585,L0AJX6,A0A2A5QS34,A0A3P3RGE5,A0A329TBQ3,A0A1V4C8L7,A0A1I6HGN0,,",366,37
"178","C.L11.2","C.L3.18",146,105,41,3.35551684088269,"4F3T,4KRE,6KR6,6OON,7SWF,J9D5G4,T1H8B3,S4RWI0,D2VMG4,A0A3M7S814,R7QGN7,K1VVQ6,A0A158P1R9,V6R0U9,G4N9J3,E3KLI3,B7Q5I1,U4LBG4,A0A177URI1,A6N7Y9,T1KZ60,A0A250WXN5,A0A2G8JLH3,Q5KAT1,L2GUF2,W2T741,A0A1W0E4B5,A0A2J7QB22,S4RYE2,A0A2K3CW87,A0A388KES6,A0A226EFL3,A0A3S3PD82,A0A1J1HRI1,C4V9J2,Q9JMB7,A0A401PRI6,Q96J94,A0A2B4RHN2,G2QEV0,A0A2T7PFL8,A0A0G4IME3,E9FUN9,A0A1S3CYL5,D7FQK3,T1GSU4,A0A2G5B1D8,A0A158PJG6,A0A0C2XG51,A0A158QZT6,A0A3S1A0C3,A0A074YJ47,A0A1Q3ENA6,F4NYW7,A0A0L0HAB7,A0A1D1W4K0,A7RQ46,W4YU94,A7BJS5,X1WG39,A0A0D8XL16,A0A016WPN3,Q9QZ81,G5EES3,A0A0K0EFP6,Q8CJG0,A0A1D5NTU6,A0A0V0YLH8,A0A139WDH0,A0A0R3W9Q7,H3DS31,B7QCC4,A0A0B2UV00,M7BCJ9,E9GN30,Q7PZ41,A0A077Z361,R7U9I3,A0A1X7V1N5,A0A0K0JDP1,A0A0N4UKJ1,A0A498N3A3,A0A3M0IQP5,A0A0L8GBV4,Q32KD4,A0A1J1JBJ0,E0W4C3,A0A482XDA9,A0A3P7EJD6,J9K2Z4,A0A2J7Q8V4,T1IBM6,V3ZRX0,A0A210QKF7,A0A423TSS1,K1PT78,A0A267E8R7,A0A1D2N447,A0A226D7A9,F6YK55,T1KTE4,A0A2C9JGZ6,A0A1V9X9F0,A0A3Q0KUG5,T1FY40,1YVU,1Z26,3DLB,B1XJG0,A0A235B542,A0A0Q2M2Z1,Q8DKB1,A0A1J1EK56,A0A2T1EKT1,E0UCX3,K9XZC6,B9LVW4,A0A0C1VHB4,Q31N05,Q2JI93,A0A329TD61,A0A1E3XF49,H1YCU5,A0A1Q5ZS75,M0AF24,A0A1W2A082,A0A1H3X247,A0A0C1XUA0,M0D2X3,A0A346PK63,A0A1H2RBI2,A0A1C3ZXN2,B9LVP8,W0JW77,F8D8G0,A0A343TL88,L0AJX6,A0A2A5QS34,A0A3P3RGE5,A0A329TBQ3,A0A0W1S8B8,A0A1V4C8L7,L9VRQ2,E4NRV1,A0A1I6HGN0,A0A1I0NI68,,",366,37
"181","N.H4.1","N.S19.1",229,105,124,2.28010752688172,"4F3T,5GUH,5VM9,6KR6,7KX7,A0A0N4X8S8,C4LVV2,A8BCK6,A2DPV7,A0A0G4H2S4,T1H8B3,D2VMG4,A0A0D1ZAJ4,Q1K660,F4PH46,A0A3M7S814,A0A164ZA52,Q54G64,S7WCF7,R7QGN7,A0A2C5Z0M1,A0CB11,R9ACY5,D3BMP8,W7XD45,A0A1U7LLR0,A0A4S2MWZ7,A0A158P1R9,G7DVX0,V6R0U9,E3KLI3,A0A1E3QC61,D5GGK8,S8ANP9,A0A139AUH8,L2GMR6,A0A3N4IGK1,A6N7Y9,A0A0E9NDK5,T1KZ60,A0A2G8JLH3,Q5KAT1,L2GUF2,A0A1W0E4B5,A0A2J7QB22,S4RYE2,A0A2K3CW87,A0A388KES6,A0A226EFL3,A0A3S3PD82,A0A0L0TEV1,A0A1S3J512,G0QTT2,A0A1J1HRI1,C4V9J2,Q9JMB7,A0A075AN09,Q5TW24,A0A401PRI6,Q96J94,A0A2B4RHN2,G2QEV0,K7ISV0,E9FUN9,A0A1S3CYL5,T1GSU4,A0A1D8PMK0,Q5BD61,A0A1C7M8P2,A0A4D8YSQ3,J9JZ66,A0A165QYQ9,A0A3S1A0C3,A0A074YJ47,A0A2K1J482,O04379,A0A371I3C8,M8AEW7,A8P0D4,A0A2K3NY65,A0A0L0HAB7,D8SNM6,A0A1J8PPA3,A0A2R6NSC2,A0A0K0EFP6,V2WTL2,A0A0V0YLH8,A0A139WDH0,A0A1Y1HWP2,B7QCC4,A0A0B2UV00,E9GN30,Q7PZ41,A0A0K0JDP1,A0A0N4UKJ1,A0A0L8GBV4,Q32KD4,A0A1J1JBJ0,A0A482XDA9,A0A2J7Q8V4,A0A267E8R7,A0A1D2N447,T1KTE4,A0A1V9X9F0,K5X5Z7,1YVU,1Z26,3DLB,5G5T,5I4A,6QZK,7R8K,E0ST67,C4L1M1,A0A0M2PXX3,A0A1I3LMA1,A0A1C0UUC4,B1XJG0,A0A1T4Y3A2,A0A0B0H9B4,R6KUL9,B7GJX9,A0A1N6SSK9,A0A2G9DT08,Q9L1X1,A0A060HNJ0,A0A235B542,R5XQK4,A0A1H3LE92,A0A496APJ8,A0A062U2W9,H0HWQ5,A0A1V9G9U4,A0A1I2ZGP1,A0A317EJY3,A0A1I2BD20,F8ERC7,S7VLM7,A0A1A5X8H4,A0A1I2T6Q1,A0A1R3T9N6,A0A0Q2M2Z1,H8KXJ0,D3S0S6,A0A2D1U4H7,I3TE64,A0A0B7I4Z6,A0LL61,Q8DKB1,A0A139WY18,A0A1J1EK56,A0A2T1E1K4,A0A1Q8ZD62,A0A4Q6XKV6,A0A1Z3HNN4,A0A239JE83,A0A2N4XBY2,Q53W94,R5JEI2,A0A0Q0ZC47,A0A2T0XH18,A0A1V4CHV0,A0A1K1RQP7,A0A2T1EKT1,A0A1N6LUI7,A0A0P0NGR6,A0A1X7IML5,A0A0A2LKJ7,K1L112,A0A0U3AL92,A0A1H3A054,E0UCX3,K9XZC6,A0A0C1VHB4,Q31N05,A0A0C5JKF3,R5NJJ8,A5D4D9,Q2JI93,A0A142Y7A9,A0A372DKU2,C1F5Q7,A0A4R3EV39,A0A1P8WP90,A0A222F7P0,A0A1C9VH88,A0A2T2YMB1,A0A329TD61,A0A101R2A0,A0A1E3XF49,A0A1U9ND56,A0A4R7BQC4,A0A1Q1FPH0,E0TGY3,A0A259TUP4,F6EYI8,A0A2S9Q9J0,A0A4Q2UIU6,A0A1H0LH25,A0A318LG42,H1YCU5,L0JS08,A0A1Q5ZS75,A0A345E7N0,M0AF24,A0A1W2A082,A0A1H3X247,A0A0C1XUA0,M0D2X3,A0A346PK63,R7RTW6,A0A1H2RBI2,A0A1C3ZXN2,B9LVP8,W0JW77,F8D8G0,A0A343TL88,L0AJX6,A0A2A5QS34,A0A343JEE2,A0A3P3RGE5,A0A329TBQ3,A0A285N2A8,A0A0W1S8B8,A0A1V4C8L7,L9VRQ2,E4NRV1,A0A1I6HGN0,A0A1I0NI68,,",366,37
"184","N.S14.4","N.S17.4",167,105,62,1.52987711213518,"4F3T,4KRE,5VM9,6OON,7KX7,Q389P5,A2DPV7,T1H8B3,S4RWI0,D2VMG4,Q1K660,A0A3M7S814,A0A383WDW5,Q54G64,I0YVB2,C1DZY0,D3BMP8,W7XD45,A0A4S2MWZ7,A0A158P1R9,G4N9J3,E3KLI3,D5GGK8,S8ANP9,A0A139AUH8,L2GMR6,U4LBG4,O74957,A0A2G8JLH3,W2T741,A0A1W0E4B5,A0A2J7QB22,S4RYE2,A0A226EFL3,A0A3S3PD82,A0A1S3J512,G0QTT2,A0A1J1HRI1,Q5TW24,U5HIG6,A0A401PRI6,Q96J94,A0A2B4RHN2,G2QEV0,A0A2T7PFL8,K7ISV0,A0A024FT57,H3HCL6,E9FUN9,D7FQK3,T1GSU4,Q5BD61,A0A1C7M8P2,A0A158PJG6,J9JZ66,A0A158QZT6,T0SAU8,A0A3S1A0C3,A0A074YJ47,A8P0D4,D8PZT7,D8SNM6,X1WG39,M5FQK2,A0A2R6NSC2,A0A0D8XL16,A0A016WPN3,Q9QZ81,G5EES3,A0A0K0EFP6,Q8CJG0,A0A1D5NTU6,V2WTL2,A0A0V0YLH8,A0A139WDH0,H3DS31,A0A1Y1HWP2,B7QCC4,A0A0B2UV00,M7BCJ9,E9GN30,A0A077Z361,R7U9I3,A0A1X7V1N5,A0A0K0JDP1,A0A0N4UKJ1,A0A498N3A3,A0A3M0IQP5,A0A0L8GBV4,Q32KD4,A0A1J1JBJ0,E0W4C3,A0A3P7EJD6,J9K2Z4,A0A210QKF7,A0A423TSS1,K1PT78,A0A1D2N447,A0A226D7A9,F6YK55,T1KTE4,A0A2C9JGZ6,K5X5Z7,A0A3Q0KUG5,T1FY40,3DLB,E0ST67,H1KXR6,A0A1N6SSK9,A0A2G9DT08,Q9L1X1,A0A496APJ8,S7VLM7,A0A1A5X8H4,A0A1I2T6Q1,A0A1R3T9N6,A0A0Q2M2Z1,H8KXJ0,A0A2D1U4H7,A0LL61,A0A139WY18,A0A2T1E1K4,A0A1Q8ZD62,A0A1Z3HNN4,R5JEI2,A0A1V4CHV0,A0A1K1RQP7,A0A0P0NGR6,A0A1X7IML5,A0A0A2LKJ7,A0A0U3AL92,A0A1H3A054,A0A0C5JKF3,R5NJJ8,A5D4D9,A0A142Y7A9,A0A432MEQ5,A0A372DKU2,A0A3R7KLK4,C1F5Q7,A0A4R3EV39,A0A1P8WP90,A0A222F7P0,A0A1C9VH88,A0A2T2YMB1,A0A101R2A0,A0A1U9ND56,A0A4R7BQC4,A0A1H3DGN3,E0TGY3,A0A259TUP4,F6EYI8,A0A2S9Q9J0,A0A4Q2UIU6,A0A318LG42,L0JS08,A0A1Q5ZS75,M0AF24,M0D2X3,A0A2R5G167,A0A346PK63,A0A1C3ZXN2,B7K585,F8D8G0,A0A343JEE2,A0A1V4C8L7,A0A1I0NI68,,",366,37
"189","C.S1.1","C.S2.1",254,106,148,2.69365119836818,"4F1N,4F3T,4KRE,5GUH,5VM9,6KR6,6OON,7KX7,A0A163JTZ6,J9D5G4,Q389P5,T1H8B3,R1FDF0,S4RWI0,A0A074TLL7,A0A3M7S814,S7WCF7,K1VVQ6,A0A158P1R9,B7Q5I1,L2GMR6,A6N7Y9,T1KZ60,A0A2G8JLH3,Q5KAT1,L2GUF2,W2T741,A0A2J7QB22,S4RYE2,A0A1S3J512,A0A1J1HRI1,C4V9J2,Q9JMB7,A0A075AN09,Q5TW24,U5HIG6,A0A401PRI6,Q96J94,A0A2B4RHN2,A0A397UU01,A0A2T7PFL8,K7ISV0,A0A1S3CYL5,A0A1Y1YHC8,A0A1D8PMK0,A0A2G5B1D8,A0A158PJG6,J9JZ66,A0A0C2XG51,A0A158QZT6,A0A165QYQ9,A0A3S1A0C3,A0A1Q3ENA6,F4NYW7,A0A409Y6G2,A0A0L0HAB7,D8PZT7,A0A1D1W4K0,W4YU94,A0A1J8PPA3,X1WG39,M5FQK2,A0A0D8XL16,A0A016WPN3,Q9QZ81,G5EES3,A0A0K0EFP6,Q8CJG0,A0A1D5NTU6,V2WTL2,A0A0V0YLH8,A0A139WDH0,A0A0R3W9Q7,H3DS31,G4T5G9,B7QCC4,A0A0B2UV00,M7BCJ9,E9GN30,A0A077Z361,R7U9I3,A0A1X7V1N5,A0A0K0JDP1,A0A0N4UKJ1,A0A498N3A3,A0A3M0IQP5,A0A0L8GBV4,E0W4C3,A0A482XDA9,A0A3P7EJD6,J9K2Z4,A0A2J7Q8V4,T1IBM6,V3ZRX0,A0A210QKF7,A0A423TSS1,K1PT78,A0A267E8R7,A0A1D2N447,A0A226D7A9,F6YK55,T1KTE4,A0A2C9JGZ6,A0A1V9X9F0,A0A3Q0KUG5,T1FY40,1YVU,1Z26,5AWH,5G5T,5I4A,A0A1I7IXT4,A0A2W1JZ37,A0A2S7WBN3,A0A420DFE6,E0ST67,A0A4V1VDY2,A0A368P5I0,A0A4R1RMM2,A0A1Y2RDH8,Q11QW7,A0A1M5ZSR3,A0A0K8QX04,K9TPA9,A0A1L3JHM3,A0A1W6MIP2,A0A2U2J9E0,A0A2Z6E1D5,B1XJG0,A0A3D8L290,A0A1Q4R485,K9U8J6,K9RC91,A0A0D8ZUC0,A0A139XGN8,A0A1T4Y3A2,Q5P0R2,A0A0B0H9B4,A0YYT3,A0A2T1EFY0,G6FTN0,A0A433NB65,A0A1Z4L0A1,K9UQR0,A0A2T1G8M7,K9VUN0,B7GJX9,K9ZDE3,B0JXD6,A0A2T1LS63,A0A1Z4K1Y3,A0A2Z6E0R7,A0A0P4UVI8,A0A0V7ZCG4,A0A1J0AGK2,K9PFF9,A0A2G9DT08,K9UEV4,Q9L1X1,A0A1H3LE92,A0A496APJ8,A0A1V9G9U4,S7VLM7,A0A1A5X8H4,A0A1I2T6Q1,A0A1R3T9N6,A0A0Q2M2Z1,H8KXJ0,A0A2D1U4H7,A0A0B7I4Z6,A0LL61,Q8DKB1,A0A139WY18,A0A1J1EK56,A0A2T1E1K4,A0A1Q8ZD62,A0A4Q6XKV6,A0A1Z3HNN4,A0A239JE83,A0A2N4XBY2,Q53W94,R5JEI2,A0A0Q0ZC47,A0A2T0XH18,A0A1V4CHV0,A0A1K1RQP7,A0A1N6LUI7,A0A0P0NGR6,A0A1X7IML5,A0A0A2LKJ7,K1L112,A0A0U3AL92,A0A1H3A054,E0UCX3,K9XZC6,A0A0C1VHB4,Q31N05,A0A0C5JKF3,A5D4D9,Q2JI93,A0A142Y7A9,A0A432MEQ5,A0A372DKU2,A0A3R7KLK4,C1F5Q7,A0A4R3EV39,A0A1P8WP90,A0A222F7P0,A0A1C9VH88,A0A2T2YMB1,A0A329TD61,A0A101R2A0,A0A1E3XF49,A0A1U9ND56,A0A4R7BQC4,A0A1H3DGN3,A0A1Q1FPH0,E0TGY3,A0A259TUP4,F6EYI8,A0A2S9Q9J0,A0A4Q2UIU6,A0A1H0LH25,A0A318LG42,H1YCU5,L0JS08,A0A1Q5ZS75,A0A345E7N0,M0AF24,A0A1W2A082,A0A1H3X247,A0A0C1XUA0,M0D2X3,A0A2R5G167,A0A346PK63,A0A1H2RBI2,A0A1C3ZXN2,B9LVP8,M5RSF0,W0JW77,B7K585,F8D8G0,A0A343TL88,L0AJX6,A0A2A5QS34,A0A3P3RGE5,A0A329TBQ3,A0A285N2A8,A0A0W1S8B8,A0A1V4C8L7,L9VRQ2,E4NRV1,A0A1I6HGN0,A0A1I0NI68,,",366,37
"191","N.H5.12","N.S14.7",151,107,44,1.45571367884452,"4F3T,4KRE,6OON,7KX7,A0A196SDB4,C4LVV2,T1H8B3,S4RWI0,D2VMG4,Q1K660,F4PH46,A0A3M7S814,A0A164ZA52,A0A383WDW5,I0YVB2,C1DZY0,A0CB11,D3BMP8,A0A1Z5TVE5,A0A4S2MWZ7,G4N9J3,D5GGK8,S8ANP9,U4LBG4,A0A177URI1,A0A3N4IGK1,A0A250WXN5,W2T741,A0A2J7QB22,S4RYE2,A0A2K3CW87,A0A226EFL3,G0QTT2,A0A1J1HRI1,C4V9J2,Q96J94,A0A2T7PFL8,K7ISV0,E9FUN9,A0A1S3CYL5,T1GSU4,F4S231,Q5BD61,A0A158PJG6,A0A0C2XG51,A0A158QZT6,T0SAU8,A0A3S1A0C3,A8P0D4,F4NYW7,A0A409Y6G2,D8PZT7,A0A1D1W4K0,A7RQ46,W4YU94,A7BJS5,A0A1J8PPA3,X1WG39,M5FQK2,A0A2R6NSC2,A0A0D8XL16,A0A016WPN3,Q9QZ81,G5EES3,Q8CJG0,A0A1D5NTU6,V2WTL2,A0A0V0YLH8,A0A139WDH0,A0A0R3W9Q7,H3DS31,A0A1Y1HWP2,B7QCC4,A0A0B2UV00,M7BCJ9,E9GN30,Q7PZ41,A0A077Z361,R7U9I3,A0A1X7V1N5,A0A0K0JDP1,A0A0N4UKJ1,A0A498N3A3,A0A3M0IQP5,A0A0L8GBV4,Q32KD4,A0A1J1JBJ0,E0W4C3,A0A482XDA9,A0A3P7EJD6,J9K2Z4,A0A2J7Q8V4,T1IBM6,V3ZRX0,A0A210QKF7,A0A423TSS1,K1PT78,A0A267E8R7,A0A1D2N447,A0A226D7A9,F6YK55,T1KTE4,A0A2C9JGZ6,A0A1V9X9F0,K5X5Z7,A0A3Q0KUG5,T1FY40,A0A1T4Y3A2,A0A2G9DT08,Q9L1X1,S7VLM7,A0A1R3T9N6,A0A2D1U4H7,A0A0B7I4Z6,A0LL61,A0A1J1EK56,A0A4Q6XKV6,A0A239JE83,A0A2N4XBY2,Q53W94,A0A2T0XH18,A0A1K1RQP7,A0A1N6LUI7,A0A0P0NGR6,A0A1X7IML5,A0A0A2LKJ7,K1L112,A0A0U3AL92,A0A0C5JKF3,R5NJJ8,A5D4D9,C1F5Q7,A0A101R2A0,A0A1U9ND56,A0A4R7BQC4,E0TGY3,A0A259TUP4,A0A2S9Q9J0,M0AF24,A0A1W2A082,M0D2X3,A0A2R5G167,A0A346PK63,R7RTW6,F8D8G0,A0A343JEE2,A0A0W1S8B8,A0A1V4C8L7,L9VRQ2,A0A1I6HGN0,A0A1I0NI68,,",366,37
"192","N.S12.3","N.S2.4",167,107,60,1.82196261682243,"4F1N,4F3T,4KRE,5GUH,6OON,7KX7,C4LVV2,A0A2P6N8X7,A8BCK6,A0A0G4H2S4,R1FDF0,S4RWI0,D2VMG4,F4PH46,A0A164ZA52,A0A383WDW5,C1DZY0,A0CB11,A0A1Z5TVE5,W7XD45,K1VVQ6,E3KLI3,A0A1E3QC61,A0A139AUH8,A0A0E9NDK5,A0A2G8JLH3,L2GUF2,A0A388KES6,A0A0L0TEV1,G0QTT2,A0A1J1HRI1,U5HIG6,A0A2B4RHN2,G2QEV0,A0A397UU01,A0A2T7PFL8,A0A024FT57,H3HCL6,A0A0G4IME3,A0A1Y1YHC8,T1GSU4,F4S231,A0A1D8PMK0,A0A2G5B1D8,Q5BD61,A0A1C7M8P2,A0A158PJG6,A0A158QZT6,A0A165QYQ9,T0SAU8,A0A3S1A0C3,A0A1Q3ENA6,A8P0D4,D8PZT7,A7RQ46,W4YU94,A7BJS5,A0A1J8PPA3,X1WG39,A0A2R6NSC2,A0A0D8XL16,A0A016WPN3,Q9QZ81,G5EES3,A0A0K0EFP6,Q8CJG0,A0A1D5NTU6,V2WTL2,A0A0V0YLH8,A0A139WDH0,A0A0R3W9Q7,H3DS31,G4T5G9,B7QCC4,A0A0B2UV00,M7BCJ9,E9GN30,Q7PZ41,A0A077Z361,R7U9I3,A0A1X7V1N5,A0A0K0JDP1,A0A0N4UKJ1,A0A498N3A3,A0A3M0IQP5,A0A0L8GBV4,Q32KD4,A0A1J1JBJ0,E0W4C3,A0A482XDA9,A0A3P7EJD6,J9K2Z4,A0A2J7Q8V4,T1IBM6,V3ZRX0,A0A210QKF7,A0A423TSS1,K1PT78,A0A267E8R7,A0A1D2N447,A0A226D7A9,F6YK55,T1KTE4,A0A2C9JGZ6,A0A1V9X9F0,A0A3Q0KUG5,T1FY40,5AWH,7R8K,A0A326U7G5,K9U8J6,A0A139XGN8,A0YYT3,A0A433NB65,A0A1Z4L0A1,K9UQR0,K9ZDE3,B0JXD6,A0A2T1LS63,K9PFF9,A0A060HNJ0,A0A235B542,H0HWQ5,A0A1I2BD20,S7VLM7,A0A0Q2M2Z1,A0A0B7I4Z6,Q8DKB1,A0A1J1EK56,A0A4Q6XKV6,A0A239JE83,A0A2N4XBY2,Q53W94,R5JEI2,A0A0Q0ZC47,A0A2T0XH18,A0A1V4CHV0,A0A1K1RQP7,A0A2T1EKT1,A0A0P0NGR6,A0A1X7IML5,A0A0A2LKJ7,E0UCX3,K9XZC6,A0A0C1VHB4,Q31N05,Q2JI93,C1F5Q7,A0A1P8WP90,A0A2T2YMB1,A0A329TD61,A0A4R7BQC4,A0A1Q1FPH0,L0JS08,A0A345E7N0,A0A1H3X247,A0A346PK63,B9LVP8,M5RSF0,B7K585,A0A343TL88,A0A3P3RGE5,A0A329TBQ3,A0A0W1S8B8,L9VRQ2,E4NRV1,A0A1I6HGN0,,",366,37
"193","C.H1.8","C.H4.4",208,108,100,2.46222222222222,"4F3T,4KRE,5GUH,5VM9,6KR6,6OON,7SWF,A0A163JTZ6,A0A196SDB4,A0A2P6N8X7,T1H8B3,S4RWI0,D2VMG4,A0A0D1ZAJ4,Q1K660,F4PH46,A0A3M7S814,A0A164ZA52,Q54G64,I0YVB2,A0A2C5Z0M1,D3BMP8,A0A1Z5TVE5,W7XD45,A0A1U7LLR0,A0A4S2MWZ7,V6R0U9,G4N9J3,A0A1E3QC61,D5GGK8,S8ANP9,A0A139AUH8,L2GMR6,U4LBG4,O74957,A0A0E9NDK5,T1KZ60,L2GUF2,W2T741,A0A1W0E4B5,A0A2J7QB22,S4RYE2,A0A388KES6,A0A0L0TEV1,A0A1J1HRI1,Q9JMB7,Q5TW24,U5HIG6,A0A401PRI6,Q96J94,A0A397UU01,K7ISV0,A0A024FT57,H3HCL6,D7FQK3,A0A2G5B1D8,Q5BD61,A0A1C7M8P2,A0A4D8YSQ3,A0A158PJG6,J9JZ66,A0A0C2XG51,A0A158QZT6,T0SAU8,A0A3S1A0C3,A0A074YJ47,A0A2K1J482,A0A1Q3ENA6,O04379,A0A371I3C8,M8AEW7,A8P0D4,A0A2K3NY65,F4NYW7,A0A0L0HAB7,D8PZT7,A0A1D1W4K0,W4YU94,D8SNM6,A0A1J8PPA3,X1WG39,A0A2R6NSC2,A0A0D8XL16,A0A016WPN3,Q9QZ81,G5EES3,A0A0K0EFP6,Q8CJG0,A0A1D5NTU6,V2WTL2,H3DS31,A0A1Y1HWP2,G4T5G9,B7QCC4,A0A0B2UV00,M7BCJ9,R7U9I3,A0A0K0JDP1,A0A0N4UKJ1,A0A498N3A3,A0A3M0IQP5,A0A0L8GBV4,E0W4C3,A0A2J7Q8V4,A0A423TSS1,F6YK55,T1KTE4,A0A1V9X9F0,1YVU,5AWH,5G5T,5I4A,6QZK,E8N0K8,A0A1I7IXT4,A0A2W1JZ37,A0A2S7WBN3,A0A420DFE6,A0A4V1VDY2,A0A368P5I0,A0A0M2PXX3,K9TPA9,A0A1C0UUC4,A0A2U2J9E0,A0A326U7G5,A0A1T4Y3A2,A0YYT3,G6FTN0,R6KUL9,A0A1Z4L0A1,K9UQR0,A0A0P6X5X2,K9ZDE3,A0A2T1LS63,A0A1N6SSK9,A0A0P4UVI8,A0A1J0AGK2,A0A2G9DT08,K9UEV4,Q9L1X1,A0A060HNJ0,A0A235B542,R5XQK4,A0A1H3LE92,A0A496APJ8,A0A1V9G9U4,S7VLM7,A0A1A5X8H4,A0A1R3T9N6,H8KXJ0,A0A2D1U4H7,A0LL61,A0A139WY18,A0A2T1E1K4,A0A1Q8ZD62,A0A239JE83,A0A2T0XH18,A0A1V4CHV0,A0A1N6LUI7,K1L112,A0A0U3AL92,A0A1H3A054,B9LVW4,A0A0C5JKF3,R5NJJ8,A5D4D9,A0A142Y7A9,A0A432MEQ5,A0A372DKU2,C1F5Q7,A0A4R3EV39,A0A1P8WP90,A0A222F7P0,A0A1C9VH88,A0A2T2YMB1,A0A101R2A0,A0A1E3XF49,A0A1U9ND56,A0A4R7BQC4,A0A1Q1FPH0,E0TGY3,A0A4Q2UIU6,A0A1H0LH25,A0A318LG42,H1YCU5,L0JS08,A0A1Q5ZS75,A0A345E7N0,M0AF24,A0A1W2A082,A0A1H3X247,A0A0C1XUA0,M0D2X3,A0A2R5G167,A0A1C3ZXN2,B9LVP8,M5RSF0,F8D8G0,A0A343TL88,L0AJX6,A0A2A5QS34,A0A343JEE2,A0A3P3RGE5,A0A329TBQ3,L9VRQ2,E4NRV1,A0A1I6HGN0,A0A1I0NI68,,",366,37
"197","C.H3.10","C.H3.7",255,109,146,1.44511122282267,"4F1N,5GUH,5VM9,6KR6,7KX7,A0A163JTZ6,A0A196SDB4,J9D5G4,Q389P5,C4LVV2,A2DPV7,A0A0G4H2S4,T1H8B3,D2VMG4,A0A074TLL7,A0A0D1ZAJ4,Q1K660,F4PH46,A0A164ZA52,A0A383WDW5,Q54G64,I0YVB2,R7QGN7,C1DZY0,A0A2C5Z0M1,A0CB11,R9ACY5,D3BMP8,A0A1Z5TVE5,W7XD45,A0A1U7LLR0,A0A4S2MWZ7,A0A158P1R9,G7DVX0,V6R0U9,G4N9J3,E3KLI3,B7Q5I1,A0A1E3QC61,D5GGK8,S8ANP9,L2GMR6,U4LBG4,A0A177URI1,O74957,A0A3N4IGK1,A6N7Y9,A0A0E9NDK5,T1KZ60,A0A250WXN5,A0A2G8JLH3,L2GUF2,A0A1W0E4B5,A0A2J7QB22,S4RYE2,A0A2K3CW87,A0A388KES6,A0A226EFL3,A0A3S3PD82,A0A0L0TEV1,A0A1S3J512,G0QTT2,A0A1J1HRI1,C4V9J2,Q9JMB7,Q5TW24,U5HIG6,A0A401PRI6,Q96J94,A0A2B4RHN2,G2QEV0,A0A397UU01,K7ISV0,A0A024FT57,H3HCL6,A0A0G4IME3,E9FUN9,A0A1S3CYL5,D7FQK3,A0A1Y1YHC8,T1GSU4,F4S231,A0A1D8PMK0,A0A2G5B1D8,Q5BD61,A0A1C7M8P2,A0A4D8YSQ3,J9JZ66,A0A0C2XG51,A0A165QYQ9,T0SAU8,R7YY92,A0A074YJ47,A0A2K1J482,A0A1Q3ENA6,O04379,A8P0D4,A0A2K3NY65,F4NYW7,A0A409Y6G2,A0A0L0HAB7,D8PZT7,D8SNM6,A0A1J8PPA3,M5FQK2,A0A2R6NSC2,V2WTL2,G4T5G9,K5X5Z7,1YVU,1Z26,5I4A,7R8K,E8N0K8,A0A1I7IXT4,A0A2W1JZ37,A0A2S7WBN3,A0A328VKE4,A0A420DFE6,A0A4V1VDY2,A0A368P5I0,A0A4R1RMM2,A0A1Y2RDH8,A0A1M5ZSR3,A0A0K8QX04,K9TPA9,A0A1L3JHM3,A0A1W6MIP2,A0A1C0UUC4,A0A2U2J9E0,A0A2Z6E1D5,A0A0F4NXW8,L8D0R3,B1XJG0,A0A326U7G5,A0A3D8L290,H1KXR6,A0A1Q4R485,K9U8J6,A0A097QRL6,K9RC91,A0A0D8ZUC0,A0A139XGN8,A0A1T4Y3A2,Q5P0R2,B6YTQ5,A0YYT3,A0A2T1EFY0,G6FTN0,A0A433NB65,A0A1Z4L0A1,K9UQR0,A0A2T1G8M7,K9VUN0,A0A0P6X5X2,K9ZDE3,B0JXD6,A0A2T1LS63,A0A1Z4K1Y3,A0A2Z6E0R7,A0A0P4UVI8,A0A0V7ZCG4,A0A1J0AGK2,K9PFF9,A0A2G9DT08,K9UEV4,Q9L1X1,A0A060HNJ0,A0A496APJ8,A0A062U2W9,A0A1V9G9U4,A0A1I2ZGP1,A0A317EJY3,A0A1I2BD20,F8ERC7,S7VLM7,A0A1A5X8H4,A0A1I2T6Q1,A0A1R3T9N6,A0A0Q2M2Z1,H8KXJ0,D3S0S6,A0A2D1U4H7,I3TE64,A0A0B7I4Z6,A0LL61,Q8DKB1,A0A139WY18,A0A1J1EK56,A0A2T1E1K4,A0A1Q8ZD62,A0A4Q6XKV6,A0A1Z3HNN4,A0A239JE83,A0A2N4XBY2,Q53W94,R5JEI2,A0A0Q0ZC47,A0A2T0XH18,A0A1V4CHV0,A0A1K1RQP7,A0A2T1EKT1,A0A1N6LUI7,A0A0P0NGR6,A0A1X7IML5,A0A0A2LKJ7,K1L112,A0A0U3AL92,A0A1H3A054,E0UCX3,K9XZC6,A0A0C1VHB4,Q31N05,A0A0C5JKF3,R5NJJ8,A5D4D9,Q2JI93,A0A142Y7A9,A0A432MEQ5,A0A372DKU2,C1F5Q7,A0A4R3EV39,A0A1P8WP90,A0A222F7P0,A0A1C9VH88,A0A2T2YMB1,A0A329TD61,A0A101R2A0,A0A1E3XF49,A0A1U9ND56,A0A4R7BQC4,A0A1Q1FPH0,E0TGY3,A0A259TUP4,F6EYI8,A0A2S9Q9J0,A0A4Q2UIU6,A0A1H0LH25,A0A318LG42,H1YCU5,A0A1Q5ZS75,A0A345E7N0,A0A1W2A082,A0A1H3X247,A0A0C1XUA0,A0A2R5G167,R7RTW6,A0A1H2RBI2,A0A1C3ZXN2,B9LVP8,M5RSF0,W0JW77,B7K585,A0A343JEE2,A0A1I0NI68,,",366,37
"200","C.H9.12","C.S8.3",233,109,124,1.76464930452797,"4KRE,5GUH,6KR6,6OON,7KX7,7SWF,A0A0N4X8S8,Q389P5,C4LVV2,A0A2P6N8X7,A8BCK6,A2DPV7,A0A0G4H2S4,R1FDF0,D2VMG4,Q1K660,F4PH46,A0A3M7S814,A0A383WDW5,Q54G64,S7WCF7,I0YVB2,C1DZY0,D3BMP8,A0A1Z5TVE5,W7XD45,K1VVQ6,A0A158P1R9,G4N9J3,B7Q5I1,S8ANP9,L2GMR6,A0A177URI1,A6N7Y9,A0A0E9NDK5,T1KZ60,A0A2G8JLH3,A0A1W0E4B5,A0A2J7QB22,A0A0L0TEV1,A0A1S3J512,G0QTT2,A0A1J1HRI1,Q9JMB7,A0A401PRI6,Q96J94,A0A2B4RHN2,G2QEV0,A0A397UU01,A0A2T7PFL8,K7ISV0,A0A024FT57,H3HCL6,A0A1S3CYL5,T1GSU4,A0A1D8PMK0,A0A2G5B1D8,Q5BD61,J9JZ66,T0SAU8,A0A3S1A0C3,A0A1Q3ENA6,A0A409Y6G2,A0A0L0HAB7,A0A1D1W4K0,A7RQ46,W4YU94,A7BJS5,A0A1J8PPA3,X1WG39,Q9QZ81,Q8CJG0,A0A1D5NTU6,A0A0V0YLH8,A0A139WDH0,A0A0R3W9Q7,H3DS31,G4T5G9,B7QCC4,M7BCJ9,E9GN30,Q7PZ41,A0A077Z361,R7U9I3,A0A1X7V1N5,A0A498N3A3,A0A3M0IQP5,A0A0L8GBV4,Q32KD4,A0A1J1JBJ0,E0W4C3,A0A482XDA9,A0A3P7EJD6,J9K2Z4,A0A2J7Q8V4,T1IBM6,V3ZRX0,A0A210QKF7,A0A423TSS1,K1PT78,A0A267E8R7,A0A1D2N447,A0A226D7A9,F6YK55,T1KTE4,A0A2C9JGZ6,A0A1V9X9F0,A0A3Q0KUG5,T1FY40,1Z26,3DLB,5AWH,5I4A,A0A328VKE4,E0ST67,C4L1M1,Q11QW7,A0A1M5ZSR3,A0A0K8QX04,A0A0M2PXX3,K9TPA9,A0A1L3JHM3,A0A1C0UUC4,A0A2U2J9E0,A0A2Z6E1D5,A0A0F4NXW8,L8D0R3,B1XJG0,A0A326U7G5,K9U8J6,K9RC91,A0A0D8ZUC0,A0A139XGN8,A0A1T4Y3A2,Q5P0R2,A0A0B0H9B4,A0YYT3,A0A433NB65,A0A1Z4L0A1,A0A2T1G8M7,K9VUN0,B7GJX9,K9ZDE3,B0JXD6,A0A2T1LS63,A0A2Z6E0R7,A0A1N6SSK9,A0A0P4UVI8,A0A0V7ZCG4,A0A1J0AGK2,A0A2G9DT08,Q9L1X1,A0A060HNJ0,A0A235B542,A0A1H3LE92,A0A1I2BD20,S7VLM7,A0A1A5X8H4,A0A1I2T6Q1,A0A1R3T9N6,H8KXJ0,A0A2D1U4H7,A0A0B7I4Z6,A0LL61,A0A4Q6XKV6,A0A1Z3HNN4,A0A239JE83,A0A2N4XBY2,R5JEI2,A0A0Q0ZC47,A0A2T0XH18,A0A1V4CHV0,A0A1K1RQP7,A0A1N6LUI7,A0A0P0NGR6,A0A1X7IML5,A0A0A2LKJ7,K1L112,A0A0U3AL92,A0A1H3A054,E0UCX3,K9XZC6,A0A0C1VHB4,A0A0C5JKF3,A5D4D9,Q2JI93,A0A142Y7A9,A0A432MEQ5,A0A372DKU2,A0A3R7KLK4,C1F5Q7,A0A4R3EV39,A0A1P8WP90,A0A222F7P0,A0A1C9VH88,A0A2T2YMB1,A0A329TD61,A0A101R2A0,A0A1U9ND56,A0A4R7BQC4,A0A1H3DGN3,E0TGY3,A0A259TUP4,F6EYI8,A0A2S9Q9J0,A0A4Q2UIU6,A0A1H0LH25,A0A318LG42,H1YCU5,L0JS08,A0A1Q5ZS75,M0AF24,M0D2X3,A0A2R5G167,R7RTW6,A0A1H2RBI2,A0A1C3ZXN2,M5RSF0,B7K585,F8D8G0,A0A343TL88,L0AJX6,A0A2A5QS34,A0A343JEE2,A0A3P3RGE5,A0A329TBQ3,A0A285N2A8,A0A0W1S8B8,A0A1V4C8L7,L9VRQ2,E4NRV1,A0A1I6HGN0,A0A1I0NI68,,",366,37
"204","C.H5.16","C.L7.4",171,110,61,1.16102831594635,"4KRE,5GUH,6OON,7KX7,A0A196SDB4,J9D5G4,A0A2P6N8X7,T1H8B3,S4RWI0,F4PH46,A0A3M7S814,C1DZY0,A0CB11,D3BMP8,W7XD45,A0A4S2MWZ7,A0A158P1R9,G7DVX0,V6R0U9,E3KLI3,A0A1E3QC61,S8ANP9,A0A139AUH8,A0A3N4IGK1,A0A0E9NDK5,A0A250WXN5,L2GUF2,W2T741,A0A1W0E4B5,S4RYE2,A0A2K3CW87,A0A226EFL3,A0A3S3PD82,A0A1S3J512,G0QTT2,A0A1J1HRI1,C4V9J2,A0A075AN09,U5HIG6,A0A2B4RHN2,G2QEV0,A0A397UU01,A0A2T7PFL8,E9FUN9,A0A1S3CYL5,A0A1Y1YHC8,F4S231,A0A1C7M8P2,A0A158PJG6,A0A0C2XG51,A0A158QZT6,T0SAU8,A0A3S1A0C3,A0A1Q3ENA6,F4NYW7,A0A0L0HAB7,A0A1D1W4K0,W4YU94,A7BJS5,A0A1J8PPA3,X1WG39,M5FQK2,Q69VD5,A0A0D8XL16,A0A016WPN3,Q9QZ81,G5EES3,A0A0K0EFP6,Q8CJG0,A0A1D5NTU6,A0A0V0YLH8,A0A139WDH0,A0A0R3W9Q7,H3DS31,G4T5G9,B7QCC4,A0A0B2UV00,M7BCJ9,E9GN30,Q7PZ41,A0A077Z361,R7U9I3,A0A1X7V1N5,A0A0K0JDP1,A0A0N4UKJ1,A0A498N3A3,A0A3M0IQP5,A0A0L8GBV4,Q32KD4,A0A1J1JBJ0,E0W4C3,A0A482XDA9,A0A3P7EJD6,J9K2Z4,A0A2J7Q8V4,T1IBM6,V3ZRX0,A0A210QKF7,A0A423TSS1,K1PT78,A0A267E8R7,A0A1D2N447,A0A226D7A9,F6YK55,T1KTE4,A0A2C9JGZ6,A0A1V9X9F0,K5X5Z7,A0A3Q0KUG5,T1FY40,5AWH,A0A328VKE4,A0A0M2PXX3,K9TPA9,A0A142XB92,K9U8J6,K9RC91,A0A0D8ZUC0,A0A139XGN8,A0A1T4Y3A2,A0A2T1EFY0,G6FTN0,A0A433NB65,K9UQR0,A0A2T1G8M7,K9VUN0,K9ZDE3,B0JXD6,A0A2T1LS63,A0A0P4UVI8,A0A0V7ZCG4,A0A1J0AGK2,A0A2G9DT08,Q9L1X1,A0A1H3LE92,A0A1A5X8H4,A0A1I2T6Q1,H8KXJ0,A0A2D1U4H7,A0A239JE83,R5JEI2,A0A1N6LUI7,A0A0A2LKJ7,A0A0U3AL92,A0A1H3A054,B9LVW4,A0A0C5JKF3,A5D4D9,A0A142Y7A9,A0A372DKU2,A0A4R3EV39,A0A1P8WP90,A0A222F7P0,A0A1C9VH88,A0A2T2YMB1,A0A101R2A0,A0A1U9ND56,A0A4R7BQC4,A0A1Q1FPH0,E0TGY3,A0A259TUP4,F6EYI8,A0A2S9Q9J0,A0A4Q2UIU6,A0A318LG42,A0A1H3X247,A0A346PK63,B9LVP8,W0JW77,B7K585,A0A285N2A8,,",366,37
"205","C.L23.10","C.L23.8",220,110,110,1.11818181818182,"4KRE,6KR6,7KX7,A0A0N4X8S8,J9D5G4,A2DPV7,A0A0G4H2S4,D2VMG4,A0A074TLL7,Q1K660,F4PH46,A0A164ZA52,A0A383WDW5,S7WCF7,I0YVB2,R7QGN7,C1DZY0,A0A2C5Z0M1,A0CB11,D3BMP8,A0A1Z5TVE5,W7XD45,A0A1U7LLR0,A0A4S2MWZ7,K1VVQ6,V6R0U9,G4N9J3,A0A1E3QC61,D5GGK8,S8ANP9,L2GMR6,U4LBG4,O74957,A0A3N4IGK1,A6N7Y9,A0A0E9NDK5,A0A250WXN5,A0A2G8JLH3,Q5KAT1,L2GUF2,W2T741,A0A1W0E4B5,A0A2J7QB22,S4RYE2,A0A2K3CW87,A0A388KES6,A0A226EFL3,A0A3S3PD82,A0A0L0TEV1,A0A1S3J512,G0QTT2,A0A1J1HRI1,C4V9J2,A0A075AN09,Q5TW24,A0A401PRI6,A0A2B4RHN2,G2QEV0,A0A2T7PFL8,A0A0G4IME3,E9FUN9,A0A1S3CYL5,F4S231,Q5BD61,A0A4D8YSQ3,J9JZ66,A0A0C2XG51,A0A158QZT6,A0A074YJ47,A0A2K1J482,O04379,A0A371I3C8,M8AEW7,A0A2K3NY65,F4NYW7,D8PZT7,A0A1D1W4K0,W4YU94,A7BJS5,D8SNM6,A0A1J8PPA3,X1WG39,Q69VD5,A0A0D8XL16,A0A016WPN3,G5EES3,A0A0K0EFP6,Q8CJG0,V2WTL2,A0A0R3W9Q7,H3DS31,A0A1Y1HWP2,A0A0B2UV00,M7BCJ9,A0A077Z361,R7U9I3,A0A1X7V1N5,A0A0K0JDP1,A0A498N3A3,A0A3M0IQP5,A0A0L8GBV4,E0W4C3,A0A3P7EJD6,A0A2J7Q8V4,V3ZRX0,A0A423TSS1,K1PT78,A0A1D2N447,A0A226D7A9,A0A1V9X9F0,1Z26,5I4A,A0A328VKE4,E0ST67,C4L1M1,A0A4R1RMM2,Q11QW7,A0A0M2PXX3,K9TPA9,A0A1W6MIP2,A0A1C0UUC4,A0A0F4NXW8,A0A142XB92,L8D0R3,A0A326U7G5,A0A3D8L290,A0A1Q4R485,K9U8J6,A0A097QRL6,K9RC91,A0A0D8ZUC0,A0A1T4Y3A2,Q5P0R2,A0A0B0H9B4,A0YYT3,G6FTN0,R6KUL9,A0A433NB65,A0A1Z4L0A1,K9UQR0,A0A2T1G8M7,K9VUN0,B7GJX9,K9ZDE3,B0JXD6,A0A2T1LS63,A0A1Z4K1Y3,A0A2Z6E0R7,A0A1N6SSK9,A0A0P4UVI8,A0A0V7ZCG4,K9PFF9,A0A2G9DT08,K9UEV4,Q9L1X1,A0A062U2W9,H0HWQ5,A0A1V9G9U4,A0A1I2ZGP1,A0A317EJY3,A0A1I2BD20,F8ERC7,A0A1A5X8H4,A0A1I2T6Q1,A0A0Q2M2Z1,H8KXJ0,A0A2D1U4H7,A0A139WY18,A0A2T1E1K4,A0A1Q8ZD62,A0A1Z3HNN4,A0A1V4CHV0,K9XZC6,R5NJJ8,A5D4D9,Q2JI93,A0A432MEQ5,A0A3R7KLK4,C1F5Q7,A0A4R3EV39,A0A2T2YMB1,A0A329TD61,A0A101R2A0,A0A1E3XF49,A0A1H3DGN3,A0A1Q1FPH0,E0TGY3,A0A4Q2UIU6,A0A1H0LH25,A0A318LG42,H1YCU5,L0JS08,A0A1Q5ZS75,A0A345E7N0,M0AF24,A0A1W2A082,A0A1H3X247,A0A0C1XUA0,M0D2X3,A0A2R5G167,A0A346PK63,R7RTW6,A0A1H2RBI2,A0A1C3ZXN2,M5RSF0,W0JW77,B7K585,F8D8G0,A0A343TL88,L0AJX6,A0A343JEE2,A0A3P3RGE5,A0A329TBQ3,A0A285N2A8,A0A0W1S8B8,A0A1V4C8L7,L9VRQ2,E4NRV1,A0A1I6HGN0,A0A1I0NI68,,",366,37
"215","C.L18.1","C.L20.1",161,113,48,4.01364306784661,"4F1N,5GUH,A0A163JTZ6,A0A2P6N8X7,A8BCK6,S4RWI0,D2VMG4,F4PH46,A0A3M7S814,Q54G64,S7WCF7,C1DZY0,D3BMP8,W7XD45,A0A158P1R9,E3KLI3,B7Q5I1,A6N7Y9,A0A0E9NDK5,A0A250WXN5,A0A2G8JLH3,Q5KAT1,L2GUF2,W2T741,A0A2J7QB22,A0A2K3CW87,A0A226EFL3,A0A0L0TEV1,A0A1S3J512,A0A1J1HRI1,Q9JMB7,A0A075AN09,U5HIG6,A0A401PRI6,A0A2B4RHN2,A0A397UU01,A0A2T7PFL8,K7ISV0,A0A024FT57,H3HCL6,A0A1S3CYL5,D7FQK3,A0A1Y1YHC8,T1GSU4,A0A1D8PMK0,A0A2G5B1D8,Q5BD61,A0A1C7M8P2,A0A4D8YSQ3,A0A158PJG6,A0A0C2XG51,A0A158QZT6,A0A165QYQ9,T0SAU8,R7YY92,A0A3S1A0C3,A0A074YJ47,A0A371I3C8,A8P0D4,A0A2K3NY65,A0A409Y6G2,A0A0L0HAB7,D8PZT7,A0A1D1W4K0,A7RQ46,W4YU94,A7BJS5,D8SNM6,A0A1J8PPA3,M5FQK2,Q69VD5,A0A2R6NSC2,A0A0D8XL16,A0A016WPN3,Q9QZ81,G5EES3,A0A0K0EFP6,Q8CJG0,A0A1D5NTU6,A0A0V0YLH8,A0A139WDH0,A0A0R3W9Q7,H3DS31,G4T5G9,B7QCC4,A0A0B2UV00,E9GN30,Q7PZ41,A0A077Z361,R7U9I3,A0A1X7V1N5,A0A0K0JDP1,A0A0N4UKJ1,Q32KD4,A0A1J1JBJ0,E0W4C3,A0A3P7EJD6,J9K2Z4,T1IBM6,V3ZRX0,A0A210QKF7,A0A423TSS1,K1PT78,A0A267E8R7,A0A1D2N447,A0A226D7A9,F6YK55,T1KTE4,A0A2C9JGZ6,A0A1V9X9F0,K5X5Z7,A0A3Q0KUG5,T1FY40,1YVU,1Z26,5AWH,5I4A,7R8K,E0ST67,A0A0M2PXX3,A0A1I3LMA1,A0A1C0UUC4,A0A142XB92,B1XJG0,H1KXR6,A0A097QRL6,B6YTQ5,A0A0B0H9B4,B7GJX9,A0A1N6SSK9,A0A235B542,A0A1H3LE92,A0A062U2W9,H0HWQ5,A0A1I2ZGP1,A0A317EJY3,A0A1I2BD20,A0A0Q2M2Z1,I3TE64,A0A2T1EKT1,A0A0U3AL92,A0A1H3A054,B9LVW4,A0A0C1VHB4,A0A1C9VH88,A0A1E3XF49,A0A1H3DGN3,H1YCU5,L0JS08,A0A1Q5ZS75,M0D2X3,A0A1H2RBI2,A0A1C3ZXN2,W0JW77,F8D8G0,L0AJX6,A0A2A5QS34,A0A343JEE2,A0A3P3RGE5,A0A329TBQ3,A0A1V4C8L7,,",366,37
"225","C.H10.6","C.L25.2",159,115,44,1.13774703557312,"4F1N,4F3T,4KRE,5GUH,5VM9,6KR6,6OON,7KX7,D2VMG4,F4PH46,A0A3M7S814,S7WCF7,R7QGN7,D3BMP8,W7XD45,A0A1U7LLR0,A0A158P1R9,G7DVX0,G4N9J3,B7Q5I1,L2GMR6,A0A177URI1,A0A3N4IGK1,A6N7Y9,T1KZ60,A0A2G8JLH3,W2T741,A0A1W0E4B5,A0A2J7QB22,S4RYE2,A0A2K3CW87,A0A226EFL3,A0A3S3PD82,A0A0L0TEV1,A0A1S3J512,G0QTT2,A0A1J1HRI1,C4V9J2,Q9JMB7,A0A075AN09,Q5TW24,U5HIG6,A0A401PRI6,Q96J94,A0A2B4RHN2,A0A2T7PFL8,K7ISV0,A0A0G4IME3,E9FUN9,A0A1S3CYL5,A0A1Y1YHC8,A0A158PJG6,J9JZ66,A0A0C2XG51,O04379,A8P0D4,A0A2K3NY65,F4NYW7,A0A0L0HAB7,A0A1D1W4K0,A7RQ46,W4YU94,A7BJS5,D8SNM6,A0A1J8PPA3,X1WG39,M5FQK2,Q69VD5,A0A2R6NSC2,A0A0D8XL16,A0A016WPN3,Q9QZ81,G5EES3,A0A0K0EFP6,Q8CJG0,A0A1D5NTU6,A0A0V0YLH8,A0A139WDH0,A0A0R3W9Q7,H3DS31,A0A1Y1HWP2,B7QCC4,A0A0B2UV00,M7BCJ9,E9GN30,Q7PZ41,A0A077Z361,R7U9I3,A0A1X7V1N5,A0A0K0JDP1,A0A0N4UKJ1,A0A498N3A3,A0A3M0IQP5,A0A0L8GBV4,Q32KD4,A0A1J1JBJ0,E0W4C3,A0A482XDA9,A0A3P7EJD6,J9K2Z4,A0A2J7Q8V4,T1IBM6,V3ZRX0,A0A210QKF7,A0A423TSS1,A0A267E8R7,A0A1D2N447,A0A226D7A9,F6YK55,T1KTE4,A0A2C9JGZ6,A0A1V9X9F0,K5X5Z7,A0A3Q0KUG5,T1FY40,5AWH,A0A1I7IXT4,A0A2W1JZ37,A0A2S7WBN3,A0A420DFE6,A0A4V1VDY2,A0A368P5I0,A0A4R1RMM2,A0A1Y2RDH8,A0A1M5ZSR3,A0A1L3JHM3,A0A1W6MIP2,A0A2U2J9E0,A0A3D8L290,A0A1N6SSK9,A0A496APJ8,A0A1V9G9U4,D3S0S6,I3TE64,A0A0B7I4Z6,A0A139WY18,A0A2T1E1K4,A0A1Q8ZD62,A0A4Q6XKV6,A0A1Z3HNN4,A0A239JE83,A0A2N4XBY2,R5JEI2,A0A0Q0ZC47,A0A2T0XH18,A0A1K1RQP7,A0A0P0NGR6,A0A1X7IML5,A0A0A2LKJ7,K1L112,A0A432MEQ5,A0A2T2YMB1,A0A1U9ND56,A0A259TUP4,F6EYI8,A0A2S9Q9J0,A0A2R5G167,M5RSF0,B7K585,,",366,37
"227","C.H9.3","C.H9.6",275,115,160,2.10135869565217,"4F3T,4KRE,5GUH,5VM9,6KR6,6OON,7KX7,7SWF,Q389P5,A0A2P6N8X7,D2VMG4,A0A074TLL7,F4PH46,A0A383WDW5,Q54G64,C1DZY0,A0CB11,R9ACY5,D3BMP8,A0A1Z5TVE5,W7XD45,A0A1U7LLR0,K1VVQ6,A0A158P1R9,G7DVX0,B7Q5I1,L2GMR6,A6N7Y9,T1KZ60,A0A250WXN5,A0A2G8JLH3,Q5KAT1,W2T741,A0A2J7QB22,S4RYE2,A0A2K3CW87,A0A226EFL3,A0A3S3PD82,A0A1S3J512,G0QTT2,A0A1J1HRI1,C4V9J2,Q9JMB7,A0A075AN09,Q5TW24,U5HIG6,A0A401PRI6,Q96J94,A0A2B4RHN2,G2QEV0,A0A2T7PFL8,K7ISV0,A0A024FT57,E9FUN9,A0A1S3CYL5,D7FQK3,A0A1Y1YHC8,T1GSU4,A0A1C7M8P2,A0A4D8YSQ3,A0A158PJG6,J9JZ66,A0A0C2XG51,A0A165QYQ9,R7YY92,A0A3S1A0C3,A0A074YJ47,A0A2K1J482,A0A1Q3ENA6,A0A2K3NY65,F4NYW7,A0A409Y6G2,A0A0L0HAB7,A0A1D1W4K0,W4YU94,A7BJS5,X1WG39,M5FQK2,Q69VD5,Q9QZ81,Q8CJG0,A0A1D5NTU6,A0A139WDH0,A0A0R3W9Q7,A0A1Y1HWP2,G4T5G9,B7QCC4,M7BCJ9,E9GN30,Q7PZ41,R7U9I3,A0A1X7V1N5,A0A0N4UKJ1,A0A498N3A3,A0A3M0IQP5,Q32KD4,A0A1J1JBJ0,E0W4C3,A0A482XDA9,A0A3P7EJD6,J9K2Z4,A0A2J7Q8V4,T1IBM6,V3ZRX0,A0A210QKF7,A0A423TSS1,A0A267E8R7,A0A1D2N447,A0A226D7A9,F6YK55,T1KTE4,A0A2C9JGZ6,A0A1V9X9F0,A0A3Q0KUG5,T1FY40,1YVU,1Z26,3DLB,5AWH,5I4A,6QZK,A0A328VKE4,E0ST67,C4L1M1,K9TPA9,A0A2Z6E1D5,A0A0F4NXW8,A0A142XB92,L8D0R3,B1XJG0,A0A326U7G5,A0A3D8L290,A0A1Q4R485,K9U8J6,A0A097QRL6,K9RC91,A0A0D8ZUC0,A0A139XGN8,A0A1T4Y3A2,Q5P0R2,B6YTQ5,A0A0B0H9B4,A0YYT3,A0A2T1EFY0,G6FTN0,R6KUL9,A0A433NB65,A0A1Z4L0A1,K9UQR0,A0A2T1G8M7,K9VUN0,B7GJX9,A0A0P6X5X2,K9ZDE3,B0JXD6,A0A2T1LS63,A0A1Z4K1Y3,A0A2Z6E0R7,A0A1N6SSK9,A0A0P4UVI8,A0A0V7ZCG4,A0A1J0AGK2,K9PFF9,A0A2G9DT08,K9UEV4,Q9L1X1,A0A060HNJ0,A0A235B542,R5XQK4,A0A1H3LE92,A0A496APJ8,A0A062U2W9,H0HWQ5,A0A1V9G9U4,A0A1I2ZGP1,A0A317EJY3,A0A1I2BD20,F8ERC7,S7VLM7,A0A1A5X8H4,A0A1I2T6Q1,A0A1R3T9N6,A0A0Q2M2Z1,D3S0S6,I3TE64,A0A0B7I4Z6,A0LL61,Q8DKB1,A0A139WY18,A0A1J1EK56,A0A2T1E1K4,A0A1Q8ZD62,A0A4Q6XKV6,A0A1Z3HNN4,A0A239JE83,A0A2N4XBY2,Q53W94,R5JEI2,A0A0Q0ZC47,A0A2T0XH18,A0A1V4CHV0,A0A1K1RQP7,A0A2T1EKT1,A0A1N6LUI7,A0A0P0NGR6,A0A1X7IML5,A0A0A2LKJ7,K1L112,A0A0U3AL92,A0A1H3A054,E0UCX3,K9XZC6,B9LVW4,A0A0C1VHB4,Q31N05,A0A0C5JKF3,R5NJJ8,A5D4D9,Q2JI93,A0A142Y7A9,A0A432MEQ5,A0A372DKU2,A0A3R7KLK4,C1F5Q7,A0A4R3EV39,A0A1P8WP90,A0A222F7P0,A0A1C9VH88,A0A2T2YMB1,A0A329TD61,A0A101R2A0,A0A1E3XF49,A0A1U9ND56,A0A4R7BQC4,A0A1H3DGN3,A0A1Q1FPH0,E0TGY3,A0A259TUP4,F6EYI8,A0A2S9Q9J0,A0A4Q2UIU6,A0A1H0LH25,A0A318LG42,H1YCU5,L0JS08,A0A1Q5ZS75,A0A345E7N0,M0AF24,A0A1W2A082,A0A1H3X247,A0A0C1XUA0,M0D2X3,A0A2R5G167,A0A346PK63,R7RTW6,A0A1H2RBI2,A0A1C3ZXN2,B9LVP8,M5RSF0,W0JW77,B7K585,F8D8G0,A0A343TL88,L0AJX6,A0A2A5QS34,A0A343JEE2,A0A3P3RGE5,A0A329TBQ3,A0A285N2A8,A0A0W1S8B8,A0A1V4C8L7,L9VRQ2,E4NRV1,A0A1I6HGN0,A0A1I0NI68,,",366,37
"229","N.S14.6","N.S17.3",199,115,84,1.8851966873706,"4F1N,4F3T,5GUH,5VM9,6KR6,6OON,J9D5G4,Q389P5,C4LVV2,A0A2P6N8X7,D2VMG4,A0A074TLL7,Q1K660,A0A383WDW5,S7WCF7,I0YVB2,R7QGN7,C1DZY0,A0A2C5Z0M1,A0CB11,R9ACY5,A0A1U7LLR0,A0A4S2MWZ7,G7DVX0,V6R0U9,E3KLI3,A0A1E3QC61,D5GGK8,S8ANP9,A0A139AUH8,O74957,A0A3N4IGK1,A6N7Y9,A0A0E9NDK5,A0A2G8JLH3,L2GUF2,A0A1W0E4B5,A0A2J7QB22,A0A2K3CW87,A0A388KES6,A0A226EFL3,A0A3S3PD82,A0A1S3J512,G0QTT2,A0A1J1HRI1,C4V9J2,Q9JMB7,U5HIG6,A0A401PRI6,Q96J94,A0A2B4RHN2,A0A397UU01,A0A024FT57,H3HCL6,E9FUN9,A0A1S3CYL5,D7FQK3,T1GSU4,F4S231,A0A1D8PMK0,A0A2G5B1D8,A0A1C7M8P2,A0A4D8YSQ3,A0A158PJG6,A0A158QZT6,A0A165QYQ9,T0SAU8,R7YY92,A0A074YJ47,A0A1Q3ENA6,O04379,A8P0D4,F4NYW7,A0A409Y6G2,D8PZT7,A0A1D1W4K0,A7RQ46,W4YU94,A7BJS5,A0A1J8PPA3,X1WG39,M5FQK2,A0A2R6NSC2,A0A0D8XL16,A0A016WPN3,Q9QZ81,A0A0K0EFP6,Q8CJG0,A0A1D5NTU6,V2WTL2,A0A0V0YLH8,A0A139WDH0,A0A1Y1HWP2,G4T5G9,B7QCC4,E9GN30,Q7PZ41,A0A077Z361,R7U9I3,A0A1X7V1N5,E0W4C3,A0A3P7EJD6,J9K2Z4,A0A2J7Q8V4,T1IBM6,V3ZRX0,A0A423TSS1,K1PT78,A0A267E8R7,A0A1D2N447,A0A226D7A9,F6YK55,A0A2C9JGZ6,K5X5Z7,A0A3Q0KUG5,1YVU,5AWH,5G5T,5I4A,E0ST67,C4L1M1,B1XJG0,A0A0B0H9B4,R6KUL9,B7GJX9,A0A235B542,R5XQK4,A0A1H3LE92,A0A496APJ8,A0A1V9G9U4,S7VLM7,A0A1I2T6Q1,A0A1R3T9N6,H8KXJ0,A0A2D1U4H7,A0A0B7I4Z6,A0LL61,Q8DKB1,A0A139WY18,A0A1J1EK56,A0A2T1E1K4,A0A1Q8ZD62,A0A4Q6XKV6,A0A1Z3HNN4,A0A239JE83,A0A2N4XBY2,Q53W94,R5JEI2,A0A0Q0ZC47,A0A2T0XH18,A0A1V4CHV0,A0A1K1RQP7,A0A2T1EKT1,A0A1N6LUI7,A0A0P0NGR6,A0A1X7IML5,A0A0A2LKJ7,K1L112,A0A0U3AL92,A0A1H3A054,E0UCX3,K9XZC6,A0A0C1VHB4,Q31N05,R5NJJ8,Q2JI93,A0A372DKU2,A0A3R7KLK4,C1F5Q7,A0A2T2YMB1,A0A1E3XF49,A0A1H3DGN3,A0A259TUP4,F6EYI8,H1YCU5,L0JS08,A0A1Q5ZS75,M0AF24,A0A1H3X247,A0A0C1XUA0,M0D2X3,A0A346PK63,A0A1C3ZXN2,B9LVP8,W0JW77,B7K585,F8D8G0,A0A343TL88,L0AJX6,A0A2A5QS34,A0A3P3RGE5,A0A329TBQ3,A0A285N2A8,A0A0W1S8B8,A0A1V4C8L7,L9VRQ2,E4NRV1,A0A1I6HGN0,A0A1I0NI68,,",366,37
"230","C.H1.9","C.S3.3",200,116,84,1.6867816091954,"4F1N,4F3T,4KRE,5GUH,5VM9,7SWF,A0A163JTZ6,J9D5G4,A0A2P6N8X7,A8BCK6,S4RWI0,A0A074TLL7,A0A0D1ZAJ4,A0A3M7S814,A0A383WDW5,I0YVB2,A0A2C5Z0M1,D3BMP8,A0A1Z5TVE5,A0A1U7LLR0,A0A4S2MWZ7,K1VVQ6,G7DVX0,V6R0U9,E3KLI3,D5GGK8,A0A139AUH8,L2GMR6,U4LBG4,A0A3N4IGK1,A0A0E9NDK5,Q5KAT1,W2T741,S4RYE2,A0A226EFL3,Q9JMB7,Q5TW24,U5HIG6,Q96J94,G2QEV0,A0A2T7PFL8,A0A024FT57,H3HCL6,A0A0G4IME3,D7FQK3,A0A1Y1YHC8,T1GSU4,F4S231,A0A2G5B1D8,A0A1C7M8P2,A0A4D8YSQ3,A0A158PJG6,A0A0C2XG51,A0A158QZT6,T0SAU8,A0A3S1A0C3,A0A074YJ47,A0A2K1J482,O04379,A0A371I3C8,M8AEW7,A0A2K3NY65,F4NYW7,A0A1D1W4K0,A7RQ46,W4YU94,A7BJS5,D8SNM6,X1WG39,Q69VD5,A0A2R6NSC2,A0A0D8XL16,A0A016WPN3,Q9QZ81,G5EES3,A0A0K0EFP6,Q8CJG0,A0A1D5NTU6,V2WTL2,A0A0V0YLH8,A0A139WDH0,A0A0R3W9Q7,H3DS31,A0A1Y1HWP2,B7QCC4,A0A0B2UV00,M7BCJ9,E9GN30,Q7PZ41,A0A077Z361,R7U9I3,A0A1X7V1N5,A0A0K0JDP1,A0A0N4UKJ1,A0A3M0IQP5,A0A0L8GBV4,Q32KD4,A0A1J1JBJ0,E0W4C3,A0A482XDA9,A0A3P7EJD6,J9K2Z4,A0A2J7Q8V4,T1IBM6,V3ZRX0,A0A210QKF7,K1PT78,A0A267E8R7,A0A1D2N447,A0A226D7A9,F6YK55,T1KTE4,A0A2C9JGZ6,A0A1V9X9F0,A0A3Q0KUG5,T1FY40,1YVU,1Z26,5AWH,5G5T,A0A1I7IXT4,A0A2W1JZ37,A0A2S7WBN3,A0A420DFE6,A0A4V1VDY2,A0A368P5I0,C4L1M1,A0A1I3LMA1,A0A1W6MIP2,A0A0D8ZUC0,A0A0B0H9B4,A0YYT3,A0A2T1EFY0,R6KUL9,A0A1Z4L0A1,K9UQR0,B7GJX9,A0A0P6X5X2,A0A2T1LS63,A0A1Z4K1Y3,A0A0P4UVI8,A0A1J0AGK2,K9PFF9,A0A2G9DT08,K9UEV4,Q9L1X1,A0A060HNJ0,A0A235B542,R5XQK4,A0A496APJ8,A0A062U2W9,A0A1V9G9U4,A0A1I2ZGP1,A0A317EJY3,A0A1I2BD20,S7VLM7,A0A1A5X8H4,A0A1R3T9N6,H8KXJ0,A0A0B7I4Z6,A0LL61,A0A139WY18,A0A2T1E1K4,A0A1Q8ZD62,A0A4Q6XKV6,A0A1Z3HNN4,A0A239JE83,A0A2N4XBY2,A0A2T0XH18,A0A1V4CHV0,A0A1K1RQP7,A0A1N6LUI7,A0A0P0NGR6,A0A1X7IML5,A0A0A2LKJ7,K1L112,A0A0C1VHB4,Q31N05,R5NJJ8,C1F5Q7,A0A2T2YMB1,A0A329TD61,A0A101R2A0,A0A1E3XF49,F6EYI8,A0A318LG42,H1YCU5,A0A345E7N0,M0AF24,M0D2X3,A0A346PK63,A0A1H2RBI2,A0A1C3ZXN2,B9LVP8,M5RSF0,W0JW77,L0AJX6,A0A2A5QS34,A0A343JEE2,A0A285N2A8,,",366,37
"233","C.L11.5","C.L2.1",266,116,150,3.10557471264368,"4F1N,4F3T,4KRE,5VM9,6OON,7KX7,7SWF,J9D5G4,R1FDF0,S4RWI0,D2VMG4,A0A074TLL7,A0A0D1ZAJ4,F4PH46,A0A164ZA52,A0A383WDW5,S7WCF7,R7QGN7,A0A2C5Z0M1,R9ACY5,D3BMP8,W7XD45,A0A1U7LLR0,A0A4S2MWZ7,K1VVQ6,A0A158P1R9,V6R0U9,G4N9J3,E3KLI3,A0A139AUH8,L2GMR6,U4LBG4,A0A177URI1,O74957,A0A3N4IGK1,A0A0E9NDK5,T1KZ60,A0A250WXN5,Q5KAT1,L2GUF2,W2T741,A0A1W0E4B5,A0A2J7QB22,S4RYE2,A0A2K3CW87,G0QTT2,C4V9J2,A0A075AN09,A0A2B4RHN2,G2QEV0,A0A397UU01,A0A024FT57,D7FQK3,T1GSU4,F4S231,A0A1D8PMK0,A0A2G5B1D8,Q5BD61,A0A1C7M8P2,A0A158PJG6,A0A0C2XG51,A0A158QZT6,A0A165QYQ9,T0SAU8,R7YY92,A0A3S1A0C3,A0A074YJ47,A0A1Q3ENA6,A8P0D4,D8PZT7,A0A1D1W4K0,A7RQ46,W4YU94,A7BJS5,D8SNM6,X1WG39,M5FQK2,A0A2R6NSC2,A0A0D8XL16,A0A016WPN3,G5EES3,A0A0K0EFP6,V2WTL2,A0A0V0YLH8,A0A139WDH0,A0A0R3W9Q7,A0A1Y1HWP2,B7QCC4,A0A0B2UV00,Q7PZ41,A0A077Z361,R7U9I3,A0A1X7V1N5,A0A0K0JDP1,A0A0N4UKJ1,A0A498N3A3,Q32KD4,A0A1J1JBJ0,E0W4C3,A0A482XDA9,A0A3P7EJD6,J9K2Z4,A0A2J7Q8V4,T1IBM6,V3ZRX0,A0A210QKF7,A0A423TSS1,K1PT78,A0A267E8R7,A0A1D2N447,A0A226D7A9,T1KTE4,A0A2C9JGZ6,A0A1V9X9F0,K5X5Z7,A0A3Q0KUG5,5AWH,5G5T,5I4A,7R8K,A0A1I7IXT4,A0A2W1JZ37,A0A2S7WBN3,A0A420DFE6,E0ST67,A0A4V1VDY2,A0A368P5I0,C4L1M1,A0A4R1RMM2,A0A1Y2RDH8,Q11QW7,A0A1M5ZSR3,A0A0K8QX04,A0A1I3LMA1,K9TPA9,A0A1L3JHM3,A0A1W6MIP2,A0A2U2J9E0,A0A2Z6E1D5,L8D0R3,A0A3D8L290,A0A1Q4R485,K9U8J6,K9RC91,A0A0D8ZUC0,A0A139XGN8,A0A1T4Y3A2,Q5P0R2,A0A0B0H9B4,A0YYT3,A0A2T1EFY0,G6FTN0,R6KUL9,A0A433NB65,A0A1Z4L0A1,K9UQR0,A0A2T1G8M7,K9VUN0,B7GJX9,K9ZDE3,B0JXD6,A0A2T1LS63,A0A1Z4K1Y3,A0A2Z6E0R7,A0A0P4UVI8,A0A0V7ZCG4,A0A1J0AGK2,K9PFF9,A0A2G9DT08,K9UEV4,Q9L1X1,A0A060HNJ0,A0A235B542,R5XQK4,A0A1H3LE92,A0A496APJ8,A0A062U2W9,H0HWQ5,A0A1V9G9U4,A0A1I2ZGP1,A0A317EJY3,A0A1I2BD20,F8ERC7,S7VLM7,A0A1A5X8H4,A0A1I2T6Q1,A0A1R3T9N6,H8KXJ0,A0A2D1U4H7,A0A0B7I4Z6,A0LL61,A0A139WY18,A0A2T1E1K4,A0A1Q8ZD62,A0A4Q6XKV6,A0A1Z3HNN4,A0A239JE83,A0A2N4XBY2,R5JEI2,A0A0Q0ZC47,A0A2T0XH18,A0A1V4CHV0,A0A1K1RQP7,A0A1N6LUI7,A0A0P0NGR6,A0A1X7IML5,A0A0A2LKJ7,K1L112,A0A0U3AL92,A0A1H3A054,B9LVW4,A0A0C5JKF3,A5D4D9,A0A142Y7A9,A0A432MEQ5,A0A372DKU2,A0A3R7KLK4,C1F5Q7,A0A4R3EV39,A0A1P8WP90,A0A222F7P0,A0A1C9VH88,A0A2T2YMB1,A0A329TD61,A0A101R2A0,A0A1E3XF49,A0A1U9ND56,A0A4R7BQC4,A0A1Q1FPH0,E0TGY3,A0A259TUP4,F6EYI8,A0A2S9Q9J0,A0A4Q2UIU6,A0A1H0LH25,A0A318LG42,H1YCU5,L0JS08,A0A1Q5ZS75,A0A345E7N0,M0AF24,A0A1W2A082,A0A1H3X247,A0A0C1XUA0,M0D2X3,A0A2R5G167,A0A346PK63,A0A1H2RBI2,A0A1C3ZXN2,B9LVP8,M5RSF0,W0JW77,B7K585,F8D8G0,A0A343TL88,L0AJX6,A0A2A5QS34,A0A3P3RGE5,A0A329TBQ3,A0A285N2A8,A0A0W1S8B8,A0A1V4C8L7,L9VRQ2,E4NRV1,A0A1I6HGN0,A0A1I0NI68,,",366,37
"234","C.L12.2","C.S7.2",166,116,50,2.45896551724138,"4F3T,4KRE,5GUH,5VM9,6KR6,6OON,7KX7,7SWF,A0A0G4H2S4,T1H8B3,S4RWI0,A0A3M7S814,A0A158P1R9,B7Q5I1,A0A1E3QC61,A0A3N4IGK1,A6N7Y9,T1KZ60,A0A2G8JLH3,L2GUF2,W2T741,A0A2J7QB22,S4RYE2,A0A388KES6,A0A226EFL3,A0A3S3PD82,A0A1S3J512,G0QTT2,A0A1J1HRI1,Q9JMB7,Q5TW24,U5HIG6,A0A401PRI6,Q96J94,A0A2B4RHN2,A0A397UU01,A0A2T7PFL8,K7ISV0,A0A024FT57,A0A0G4IME3,E9FUN9,A0A1S3CYL5,D7FQK3,T1GSU4,A0A2G5B1D8,A0A4D8YSQ3,A0A158PJG6,J9JZ66,A0A0C2XG51,A0A158QZT6,A0A165QYQ9,T0SAU8,R7YY92,A0A3S1A0C3,A0A2K1J482,A0A1Q3ENA6,O04379,A0A371I3C8,M8AEW7,A0A2K3NY65,A0A409Y6G2,A0A1D1W4K0,A7RQ46,W4YU94,A7BJS5,D8SNM6,A0A1J8PPA3,X1WG39,M5FQK2,Q69VD5,A0A0D8XL16,A0A016WPN3,Q9QZ81,G5EES3,A0A0K0EFP6,Q8CJG0,A0A1D5NTU6,A0A0V0YLH8,A0A139WDH0,A0A0R3W9Q7,H3DS31,A0A1Y1HWP2,G4T5G9,B7QCC4,A0A0B2UV00,M7BCJ9,E9GN30,Q7PZ41,A0A077Z361,R7U9I3,A0A1X7V1N5,A0A0K0JDP1,A0A0N4UKJ1,A0A498N3A3,A0A3M0IQP5,A0A0L8GBV4,Q32KD4,A0A1J1JBJ0,E0W4C3,A0A482XDA9,A0A3P7EJD6,J9K2Z4,A0A2J7Q8V4,T1IBM6,V3ZRX0,A0A210QKF7,A0A423TSS1,K1PT78,A0A267E8R7,A0A1D2N447,A0A226D7A9,T1KTE4,A0A2C9JGZ6,A0A1V9X9F0,A0A3Q0KUG5,T1FY40,1YVU,1Z26,3DLB,5G5T,5I4A,6QZK,A0A1H3LE92,A0A496APJ8,A0A1V9G9U4,A0A0Q2M2Z1,D3S0S6,I3TE64,A0A139WY18,A0A2T1E1K4,A0A1Q8ZD62,A0A1Z3HNN4,B9LVW4,R5NJJ8,A0A3R7KLK4,A0A329TD61,A0A1E3XF49,A0A1H3DGN3,A0A1Q1FPH0,H1YCU5,L0JS08,A0A1Q5ZS75,A0A345E7N0,M0AF24,A0A1W2A082,A0A1H3X247,A0A0C1XUA0,M0D2X3,A0A346PK63,R7RTW6,A0A1H2RBI2,A0A1C3ZXN2,B9LVP8,W0JW77,F8D8G0,A0A343TL88,A0A2A5QS34,A0A343JEE2,A0A3P3RGE5,A0A329TBQ3,A0A285N2A8,A0A0W1S8B8,A0A1V4C8L7,L9VRQ2,E4NRV1,A0A1I6HGN0,,",366,37
"237","N.S3.5","N.S5.4",166,118,48,1.6885593220339,"4F3T,4KRE,5GUH,5VM9,6OON,A0A2P6N8X7,T1H8B3,S4RWI0,D2VMG4,A0A0D1ZAJ4,Q1K660,S7WCF7,R7QGN7,C1DZY0,R9ACY5,A0A1Z5TVE5,K1VVQ6,A0A158P1R9,V6R0U9,A0A1E3QC61,A0A139AUH8,A6N7Y9,A0A0E9NDK5,T1KZ60,A0A2G8JLH3,Q5KAT1,A0A1W0E4B5,A0A2J7QB22,S4RYE2,A0A2K3CW87,A0A226EFL3,A0A1S3J512,G0QTT2,Q9JMB7,A0A075AN09,Q5TW24,A0A401PRI6,Q96J94,A0A2B4RHN2,A0A397UU01,K7ISV0,A0A1S3CYL5,D7FQK3,A0A1Y1YHC8,T1GSU4,A0A2G5B1D8,A0A1C7M8P2,A0A4D8YSQ3,A0A158PJG6,A0A0C2XG51,A0A158QZT6,R7YY92,A0A3S1A0C3,A0A074YJ47,A0A2K1J482,A0A1Q3ENA6,O04379,A0A371I3C8,M8AEW7,A8P0D4,A0A2K3NY65,D8PZT7,A0A1D1W4K0,A7RQ46,W4YU94,A7BJS5,D8SNM6,X1WG39,M5FQK2,Q69VD5,A0A2R6NSC2,A0A0D8XL16,A0A016WPN3,Q9QZ81,G5EES3,A0A0K0EFP6,Q8CJG0,A0A1D5NTU6,V2WTL2,A0A0V0YLH8,A0A139WDH0,A0A0R3W9Q7,H3DS31,A0A1Y1HWP2,B7QCC4,A0A0B2UV00,M7BCJ9,E9GN30,Q7PZ41,A0A077Z361,A0A1X7V1N5,A0A0K0JDP1,A0A0N4UKJ1,A0A498N3A3,A0A3M0IQP5,A0A0L8GBV4,Q32KD4,A0A1J1JBJ0,E0W4C3,A0A482XDA9,A0A3P7EJD6,J9K2Z4,A0A2J7Q8V4,T1IBM6,V3ZRX0,A0A210QKF7,A0A423TSS1,K1PT78,A0A267E8R7,A0A1D2N447,A0A226D7A9,F6YK55,T1KTE4,A0A2C9JGZ6,A0A1V9X9F0,K5X5Z7,A0A3Q0KUG5,T1FY40,1YVU,7R8K,A0A1M5ZSR3,Q5P0R2,A0A0P6X5X2,A0A062U2W9,H0HWQ5,A0A317EJY3,A0A1I2BD20,F8ERC7,A0A0Q2M2Z1,H8KXJ0,I3TE64,A0LL61,Q8DKB1,A0A2T0XH18,A0A1V4CHV0,A0A1K1RQP7,A0A2T1EKT1,A0A0A2LKJ7,K1L112,E0UCX3,K9XZC6,B9LVW4,A0A0C1VHB4,Q31N05,A0A0C5JKF3,R5NJJ8,Q2JI93,A0A372DKU2,C1F5Q7,A0A1P8WP90,A0A1C9VH88,A0A2T2YMB1,A0A101R2A0,A0A1E3XF49,E0TGY3,A0A318LG42,H1YCU5,A0A1Q5ZS75,A0A1W2A082,A0A0C1XUA0,R7RTW6,A0A1H2RBI2,A0A1C3ZXN2,W0JW77,L0AJX6,A0A2A5QS34,,",366,37
"238","C.H10.1","C.H9.13",248,119,129,1.64588626148134,"4F1N,4F3T,4KRE,6KR6,6OON,A0A163JTZ6,Q389P5,A2DPV7,R1FDF0,A0A074TLL7,F4PH46,A0A3M7S814,A0A383WDW5,Q54G64,A0CB11,R9ACY5,D3BMP8,A0A1U7LLR0,E3KLI3,A6N7Y9,T1KZ60,A0A250WXN5,W2T741,S4RYE2,A0A2K3CW87,A0A388KES6,A0A226EFL3,A0A1S3J512,G0QTT2,A0A1J1HRI1,Q9JMB7,A0A075AN09,A0A401PRI6,Q96J94,G2QEV0,A0A2T7PFL8,K7ISV0,A0A0G4IME3,A0A1S3CYL5,D7FQK3,A0A1Y1YHC8,T1GSU4,F4S231,A0A1D8PMK0,A0A2G5B1D8,Q5BD61,A0A4D8YSQ3,A0A158PJG6,A0A0C2XG51,A0A158QZT6,A0A165QYQ9,A0A3S1A0C3,A0A074YJ47,A0A2K1J482,A0A1Q3ENA6,O04379,A0A371I3C8,M8AEW7,A0A2K3NY65,F4NYW7,A0A409Y6G2,A0A0L0HAB7,A0A1D1W4K0,A7RQ46,W4YU94,A7BJS5,D8SNM6,A0A1J8PPA3,X1WG39,M5FQK2,Q69VD5,A0A2R6NSC2,A0A0D8XL16,A0A016WPN3,Q9QZ81,G5EES3,A0A0K0EFP6,Q8CJG0,A0A1D5NTU6,A0A0V0YLH8,A0A139WDH0,A0A0R3W9Q7,H3DS31,A0A1Y1HWP2,G4T5G9,B7QCC4,A0A0B2UV00,M7BCJ9,E9GN30,Q7PZ41,A0A077Z361,R7U9I3,A0A1X7V1N5,A0A0K0JDP1,A0A0N4UKJ1,A0A498N3A3,A0A3M0IQP5,A0A0L8GBV4,Q32KD4,A0A1J1JBJ0,E0W4C3,A0A482XDA9,A0A3P7EJD6,J9K2Z4,A0A2J7Q8V4,T1IBM6,V3ZRX0,A0A210QKF7,A0A423TSS1,K1PT78,A0A267E8R7,A0A1D2N447,A0A226D7A9,F6YK55,T1KTE4,A0A2C9JGZ6,A0A1V9X9F0,A0A3Q0KUG5,T1FY40,5G5T,5I4A,6QZK,A0A1I7IXT4,A0A2W1JZ37,A0A2S7WBN3,A0A420DFE6,A0A4V1VDY2,A0A368P5I0,A0A4R1RMM2,A0A1Y2RDH8,A0A1M5ZSR3,A0A0K8QX04,A0A0M2PXX3,K9TPA9,A0A1L3JHM3,A0A1W6MIP2,A0A1C0UUC4,A0A2U2J9E0,A0A0F4NXW8,L8D0R3,B1XJG0,A0A326U7G5,A0A3D8L290,A0A1Q4R485,K9U8J6,A0A097QRL6,A0A0D8ZUC0,A0A1T4Y3A2,Q5P0R2,B6YTQ5,A0YYT3,A0A2T1EFY0,R6KUL9,A0A433NB65,A0A1Z4L0A1,K9VUN0,K9ZDE3,B0JXD6,A0A1Z4K1Y3,A0A2Z6E0R7,A0A1N6SSK9,A0A0P4UVI8,A0A2G9DT08,K9UEV4,Q9L1X1,A0A060HNJ0,A0A1H3LE92,A0A496APJ8,A0A062U2W9,H0HWQ5,A0A1V9G9U4,A0A1I2ZGP1,A0A317EJY3,A0A1I2BD20,F8ERC7,A0A1A5X8H4,A0A1I2T6Q1,A0A1R3T9N6,H8KXJ0,D3S0S6,A0A2D1U4H7,I3TE64,A0LL61,Q8DKB1,A0A139WY18,A0A1J1EK56,A0A2T1E1K4,A0A1Q8ZD62,Q53W94,A0A1V4CHV0,A0A2T1EKT1,A0A1N6LUI7,A0A0U3AL92,A0A1H3A054,E0UCX3,K9XZC6,A0A0C1VHB4,Q31N05,A0A0C5JKF3,R5NJJ8,A5D4D9,A0A142Y7A9,A0A432MEQ5,A0A372DKU2,A0A4R3EV39,A0A1P8WP90,A0A222F7P0,A0A1C9VH88,A0A101R2A0,A0A1E3XF49,A0A1U9ND56,A0A4R7BQC4,A0A1H3DGN3,A0A1Q1FPH0,E0TGY3,A0A259TUP4,A0A4Q2UIU6,A0A1H0LH25,A0A318LG42,H1YCU5,L0JS08,A0A1Q5ZS75,M0AF24,A0A1H3X247,A0A0C1XUA0,M0D2X3,A0A2R5G167,A0A346PK63,R7RTW6,A0A1H2RBI2,A0A1C3ZXN2,B9LVP8,M5RSF0,W0JW77,B7K585,F8D8G0,A0A343TL88,L0AJX6,A0A2A5QS34,A0A343JEE2,A0A3P3RGE5,A0A329TBQ3,A0A285N2A8,A0A0W1S8B8,L9VRQ2,E4NRV1,A0A1I6HGN0,A0A1I0NI68,,",366,37
"248","C.S11.2","C.S8.4",195,120,75,1.0975,"4F3T,6KR6,6OON,A0A163JTZ6,A0A196SDB4,J9D5G4,A0A2P6N8X7,A2DPV7,R1FDF0,S4RWI0,D2VMG4,A0A0D1ZAJ4,Q1K660,A0A3M7S814,Q54G64,S7WCF7,I0YVB2,R7QGN7,C1DZY0,A0A2C5Z0M1,A0CB11,A0A1Z5TVE5,W7XD45,A0A1U7LLR0,A0A4S2MWZ7,G4N9J3,E3KLI3,A0A1E3QC61,A0A139AUH8,U4LBG4,O74957,A0A3N4IGK1,A0A0E9NDK5,A0A250WXN5,Q5KAT1,W2T741,C4V9J2,A0A075AN09,A0A2B4RHN2,A0A2T7PFL8,A0A024FT57,H3HCL6,A0A0G4IME3,E9FUN9,A0A1S3CYL5,D7FQK3,A0A1Y1YHC8,T1GSU4,F4S231,A0A2G5B1D8,Q5BD61,A0A4D8YSQ3,A0A158PJG6,A0A0C2XG51,A0A158QZT6,A0A165QYQ9,T0SAU8,R7YY92,A0A3S1A0C3,A0A2K1J482,A0A1Q3ENA6,O04379,A0A371I3C8,M8AEW7,A8P0D4,A0A2K3NY65,F4NYW7,A0A0L0HAB7,D8PZT7,A0A1D1W4K0,A7RQ46,W4YU94,A7BJS5,D8SNM6,X1WG39,Q69VD5,A0A2R6NSC2,A0A0D8XL16,A0A016WPN3,Q9QZ81,G5EES3,A0A0K0EFP6,Q8CJG0,A0A1D5NTU6,V2WTL2,A0A139WDH0,A0A0R3W9Q7,H3DS31,A0A1Y1HWP2,B7QCC4,A0A0B2UV00,M7BCJ9,E9GN30,Q7PZ41,R7U9I3,A0A0K0JDP1,A0A0N4UKJ1,A0A498N3A3,A0A3M0IQP5,Q32KD4,A0A1J1JBJ0,E0W4C3,A0A482XDA9,A0A3P7EJD6,J9K2Z4,A0A2J7Q8V4,T1IBM6,V3ZRX0,A0A210QKF7,A0A423TSS1,K1PT78,A0A267E8R7,A0A1D2N447,A0A226D7A9,F6YK55,T1KTE4,A0A2C9JGZ6,A0A1V9X9F0,A0A3Q0KUG5,T1FY40,1YVU,5G5T,5I4A,6QZK,A0A328VKE4,A0A1M5ZSR3,A0A0K8QX04,A0A0M2PXX3,A0A1I3LMA1,K9TPA9,A0A1C0UUC4,A0A2Z6E1D5,A0A0F4NXW8,L8D0R3,A0A326U7G5,H1KXR6,A0A1Q4R485,K9U8J6,K9RC91,A0A0D8ZUC0,A0A139XGN8,Q5P0R2,B6YTQ5,A0A0B0H9B4,A0YYT3,A0A2T1EFY0,G6FTN0,R6KUL9,A0A433NB65,A0A1Z4L0A1,K9UQR0,A0A2T1G8M7,K9VUN0,B7GJX9,B0JXD6,A0A2T1LS63,A0A1Z4K1Y3,A0A2Z6E0R7,A0A1N6SSK9,A0A0P4UVI8,A0A0V7ZCG4,A0A1J0AGK2,K9PFF9,K9UEV4,A0A060HNJ0,A0A235B542,R5XQK4,A0A496APJ8,A0A1V9G9U4,A0A1I2T6Q1,D3S0S6,I3TE64,A0A139WY18,A0A2T1E1K4,R5NJJ8,A5D4D9,A0A1E3XF49,A0A4Q2UIU6,M0AF24,A0A1W2A082,A0A0C1XUA0,M0D2X3,R7RTW6,A0A1H2RBI2,W0JW77,A0A343TL88,L0AJX6,A0A2A5QS34,A0A343JEE2,A0A3P3RGE5,A0A285N2A8,A0A0W1S8B8,L9VRQ2,E4NRV1,A0A1I6HGN0,,",366,37
"250","N.L25.2","N.S2.5",196,120,76,1.94232456140351,"4F3T,4KRE,5GUH,6KR6,6OON,Q389P5,C4LVV2,A0A0G4H2S4,R1FDF0,S4RWI0,D2VMG4,F4PH46,Q54G64,R7QGN7,A0CB11,R9ACY5,D3BMP8,W7XD45,K1VVQ6,A0A158P1R9,G7DVX0,E3KLI3,A6N7Y9,T1KZ60,A0A250WXN5,A0A2G8JLH3,Q5KAT1,L2GUF2,S4RYE2,A0A2K3CW87,A0A388KES6,A0A226EFL3,A0A3S3PD82,A0A1S3J512,G0QTT2,A0A1J1HRI1,Q9JMB7,Q5TW24,U5HIG6,A0A401PRI6,Q96J94,A0A2B4RHN2,G2QEV0,A0A2T7PFL8,A0A024FT57,H3HCL6,A0A1S3CYL5,D7FQK3,T1GSU4,F4S231,A0A1D8PMK0,A0A1C7M8P2,A0A158PJG6,J9JZ66,A0A158QZT6,A0A165QYQ9,T0SAU8,R7YY92,A0A3S1A0C3,A0A074YJ47,A0A1Q3ENA6,A8P0D4,A0A409Y6G2,D8PZT7,A0A1D1W4K0,A7RQ46,W4YU94,A7BJS5,A0A1J8PPA3,X1WG39,M5FQK2,A0A0D8XL16,A0A016WPN3,Q9QZ81,G5EES3,A0A0K0EFP6,Q8CJG0,A0A1D5NTU6,V2WTL2,A0A0V0YLH8,A0A139WDH0,A0A0R3W9Q7,H3DS31,A0A1Y1HWP2,G4T5G9,B7QCC4,A0A0B2UV00,M7BCJ9,E9GN30,Q7PZ41,A0A077Z361,R7U9I3,A0A1X7V1N5,A0A0K0JDP1,A0A0N4UKJ1,A0A498N3A3,A0A3M0IQP5,A0A0L8GBV4,Q32KD4,A0A1J1JBJ0,E0W4C3,A0A482XDA9,A0A3P7EJD6,J9K2Z4,A0A2J7Q8V4,T1IBM6,V3ZRX0,A0A210QKF7,A0A423TSS1,K1PT78,A0A267E8R7,A0A1D2N447,A0A226D7A9,F6YK55,T1KTE4,A0A2C9JGZ6,A0A1V9X9F0,K5X5Z7,A0A3Q0KUG5,T1FY40,1YVU,7R8K,A0A326U7G5,A0A1Q4R485,K9U8J6,K9RC91,A0A0D8ZUC0,A0A139XGN8,A0YYT3,A0A2T1EFY0,G6FTN0,A0A433NB65,A0A1Z4L0A1,A0A2T1G8M7,K9VUN0,K9ZDE3,B0JXD6,A0A2T1LS63,A0A1Z4K1Y3,A0A0P4UVI8,A0A1J0AGK2,K9PFF9,K9UEV4,H0HWQ5,S7VLM7,H8KXJ0,A0A2D1U4H7,A0A0B7I4Z6,A0LL61,A0A4Q6XKV6,A0A239JE83,A0A2N4XBY2,R5JEI2,A0A0Q0ZC47,A0A2T0XH18,A0A1K1RQP7,A0A1N6LUI7,A0A0P0NGR6,A0A1X7IML5,A0A0A2LKJ7,K1L112,A0A0C5JKF3,A5D4D9,A0A142Y7A9,C1F5Q7,A0A4R3EV39,A0A1P8WP90,A0A222F7P0,A0A2T2YMB1,A0A329TD61,A0A101R2A0,A0A1U9ND56,A0A4R7BQC4,A0A1Q1FPH0,E0TGY3,A0A259TUP4,F6EYI8,A0A2S9Q9J0,A0A4Q2UIU6,A0A1H0LH25,A0A318LG42,L0JS08,M0AF24,A0A1H3X247,M0D2X3,R7RTW6,B9LVP8,A0A343TL88,A0A343JEE2,A0A3P3RGE5,A0A329TBQ3,A0A0W1S8B8,A0A1V4C8L7,L9VRQ2,E4NRV1,A0A1I6HGN0,,",366,37
"257","N.L16.1","N.S14.3",213,121,92,3.4051832554797,"4F3T,4KRE,6KR6,6OON,7KX7,A0A163JTZ6,A0A196SDB4,J9D5G4,Q389P5,T1H8B3,S4RWI0,D2VMG4,Q1K660,F4PH46,A0A3M7S814,A0A164ZA52,I0YVB2,A0A2C5Z0M1,A0CB11,W7XD45,A0A1U7LLR0,A0A4S2MWZ7,V6R0U9,G4N9J3,E3KLI3,A0A1E3QC61,D5GGK8,S8ANP9,A0A139AUH8,L2GMR6,U4LBG4,O74957,A0A3N4IGK1,A0A250WXN5,W2T741,A0A1W0E4B5,A0A388KES6,A0A0L0TEV1,A0A075AN09,A0A401PRI6,A0A397UU01,A0A2T7PFL8,A0A024FT57,H3HCL6,A0A0G4IME3,D7FQK3,T1GSU4,Q5BD61,A0A4D8YSQ3,A0A158PJG6,A0A158QZT6,A0A165QYQ9,T0SAU8,R7YY92,A0A3S1A0C3,A0A2K1J482,A0A1Q3ENA6,O04379,A0A371I3C8,M8AEW7,A8P0D4,A0A2K3NY65,A0A409Y6G2,A0A0L0HAB7,D8PZT7,A0A1D1W4K0,A7RQ46,W4YU94,A7BJS5,D8SNM6,A0A1J8PPA3,X1WG39,M5FQK2,Q69VD5,A0A0D8XL16,A0A016WPN3,Q9QZ81,G5EES3,A0A0K0EFP6,Q8CJG0,A0A1D5NTU6,V2WTL2,A0A0V0YLH8,A0A139WDH0,A0A0R3W9Q7,H3DS31,A0A1Y1HWP2,G4T5G9,B7QCC4,A0A0B2UV00,M7BCJ9,E9GN30,Q7PZ41,A0A077Z361,R7U9I3,A0A1X7V1N5,A0A0K0JDP1,A0A0N4UKJ1,A0A498N3A3,A0A3M0IQP5,A0A0L8GBV4,Q32KD4,A0A1J1JBJ0,E0W4C3,A0A482XDA9,A0A3P7EJD6,J9K2Z4,A0A2J7Q8V4,T1IBM6,V3ZRX0,A0A210QKF7,A0A423TSS1,A0A267E8R7,A0A1D2N447,A0A226D7A9,F6YK55,T1KTE4,A0A2C9JGZ6,A0A1V9X9F0,K5X5Z7,T1FY40,1YVU,5AWH,5G5T,7R8K,E0ST67,C4L1M1,A0A1I3LMA1,A0A326U7G5,A0A1T4Y3A2,A0A0B0H9B4,R6KUL9,B7GJX9,A0A1N6SSK9,A0A235B542,R5XQK4,A0A1H3LE92,A0A496APJ8,A0A062U2W9,A0A1V9G9U4,A0A1I2ZGP1,F8ERC7,S7VLM7,A0A1A5X8H4,A0A1I2T6Q1,A0A1R3T9N6,A0A2D1U4H7,A0A0B7I4Z6,A0LL61,A0A139WY18,A0A2T1E1K4,A0A1Q8ZD62,A0A4Q6XKV6,A0A1Z3HNN4,A0A239JE83,A0A2N4XBY2,A0A0Q0ZC47,A0A2T0XH18,A0A1V4CHV0,A0A1K1RQP7,A0A1N6LUI7,A0A1X7IML5,A0A0A2LKJ7,K1L112,A0A1H3A054,B9LVW4,A0A0C5JKF3,R5NJJ8,A5D4D9,A0A142Y7A9,A0A432MEQ5,C1F5Q7,A0A4R3EV39,A0A1P8WP90,A0A222F7P0,A0A1C9VH88,A0A2T2YMB1,A0A1E3XF49,A0A1U9ND56,A0A4R7BQC4,E0TGY3,A0A259TUP4,F6EYI8,A0A2S9Q9J0,A0A4Q2UIU6,H1YCU5,A0A1Q5ZS75,M0AF24,A0A1W2A082,A0A1H3X247,A0A0C1XUA0,M0D2X3,A0A2R5G167,A0A346PK63,R7RTW6,A0A1H2RBI2,A0A1C3ZXN2,B9LVP8,M5RSF0,W0JW77,B7K585,F8D8G0,A0A343TL88,L0AJX6,A0A2A5QS34,A0A343JEE2,A0A3P3RGE5,A0A329TBQ3,A0A0W1S8B8,L9VRQ2,E4NRV1,A0A1I6HGN0,A0A1I0NI68,,",366,37
"259","C.H5.14","C.L11.2",261,123,138,1.06919406150583,"5GUH,5VM9,7KX7,J9D5G4,Q389P5,A0A2P6N8X7,A8BCK6,A0A0G4H2S4,T1H8B3,R1FDF0,D2VMG4,A0A0D1ZAJ4,F4PH46,A0A3M7S814,A0A164ZA52,Q54G64,A0A2C5Z0M1,A0CB11,R9ACY5,D3BMP8,A0A1Z5TVE5,A0A1U7LLR0,A0A4S2MWZ7,V6R0U9,B7Q5I1,D5GGK8,S8ANP9,U4LBG4,A0A177URI1,O74957,A0A3N4IGK1,W2T741,A0A2J7QB22,S4RYE2,A0A226EFL3,A0A3S3PD82,A0A1S3J512,G0QTT2,A0A1J1HRI1,Q9JMB7,Q5TW24,A0A2B4RHN2,A0A397UU01,A0A2T7PFL8,K7ISV0,H3HCL6,A0A1S3CYL5,T1GSU4,F4S231,A0A1D8PMK0,A0A2G5B1D8,A0A4D8YSQ3,A0A158PJG6,J9JZ66,A0A0C2XG51,A0A158QZT6,A0A165QYQ9,A0A3S1A0C3,A0A2K1J482,A0A1Q3ENA6,O04379,A0A371I3C8,M8AEW7,A8P0D4,A0A2K3NY65,A0A409Y6G2,A0A0L0HAB7,D8PZT7,A0A1D1W4K0,W4YU94,A7BJS5,D8SNM6,A0A1J8PPA3,X1WG39,M5FQK2,Q69VD5,A0A2R6NSC2,A0A0D8XL16,A0A016WPN3,Q9QZ81,G5EES3,A0A0K0EFP6,Q8CJG0,A0A1D5NTU6,V2WTL2,A0A0V0YLH8,A0A139WDH0,A0A0R3W9Q7,H3DS31,G4T5G9,B7QCC4,A0A0B2UV00,M7BCJ9,E9GN30,Q7PZ41,A0A077Z361,R7U9I3,A0A1X7V1N5,A0A0K0JDP1,A0A0N4UKJ1,A0A3M0IQP5,A0A0L8GBV4,Q32KD4,A0A1J1JBJ0,E0W4C3,A0A482XDA9,A0A3P7EJD6,J9K2Z4,A0A2J7Q8V4,T1IBM6,V3ZRX0,A0A210QKF7,A0A423TSS1,A0A267E8R7,A0A1D2N447,A0A226D7A9,F6YK55,T1KTE4,A0A2C9JGZ6,A0A1V9X9F0,K5X5Z7,A0A3Q0KUG5,T1FY40,3DLB,5AWH,E8N0K8,A0A1I7IXT4,A0A2W1JZ37,A0A2S7WBN3,A0A328VKE4,A0A420DFE6,A0A4V1VDY2,A0A368P5I0,A0A4R1RMM2,A0A1Y2RDH8,Q11QW7,A0A1M5ZSR3,A0A0K8QX04,A0A0M2PXX3,K9TPA9,A0A1L3JHM3,A0A1W6MIP2,A0A1C0UUC4,A0A2U2J9E0,A0A2Z6E1D5,B1XJG0,A0A326U7G5,A0A3D8L290,A0A1Q4R485,K9U8J6,A0A097QRL6,K9RC91,A0A0D8ZUC0,A0A139XGN8,A0A1T4Y3A2,Q5P0R2,B6YTQ5,A0YYT3,A0A2T1EFY0,G6FTN0,A0A433NB65,A0A1Z4L0A1,K9UQR0,A0A2T1G8M7,K9VUN0,K9ZDE3,B0JXD6,A0A2T1LS63,A0A1Z4K1Y3,A0A2Z6E0R7,A0A0P4UVI8,A0A0V7ZCG4,A0A1J0AGK2,K9PFF9,A0A2G9DT08,K9UEV4,Q9L1X1,A0A496APJ8,A0A1V9G9U4,S7VLM7,A0A1A5X8H4,A0A1I2T6Q1,A0A1R3T9N6,H8KXJ0,A0A2D1U4H7,A0A0B7I4Z6,A0LL61,Q8DKB1,A0A139WY18,A0A2T1E1K4,A0A1Q8ZD62,A0A4Q6XKV6,A0A1Z3HNN4,A0A239JE83,A0A2N4XBY2,R5JEI2,A0A0Q0ZC47,A0A2T0XH18,A0A1V4CHV0,A0A1K1RQP7,A0A1N6LUI7,A0A0P0NGR6,A0A1X7IML5,A0A0A2LKJ7,K1L112,A0A0U3AL92,A0A1H3A054,E0UCX3,K9XZC6,B9LVW4,A0A0C1VHB4,Q31N05,A0A0C5JKF3,A5D4D9,Q2JI93,A0A142Y7A9,A0A432MEQ5,A0A372DKU2,A0A3R7KLK4,C1F5Q7,A0A4R3EV39,A0A1P8WP90,A0A222F7P0,A0A1C9VH88,A0A2T2YMB1,A0A329TD61,A0A101R2A0,A0A1U9ND56,A0A4R7BQC4,A0A1H3DGN3,A0A1Q1FPH0,E0TGY3,A0A259TUP4,F6EYI8,A0A2S9Q9J0,A0A4Q2UIU6,A0A1H0LH25,A0A318LG42,L0JS08,A0A345E7N0,M0AF24,A0A1H3X247,M0D2X3,A0A2R5G167,A0A346PK63,R7RTW6,B9LVP8,M5RSF0,W0JW77,B7K585,F8D8G0,A0A343TL88,A0A3P3RGE5,A0A329TBQ3,A0A285N2A8,A0A0W1S8B8,A0A1V4C8L7,L9VRQ2,E4NRV1,A0A1I6HGN0,A0A1I0NI68,,",366,37
"260","C.H9.10","C.L1.2",186,123,63,1.52419667053813,"4F1N,4KRE,6OON,7KX7,A0A163JTZ6,J9D5G4,Q389P5,D2VMG4,A0A074TLL7,A0A0D1ZAJ4,Q1K660,F4PH46,A0A3M7S814,A0A164ZA52,S7WCF7,I0YVB2,R7QGN7,A0A2C5Z0M1,D3BMP8,A0A1Z5TVE5,A0A4S2MWZ7,K1VVQ6,G7DVX0,V6R0U9,G4N9J3,E3KLI3,A0A1E3QC61,D5GGK8,S8ANP9,A0A139AUH8,L2GMR6,U4LBG4,A0A177URI1,O74957,A0A3N4IGK1,A0A0E9NDK5,A0A250WXN5,A0A2G8JLH3,L2GUF2,W2T741,A0A1W0E4B5,A0A2J7QB22,A0A2K3CW87,A0A226EFL3,A0A0L0TEV1,C4V9J2,A0A075AN09,U5HIG6,G2QEV0,A0A397UU01,A0A2T7PFL8,A0A024FT57,H3HCL6,A0A0G4IME3,D7FQK3,A0A1Y1YHC8,T1GSU4,F4S231,A0A1D8PMK0,A0A2G5B1D8,Q5BD61,A0A1C7M8P2,A0A158PJG6,J9JZ66,A0A158QZT6,T0SAU8,R7YY92,A0A3S1A0C3,A0A074YJ47,A0A1Q3ENA6,F4NYW7,A0A0L0HAB7,A0A1D1W4K0,A7RQ46,W4YU94,A7BJS5,D8SNM6,X1WG39,M5FQK2,A0A0D8XL16,A0A016WPN3,Q9QZ81,G5EES3,A0A0K0EFP6,Q8CJG0,A0A1D5NTU6,A0A0V0YLH8,A0A139WDH0,H3DS31,A0A1Y1HWP2,G4T5G9,B7QCC4,A0A0B2UV00,M7BCJ9,E9GN30,Q7PZ41,A0A077Z361,R7U9I3,A0A1X7V1N5,A0A0K0JDP1,A0A0N4UKJ1,A0A498N3A3,A0A3M0IQP5,A0A0L8GBV4,Q32KD4,A0A1J1JBJ0,E0W4C3,A0A482XDA9,A0A3P7EJD6,J9K2Z4,A0A2J7Q8V4,T1IBM6,A0A210QKF7,A0A423TSS1,K1PT78,A0A267E8R7,A0A1D2N447,A0A226D7A9,F6YK55,T1KTE4,A0A2C9JGZ6,A0A1V9X9F0,T1FY40,5I4A,A0A1T4Y3A2,A0A1N6SSK9,A0A2G9DT08,Q9L1X1,S7VLM7,A0A1A5X8H4,A0A1R3T9N6,H8KXJ0,A0A2D1U4H7,A0A0B7I4Z6,A0LL61,Q8DKB1,A0A2N4XBY2,Q53W94,R5JEI2,A0A0Q0ZC47,A0A1V4CHV0,A0A1K1RQP7,A0A2T1EKT1,A0A1N6LUI7,A0A0P0NGR6,A0A1X7IML5,A0A0A2LKJ7,K1L112,A0A0U3AL92,A0A1H3A054,E0UCX3,K9XZC6,Q31N05,A0A0C5JKF3,A5D4D9,Q2JI93,A0A372DKU2,A0A3R7KLK4,C1F5Q7,A0A1P8WP90,A0A222F7P0,A0A1C9VH88,A0A2T2YMB1,A0A101R2A0,A0A1E3XF49,A0A1U9ND56,A0A4R7BQC4,A0A1H3DGN3,A0A1Q1FPH0,E0TGY3,A0A259TUP4,F6EYI8,A0A2S9Q9J0,A0A1H0LH25,A0A318LG42,H1YCU5,A0A1Q5ZS75,A0A345E7N0,A0A1W2A082,A0A1H3X247,A0A0C1XUA0,A0A1H2RBI2,A0A1C3ZXN2,F8D8G0,A0A1V4C8L7,A0A1I0NI68,,",366,37
"261","C.H9.5","C.S16.5",224,123,101,1.20578765193593,"4F3T,4KRE,5VM9,6OON,A0A163JTZ6,J9D5G4,A8BCK6,R1FDF0,A0A3M7S814,A0A164ZA52,A0A383WDW5,Q54G64,I0YVB2,R7QGN7,R9ACY5,D3BMP8,A0A1U7LLR0,A0A4S2MWZ7,G4N9J3,A0A1E3QC61,D5GGK8,S8ANP9,L2GMR6,U4LBG4,A0A177URI1,O74957,A0A3N4IGK1,A0A0E9NDK5,T1KZ60,A0A250WXN5,A0A2G8JLH3,Q5KAT1,W2T741,A0A1W0E4B5,A0A2J7QB22,A0A388KES6,A0A3S3PD82,A0A0L0TEV1,G2QEV0,A0A397UU01,A0A2T7PFL8,K7ISV0,A0A024FT57,H3HCL6,A0A0G4IME3,D7FQK3,A0A1Y1YHC8,T1GSU4,F4S231,Q5BD61,A0A1C7M8P2,A0A4D8YSQ3,A0A158PJG6,A0A158QZT6,A0A165QYQ9,T0SAU8,A0A3S1A0C3,A0A074YJ47,A0A2K1J482,A0A1Q3ENA6,O04379,A0A371I3C8,M8AEW7,A0A2K3NY65,F4NYW7,A0A409Y6G2,A0A0L0HAB7,D8PZT7,A0A1D1W4K0,A7RQ46,W4YU94,A7BJS5,D8SNM6,A0A1J8PPA3,X1WG39,M5FQK2,A0A2R6NSC2,A0A0D8XL16,A0A016WPN3,Q9QZ81,G5EES3,A0A0K0EFP6,Q8CJG0,A0A1D5NTU6,V2WTL2,A0A0V0YLH8,A0A139WDH0,A0A0R3W9Q7,H3DS31,A0A1Y1HWP2,B7QCC4,A0A0B2UV00,M7BCJ9,E9GN30,Q7PZ41,A0A077Z361,R7U9I3,A0A1X7V1N5,A0A0K0JDP1,A0A0N4UKJ1,A0A498N3A3,A0A3M0IQP5,A0A0L8GBV4,Q32KD4,A0A1J1JBJ0,E0W4C3,A0A482XDA9,J9K2Z4,A0A2J7Q8V4,T1IBM6,V3ZRX0,A0A210QKF7,A0A423TSS1,K1PT78,A0A267E8R7,A0A1D2N447,A0A226D7A9,F6YK55,T1KTE4,A0A2C9JGZ6,A0A1V9X9F0,K5X5Z7,T1FY40,3DLB,5AWH,5I4A,6QZK,A0A1I7IXT4,A0A2W1JZ37,A0A2S7WBN3,A0A420DFE6,E0ST67,A0A4V1VDY2,A0A1M5ZSR3,A0A1L3JHM3,A0A1W6MIP2,A0A2U2J9E0,K9U8J6,K9RC91,A0A0D8ZUC0,A0A139XGN8,A0A1T4Y3A2,A0A2T1EFY0,G6FTN0,A0A433NB65,A0A1Z4L0A1,K9UQR0,K9VUN0,K9ZDE3,B0JXD6,A0A2T1LS63,A0A1Z4K1Y3,A0A0P4UVI8,A0A0V7ZCG4,A0A1J0AGK2,K9PFF9,A0A2G9DT08,K9UEV4,Q9L1X1,A0A060HNJ0,A0A1H3LE92,A0A496APJ8,A0A1A5X8H4,A0A1I2T6Q1,H8KXJ0,A0A2D1U4H7,A0A0B7I4Z6,Q8DKB1,A0A139WY18,A0A1J1EK56,A0A2T1E1K4,A0A1Z3HNN4,A0A2N4XBY2,Q53W94,R5JEI2,A0A1V4CHV0,A0A2T1EKT1,A0A1N6LUI7,A0A0U3AL92,A0A1H3A054,A0A0C1VHB4,Q31N05,A0A0C5JKF3,R5NJJ8,A5D4D9,Q2JI93,A0A142Y7A9,A0A432MEQ5,A0A372DKU2,A0A3R7KLK4,A0A1P8WP90,A0A222F7P0,A0A1C9VH88,A0A101R2A0,A0A1U9ND56,A0A4R7BQC4,A0A1H3DGN3,E0TGY3,A0A259TUP4,F6EYI8,A0A2S9Q9J0,A0A4Q2UIU6,A0A1H0LH25,A0A318LG42,A0A1H3X247,A0A346PK63,R7RTW6,B9LVP8,M5RSF0,W0JW77,F8D8G0,A0A343TL88,L0AJX6,A0A2A5QS34,A0A343JEE2,A0A3P3RGE5,A0A329TBQ3,A0A285N2A8,A0A0W1S8B8,A0A1V4C8L7,L9VRQ2,E4NRV1,A0A1I6HGN0,A0A1I0NI68,,",366,37
"263","C.S8.4","C.S9.7",210,123,87,1.59153350154191,"4F3T,4KRE,6OON,7KX7,A0A163JTZ6,A0A196SDB4,J9D5G4,A8BCK6,A2DPV7,T1H8B3,R1FDF0,S4RWI0,D2VMG4,F4PH46,Q54G64,S7WCF7,I0YVB2,R7QGN7,A0A2C5Z0M1,R9ACY5,D3BMP8,A0A1Z5TVE5,W7XD45,A0A1U7LLR0,A0A4S2MWZ7,A0A158P1R9,E3KLI3,A0A1E3QC61,S8ANP9,A0A139AUH8,U4LBG4,A0A177URI1,O74957,A0A0E9NDK5,T1KZ60,A0A250WXN5,Q5KAT1,L2GUF2,W2T741,A0A2J7QB22,A0A226EFL3,A0A3S3PD82,G0QTT2,Q9JMB7,A0A401PRI6,A0A2T7PFL8,K7ISV0,A0A024FT57,H3HCL6,A0A0G4IME3,E9FUN9,A0A1S3CYL5,D7FQK3,A0A1Y1YHC8,T1GSU4,F4S231,A0A1D8PMK0,A0A2G5B1D8,A0A4D8YSQ3,A0A158PJG6,J9JZ66,A0A0C2XG51,A0A158QZT6,A0A165QYQ9,A0A3S1A0C3,A0A2K1J482,O04379,A0A371I3C8,M8AEW7,A0A2K3NY65,F4NYW7,A0A0L0HAB7,A0A1D1W4K0,A7RQ46,W4YU94,A7BJS5,D8SNM6,X1WG39,M5FQK2,Q69VD5,A0A0D8XL16,A0A016WPN3,Q9QZ81,G5EES3,A0A0K0EFP6,Q8CJG0,A0A1D5NTU6,A0A139WDH0,A0A0R3W9Q7,H3DS31,A0A1Y1HWP2,G4T5G9,B7QCC4,A0A0B2UV00,M7BCJ9,E9GN30,Q7PZ41,R7U9I3,A0A0K0JDP1,A0A0N4UKJ1,A0A498N3A3,A0A3M0IQP5,Q32KD4,A0A1J1JBJ0,E0W4C3,A0A482XDA9,A0A3P7EJD6,J9K2Z4,A0A2J7Q8V4,T1IBM6,V3ZRX0,A0A210QKF7,A0A423TSS1,K1PT78,A0A267E8R7,A0A1D2N447,A0A226D7A9,F6YK55,T1KTE4,A0A2C9JGZ6,A0A1V9X9F0,A0A3Q0KUG5,T1FY40,5G5T,5I4A,6QZK,E0ST67,C4L1M1,A0A1M5ZSR3,A0A0K8QX04,A0A0M2PXX3,A0A1I3LMA1,K9TPA9,A0A1C0UUC4,L8D0R3,H1KXR6,K9U8J6,K9RC91,A0A0D8ZUC0,A0A139XGN8,Q5P0R2,A0A0B0H9B4,A0YYT3,A0A2T1EFY0,G6FTN0,R6KUL9,A0A433NB65,A0A1Z4L0A1,K9UQR0,A0A2T1G8M7,K9VUN0,B7GJX9,A0A0P6X5X2,K9ZDE3,A0A1Z4K1Y3,A0A2Z6E0R7,A0A1N6SSK9,A0A0P4UVI8,A0A0V7ZCG4,A0A1J0AGK2,K9PFF9,K9UEV4,A0A060HNJ0,A0A235B542,R5XQK4,H0HWQ5,A0A1I2ZGP1,A0A317EJY3,A0A1I2BD20,F8ERC7,S7VLM7,A0A1I2T6Q1,H8KXJ0,A0A2D1U4H7,I3TE64,A0A0B7I4Z6,A0A4Q6XKV6,A0A239JE83,A0A2N4XBY2,R5JEI2,A0A0Q0ZC47,A0A2T0XH18,A0A1K1RQP7,A0A2T1EKT1,A0A0P0NGR6,A0A1X7IML5,A0A0A2LKJ7,K1L112,R5NJJ8,A5D4D9,A0A432MEQ5,A0A2T2YMB1,A0A329TD61,A0A1E3XF49,A0A1H3DGN3,A0A1Q1FPH0,A0A259TUP4,A0A4Q2UIU6,H1YCU5,A0A1Q5ZS75,A0A1W2A082,A0A0C1XUA0,A0A2R5G167,R7RTW6,A0A1H2RBI2,A0A1C3ZXN2,M5RSF0,B7K585,A0A343JEE2,A0A285N2A8,,",366,37
"264","C.H3.7","C.S6.4",215,124,91,2.20861396667848,"A0A163JTZ6,A0A196SDB4,J9D5G4,C4LVV2,A0A2P6N8X7,A8BCK6,A2DPV7,D2VMG4,A0A074TLL7,A0A0D1ZAJ4,Q1K660,A0A3M7S814,S7WCF7,I0YVB2,C1DZY0,A0A4S2MWZ7,V6R0U9,G4N9J3,B7Q5I1,A0A1E3QC61,D5GGK8,S8ANP9,A0A139AUH8,L2GMR6,U4LBG4,A0A3N4IGK1,A6N7Y9,A0A0E9NDK5,L2GUF2,W2T741,A0A1W0E4B5,A0A2K3CW87,A0A388KES6,A0A226EFL3,A0A0L0TEV1,A0A1S3J512,C4V9J2,Q9JMB7,A0A075AN09,U5HIG6,Q96J94,G2QEV0,A0A397UU01,A0A2T7PFL8,A0A0G4IME3,D7FQK3,A0A1Y1YHC8,A0A1D8PMK0,A0A2G5B1D8,Q5BD61,A0A1C7M8P2,A0A4D8YSQ3,A0A158PJG6,A0A158QZT6,A0A165QYQ9,T0SAU8,A0A3S1A0C3,A0A074YJ47,A0A2K1J482,A0A1Q3ENA6,O04379,A0A371I3C8,M8AEW7,A8P0D4,A0A2K3NY65,F4NYW7,A0A409Y6G2,D8PZT7,A0A1D1W4K0,A7RQ46,W4YU94,A7BJS5,D8SNM6,X1WG39,M5FQK2,Q69VD5,A0A2R6NSC2,A0A0D8XL16,A0A016WPN3,Q9QZ81,G5EES3,A0A0K0EFP6,Q8CJG0,A0A1D5NTU6,V2WTL2,A0A0V0YLH8,A0A139WDH0,A0A0R3W9Q7,H3DS31,A0A1Y1HWP2,B7QCC4,A0A0B2UV00,M7BCJ9,E9GN30,Q7PZ41,A0A077Z361,R7U9I3,A0A1X7V1N5,A0A0K0JDP1,A0A0N4UKJ1,A0A498N3A3,A0A3M0IQP5,A0A0L8GBV4,Q32KD4,A0A1J1JBJ0,E0W4C3,A0A3P7EJD6,J9K2Z4,A0A2J7Q8V4,T1IBM6,V3ZRX0,A0A210QKF7,A0A423TSS1,K1PT78,A0A267E8R7,A0A1D2N447,A0A226D7A9,F6YK55,T1KTE4,A0A2C9JGZ6,A0A1V9X9F0,K5X5Z7,A0A3Q0KUG5,T1FY40,1YVU,5AWH,6QZK,E0ST67,C4L1M1,A0A0M2PXX3,A0A1I3LMA1,A0A1W6MIP2,A0A1C0UUC4,A0A2Z6E1D5,A0A0F4NXW8,L8D0R3,B1XJG0,H1KXR6,Q5P0R2,A0A0B0H9B4,K9UQR0,B7GJX9,A0A0P6X5X2,B0JXD6,A0A2T1LS63,A0A2Z6E0R7,A0A1N6SSK9,A0A1J0AGK2,K9UEV4,A0A060HNJ0,R5XQK4,A0A1H3LE92,A0A496APJ8,A0A1V9G9U4,A0A1A5X8H4,H8KXJ0,D3S0S6,A0A2D1U4H7,I3TE64,A0A0B7I4Z6,A0LL61,Q8DKB1,A0A139WY18,A0A2T1E1K4,A0A4Q6XKV6,A0A1Z3HNN4,A0A239JE83,A0A2N4XBY2,Q53W94,R5JEI2,A0A0Q0ZC47,A0A2T0XH18,A0A1V4CHV0,A0A1K1RQP7,A0A2T1EKT1,A0A0P0NGR6,A0A1X7IML5,A0A0A2LKJ7,K1L112,A0A0U3AL92,A0A1H3A054,E0UCX3,K9XZC6,A0A0C1VHB4,Q31N05,A0A0C5JKF3,R5NJJ8,A5D4D9,Q2JI93,A0A372DKU2,C1F5Q7,A0A1C9VH88,A0A1E3XF49,H1YCU5,L0JS08,A0A1Q5ZS75,M0AF24,A0A1W2A082,M0D2X3,A0A346PK63,R7RTW6,A0A1H2RBI2,A0A1C3ZXN2,W0JW77,A0A343TL88,L0AJX6,A0A2A5QS34,A0A343JEE2,A0A3P3RGE5,A0A329TBQ3,A0A285N2A8,A0A0W1S8B8,L9VRQ2,E4NRV1,A0A1I6HGN0,,",366,37
"267","N.H7.8","N.S11.3",186,124,62,1.64112903225806,"4F1N,5GUH,5VM9,7KX7,7SWF,R1FDF0,S4RWI0,D2VMG4,A0A0D1ZAJ4,Q1K660,F4PH46,A0A164ZA52,A0A383WDW5,Q54G64,S7WCF7,I0YVB2,A0A2C5Z0M1,R9ACY5,D3BMP8,A0A1Z5TVE5,A0A4S2MWZ7,A0A158P1R9,G7DVX0,V6R0U9,G4N9J3,E3KLI3,B7Q5I1,A0A1E3QC61,S8ANP9,A0A139AUH8,L2GMR6,U4LBG4,A0A177URI1,O74957,A0A3N4IGK1,A6N7Y9,A0A0E9NDK5,T1KZ60,A0A2G8JLH3,Q5KAT1,L2GUF2,A0A1W0E4B5,A0A2J7QB22,A0A2K3CW87,A0A388KES6,A0A226EFL3,A0A1S3J512,C4V9J2,Q9JMB7,A0A075AN09,A0A401PRI6,Q96J94,G2QEV0,A0A397UU01,A0A2T7PFL8,K7ISV0,H3HCL6,A0A0G4IME3,D7FQK3,A0A1Y1YHC8,A0A2G5B1D8,Q5BD61,A0A1C7M8P2,A0A4D8YSQ3,A0A0C2XG51,A0A165QYQ9,R7YY92,A0A3S1A0C3,A0A074YJ47,A0A2K1J482,A0A1Q3ENA6,O04379,A0A371I3C8,M8AEW7,A8P0D4,A0A2K3NY65,F4NYW7,A0A409Y6G2,A0A0L0HAB7,D8PZT7,A0A1D1W4K0,A7RQ46,D8SNM6,A0A1J8PPA3,X1WG39,M5FQK2,Q69VD5,A0A2R6NSC2,Q9QZ81,G5EES3,A0A139WDH0,A0A0R3W9Q7,A0A1Y1HWP2,G4T5G9,B7QCC4,A0A0B2UV00,M7BCJ9,E9GN30,Q7PZ41,R7U9I3,A0A1X7V1N5,A0A0N4UKJ1,A0A498N3A3,A0A3M0IQP5,A0A0L8GBV4,Q32KD4,A0A1J1JBJ0,A0A3P7EJD6,J9K2Z4,A0A2J7Q8V4,T1IBM6,V3ZRX0,A0A210QKF7,A0A423TSS1,K1PT78,A0A267E8R7,A0A1D2N447,A0A226D7A9,F6YK55,T1KTE4,A0A1V9X9F0,K5X5Z7,A0A3Q0KUG5,T1FY40,1Z26,5G5T,6QZK,A0A1T4Y3A2,A0A2G9DT08,Q9L1X1,R5XQK4,A0A1H3LE92,A0A496APJ8,S7VLM7,A0A1A5X8H4,A0A0Q2M2Z1,H8KXJ0,A0A2D1U4H7,A0A0B7I4Z6,A0A2T1E1K4,A0A4Q6XKV6,A0A1Z3HNN4,A0A239JE83,A0A2N4XBY2,R5JEI2,A0A0Q0ZC47,A0A2T0XH18,A0A1K1RQP7,A0A1N6LUI7,A0A0P0NGR6,A0A1X7IML5,A0A0A2LKJ7,K1L112,A0A0U3AL92,A0A1H3A054,B9LVW4,A0A0C5JKF3,A5D4D9,A0A432MEQ5,C1F5Q7,A0A4R3EV39,A0A1P8WP90,A0A2T2YMB1,A0A1E3XF49,A0A1U9ND56,A0A4R7BQC4,A0A259TUP4,F6EYI8,A0A2S9Q9J0,A0A1H0LH25,A0A318LG42,M0AF24,M0D2X3,A0A346PK63,R7RTW6,A0A1C3ZXN2,M5RSF0,B7K585,A0A343TL88,A0A3P3RGE5,A0A329TBQ3,A0A0W1S8B8,A0A1V4C8L7,L9VRQ2,E4NRV1,A0A1I6HGN0,,",366,37
"270","C.S5.6","C.S6.4",206,125,81,1.69002469135802,"5GUH,5VM9,6KR6,6OON,7SWF,A0A163JTZ6,A0A0N4X8S8,A2DPV7,T1H8B3,S4RWI0,A0A074TLL7,A0A0D1ZAJ4,Q1K660,A0A3M7S814,A0A164ZA52,A0A383WDW5,Q54G64,R7QGN7,C1DZY0,A0A2C5Z0M1,A0CB11,R9ACY5,A0A1U7LLR0,K1VVQ6,G7DVX0,V6R0U9,E3KLI3,B7Q5I1,A0A139AUH8,A0A0E9NDK5,T1KZ60,A0A2G8JLH3,L2GUF2,W2T741,A0A1W0E4B5,A0A2J7QB22,A0A2K3CW87,A0A388KES6,A0A3S3PD82,C4V9J2,A0A075AN09,Q5TW24,U5HIG6,A0A2B4RHN2,G2QEV0,A0A2T7PFL8,A0A024FT57,H3HCL6,A0A1S3CYL5,A0A1Y1YHC8,F4S231,A0A1D8PMK0,A0A1C7M8P2,A0A4D8YSQ3,J9JZ66,A0A0C2XG51,A0A158QZT6,A0A165QYQ9,A0A3S1A0C3,A0A2K1J482,A0A1Q3ENA6,O04379,A0A371I3C8,M8AEW7,A8P0D4,A0A2K3NY65,F4NYW7,A0A409Y6G2,A0A0L0HAB7,D8PZT7,A0A1D1W4K0,W4YU94,A7BJS5,D8SNM6,A0A1J8PPA3,X1WG39,M5FQK2,Q69VD5,A0A2R6NSC2,A0A016WPN3,Q9QZ81,G5EES3,Q8CJG0,A0A1D5NTU6,V2WTL2,A0A0V0YLH8,A0A139WDH0,A0A0R3W9Q7,H3DS31,A0A1Y1HWP2,G4T5G9,B7QCC4,A0A0B2UV00,M7BCJ9,E9GN30,Q7PZ41,A0A077Z361,R7U9I3,A0A1X7V1N5,A0A0K0JDP1,A0A0N4UKJ1,A0A498N3A3,A0A3M0IQP5,A0A0L8GBV4,Q32KD4,A0A1J1JBJ0,E0W4C3,A0A482XDA9,A0A3P7EJD6,J9K2Z4,A0A2J7Q8V4,T1IBM6,V3ZRX0,A0A210QKF7,A0A423TSS1,K1PT78,A0A267E8R7,A0A1D2N447,A0A226D7A9,F6YK55,T1KTE4,A0A2C9JGZ6,A0A1V9X9F0,A0A3Q0KUG5,T1FY40,1YVU,5AWH,5I4A,6QZK,7R8K,E8N0K8,A0A328VKE4,K9TPA9,A0A142XB92,L8D0R3,A0A326U7G5,A0A3D8L290,A0A1Q4R485,K9U8J6,K9RC91,A0A0D8ZUC0,A0A139XGN8,A0A1T4Y3A2,A0YYT3,A0A2T1EFY0,G6FTN0,A0A433NB65,K9UQR0,A0A2T1G8M7,K9VUN0,A0A0P6X5X2,A0A2T1LS63,A0A0P4UVI8,A0A0V7ZCG4,A0A1J0AGK2,A0A2G9DT08,K9UEV4,Q9L1X1,A0A496APJ8,A0A062U2W9,H0HWQ5,A0A1I2ZGP1,A0A317EJY3,A0A1I2BD20,F8ERC7,S7VLM7,A0A1I2T6Q1,A0A0Q2M2Z1,Q8DKB1,A0A139WY18,A0A1J1EK56,A0A4Q6XKV6,A0A1Z3HNN4,A0A239JE83,A0A2N4XBY2,Q53W94,R5JEI2,A0A0Q0ZC47,A0A2T0XH18,A0A1V4CHV0,A0A1K1RQP7,A0A0P0NGR6,A0A1X7IML5,A0A0A2LKJ7,K1L112,Q31N05,Q2JI93,A0A432MEQ5,C1F5Q7,A0A4R3EV39,A0A2T2YMB1,A0A101R2A0,A0A1U9ND56,A0A4R7BQC4,A0A1Q1FPH0,E0TGY3,A0A1H0LH25,A0A318LG42,A0A1H3X247,M5RSF0,B7K585,F8D8G0,L0AJX6,A0A285N2A8,A0A1V4C8L7,A0A1I0NI68,,",366,37
"274","C.L9.4","C.S5.2",219,126,93,1.28635432667691,"4KRE,6KR6,6OON,7KX7,7SWF,A0A163JTZ6,A0A0N4X8S8,A0A196SDB4,J9D5G4,C4LVV2,A0A2P6N8X7,A8BCK6,T1H8B3,S4RWI0,A0A074TLL7,A0A0D1ZAJ4,Q1K660,A0A164ZA52,S7WCF7,I0YVB2,A0A2C5Z0M1,A0CB11,R9ACY5,D3BMP8,A0A1Z5TVE5,A0A4S2MWZ7,K1VVQ6,G7DVX0,G4N9J3,E3KLI3,B7Q5I1,A0A1E3QC61,L2GMR6,A0A177URI1,O74957,A0A3N4IGK1,A0A0E9NDK5,T1KZ60,Q5KAT1,W2T741,A0A1W0E4B5,A0A2J7QB22,A0A0L0TEV1,A0A1S3J512,G0QTT2,C4V9J2,Q5TW24,U5HIG6,A0A2B4RHN2,G2QEV0,A0A397UU01,A0A2T7PFL8,K7ISV0,A0A1Y1YHC8,F4S231,A0A1D8PMK0,Q5BD61,A0A1C7M8P2,A0A4D8YSQ3,A0A158QZT6,A0A165QYQ9,R7YY92,A0A3S1A0C3,A0A2K1J482,A0A1Q3ENA6,O04379,A0A371I3C8,A8P0D4,F4NYW7,A0A409Y6G2,D8PZT7,A0A1D1W4K0,A7RQ46,W4YU94,A7BJS5,A0A1J8PPA3,X1WG39,Q69VD5,A0A2R6NSC2,A0A0D8XL16,A0A016WPN3,Q9QZ81,G5EES3,A0A0K0EFP6,Q8CJG0,A0A1D5NTU6,V2WTL2,A0A0V0YLH8,A0A139WDH0,A0A0R3W9Q7,H3DS31,G4T5G9,B7QCC4,A0A0B2UV00,M7BCJ9,E9GN30,Q7PZ41,A0A077Z361,R7U9I3,A0A1X7V1N5,A0A0K0JDP1,A0A0N4UKJ1,A0A498N3A3,A0A3M0IQP5,A0A0L8GBV4,Q32KD4,A0A1J1JBJ0,E0W4C3,A0A482XDA9,A0A3P7EJD6,J9K2Z4,A0A2J7Q8V4,T1IBM6,V3ZRX0,A0A210QKF7,A0A423TSS1,K1PT78,A0A267E8R7,A0A1D2N447,A0A226D7A9,F6YK55,T1KTE4,A0A2C9JGZ6,A0A1V9X9F0,A0A3Q0KUG5,T1FY40,1YVU,1Z26,5G5T,6QZK,A0A328VKE4,E0ST67,C4L1M1,Q11QW7,A0A1C0UUC4,A0A0F4NXW8,L8D0R3,B1XJG0,A0A326U7G5,A0A3D8L290,K9U8J6,K9RC91,A0A0D8ZUC0,A0A139XGN8,A0A1T4Y3A2,Q5P0R2,A0A0B0H9B4,A0YYT3,A0A2T1EFY0,R6KUL9,A0A1Z4L0A1,K9UQR0,A0A2T1G8M7,K9VUN0,B7GJX9,A0A2Z6E0R7,A0A1N6SSK9,A0A0V7ZCG4,A0A1J0AGK2,K9PFF9,K9UEV4,R5XQK4,A0A1H3LE92,A0A496APJ8,A0A062U2W9,A0A1V9G9U4,A0A1I2ZGP1,A0A317EJY3,A0A1I2BD20,F8ERC7,A0A1A5X8H4,A0A1I2T6Q1,A0A0Q2M2Z1,D3S0S6,I3TE64,Q8DKB1,A0A139WY18,A0A2T1E1K4,A0A1Q8ZD62,A0A1Z3HNN4,R5JEI2,A0A1V4CHV0,A0A2T1EKT1,E0UCX3,K9XZC6,B9LVW4,A0A0C1VHB4,Q31N05,R5NJJ8,A5D4D9,Q2JI93,A0A142Y7A9,A0A432MEQ5,A0A4R3EV39,A0A2T2YMB1,E0TGY3,A0A259TUP4,F6EYI8,A0A2S9Q9J0,A0A4Q2UIU6,A0A1H0LH25,L0JS08,M0AF24,A0A1W2A082,A0A1H3X247,A0A0C1XUA0,M0D2X3,A0A346PK63,R7RTW6,A0A1H2RBI2,B9LVP8,W0JW77,F8D8G0,L0AJX6,A0A2A5QS34,A0A343JEE2,A0A285N2A8,A0A1V4C8L7,A0A1I0NI68,,",366,37
"275","N.H3.20","N.S9.2",203,126,77,1.81998556998557,"4KRE,5VM9,6OON,Q389P5,A2DPV7,A0A0G4H2S4,S4RWI0,D2VMG4,Q1K660,F4PH46,A0A3M7S814,Q54G64,S7WCF7,I0YVB2,R7QGN7,C1DZY0,A0A2C5Z0M1,A0CB11,W7XD45,A0A1U7LLR0,A0A4S2MWZ7,V6R0U9,G4N9J3,B7Q5I1,A0A1E3QC61,D5GGK8,S8ANP9,A0A139AUH8,U4LBG4,O74957,A0A3N4IGK1,A0A0E9NDK5,T1KZ60,A0A2G8JLH3,W2T741,A0A2J7QB22,S4RYE2,A0A2K3CW87,A0A388KES6,A0A226EFL3,A0A3S3PD82,A0A0L0TEV1,A0A1S3J512,G0QTT2,A0A1J1HRI1,Q5TW24,U5HIG6,A0A2T7PFL8,K7ISV0,A0A024FT57,H3HCL6,A0A0G4IME3,E9FUN9,A0A1S3CYL5,D7FQK3,T1GSU4,A0A2G5B1D8,Q5BD61,A0A4D8YSQ3,A0A158PJG6,A0A0C2XG51,A0A158QZT6,T0SAU8,R7YY92,A0A3S1A0C3,A0A2K1J482,O04379,A0A371I3C8,M8AEW7,A0A2K3NY65,F4NYW7,A0A0L0HAB7,A0A1D1W4K0,A7RQ46,W4YU94,A7BJS5,D8SNM6,X1WG39,M5FQK2,Q69VD5,A0A0D8XL16,A0A016WPN3,Q9QZ81,G5EES3,A0A0K0EFP6,Q8CJG0,A0A1D5NTU6,A0A0V0YLH8,A0A139WDH0,A0A0R3W9Q7,H3DS31,A0A1Y1HWP2,G4T5G9,B7QCC4,A0A0B2UV00,M7BCJ9,E9GN30,Q7PZ41,A0A077Z361,R7U9I3,A0A1X7V1N5,A0A0K0JDP1,A0A0N4UKJ1,A0A498N3A3,A0A3M0IQP5,A0A0L8GBV4,Q32KD4,A0A1J1JBJ0,E0W4C3,A0A482XDA9,A0A3P7EJD6,J9K2Z4,A0A2J7Q8V4,T1IBM6,V3ZRX0,A0A210QKF7,A0A423TSS1,K1PT78,A0A267E8R7,A0A1D2N447,A0A226D7A9,F6YK55,T1KTE4,A0A2C9JGZ6,A0A1V9X9F0,A0A3Q0KUG5,3DLB,5AWH,Q11QW7,A0A0P6X5X2,A0A2G9DT08,Q9L1X1,A0A496APJ8,A0A062U2W9,H0HWQ5,A0A1V9G9U4,A0A1I2ZGP1,A0A317EJY3,A0A1I2BD20,F8ERC7,S7VLM7,A0A1A5X8H4,A0A1I2T6Q1,A0A1R3T9N6,H8KXJ0,A0A2D1U4H7,A0A139WY18,A0A1J1EK56,A0A2T1E1K4,A0A1Q8ZD62,A0A4Q6XKV6,A0A1Z3HNN4,A0A239JE83,A0A2N4XBY2,Q53W94,R5JEI2,A0A2T0XH18,A0A1V4CHV0,A0A1K1RQP7,A0A0P0NGR6,A0A1X7IML5,A0A0A2LKJ7,K1L112,A0A0U3AL92,A0A1H3A054,B9LVW4,A0A0C5JKF3,A5D4D9,A0A432MEQ5,A0A372DKU2,A0A1C9VH88,A0A101R2A0,A0A1U9ND56,A0A4R7BQC4,A0A1Q1FPH0,E0TGY3,A0A1H0LH25,A0A318LG42,L0JS08,A0A345E7N0,M0AF24,A0A1H3X247,M0D2X3,A0A2R5G167,A0A346PK63,B9LVP8,M5RSF0,W0JW77,B7K585,F8D8G0,A0A343TL88,L0AJX6,A0A2A5QS34,A0A343JEE2,A0A3P3RGE5,A0A329TBQ3,A0A285N2A8,A0A0W1S8B8,A0A1V4C8L7,L9VRQ2,E4NRV1,A0A1I6HGN0,A0A1I0NI68,,",366,37
"279","C.H3.3","C.S6.4",278,127,151,2.62061323460395,"4F1N,4F3T,4KRE,5GUH,5VM9,6KR6,6OON,7KX7,A0A163JTZ6,A0A0N4X8S8,A0A196SDB4,Q389P5,C4LVV2,A8BCK6,A2DPV7,S4RWI0,A0A074TLL7,A0A3M7S814,A0A383WDW5,C1DZY0,R9ACY5,D3BMP8,A0A1Z5TVE5,W7XD45,A0A1U7LLR0,A0A4S2MWZ7,K1VVQ6,G7DVX0,G4N9J3,E3KLI3,A0A1E3QC61,D5GGK8,S8ANP9,L2GMR6,U4LBG4,A0A177URI1,O74957,A0A3N4IGK1,A6N7Y9,Q5KAT1,W2T741,A0A1W0E4B5,A0A226EFL3,A0A1S3J512,G0QTT2,C4V9J2,Q9JMB7,A0A075AN09,U5HIG6,A0A401PRI6,Q96J94,G2QEV0,A0A397UU01,A0A2T7PFL8,A0A1Y1YHC8,F4S231,A0A1D8PMK0,Q5BD61,A0A1C7M8P2,A0A158PJG6,A0A0C2XG51,A0A158QZT6,A0A165QYQ9,A0A3S1A0C3,A0A074YJ47,A0A2K1J482,A0A1Q3ENA6,A0A371I3C8,F4NYW7,A0A409Y6G2,A0A0L0HAB7,A0A1D1W4K0,A7RQ46,W4YU94,A7BJS5,D8SNM6,A0A1J8PPA3,X1WG39,M5FQK2,Q69VD5,A0A2R6NSC2,A0A0D8XL16,A0A016WPN3,Q9QZ81,G5EES3,A0A0K0EFP6,Q8CJG0,A0A1D5NTU6,A0A0V0YLH8,A0A139WDH0,A0A0R3W9Q7,H3DS31,G4T5G9,B7QCC4,A0A0B2UV00,M7BCJ9,E9GN30,Q7PZ41,A0A077Z361,R7U9I3,A0A1X7V1N5,A0A0K0JDP1,A0A0N4UKJ1,A0A498N3A3,A0A3M0IQP5,A0A0L8GBV4,Q32KD4,A0A1J1JBJ0,E0W4C3,A0A482XDA9,A0A3P7EJD6,J9K2Z4,A0A2J7Q8V4,T1IBM6,V3ZRX0,A0A210QKF7,A0A423TSS1,K1PT78,A0A267E8R7,A0A1D2N447,A0A226D7A9,F6YK55,T1KTE4,A0A2C9JGZ6,A0A1V9X9F0,A0A3Q0KUG5,T1FY40,1YVU,1Z26,5AWH,5G5T,6QZK,E8N0K8,A0A1I7IXT4,A0A2W1JZ37,A0A2S7WBN3,A0A328VKE4,A0A420DFE6,E0ST67,A0A4V1VDY2,A0A368P5I0,A0A4R1RMM2,A0A1Y2RDH8,Q11QW7,A0A1M5ZSR3,A0A0K8QX04,A0A0M2PXX3,K9TPA9,A0A1L3JHM3,A0A1W6MIP2,A0A1C0UUC4,A0A2U2J9E0,A0A142XB92,B1XJG0,A0A326U7G5,H1KXR6,A0A1Q4R485,K9U8J6,A0A097QRL6,K9RC91,A0A0D8ZUC0,A0A139XGN8,A0A1T4Y3A2,B6YTQ5,A0YYT3,A0A2T1EFY0,G6FTN0,A0A433NB65,A0A1Z4L0A1,K9UQR0,A0A2T1G8M7,K9VUN0,B7GJX9,A0A0P6X5X2,K9ZDE3,B0JXD6,A0A2T1LS63,A0A1Z4K1Y3,A0A1N6SSK9,A0A0P4UVI8,A0A0V7ZCG4,A0A1J0AGK2,K9PFF9,A0A2G9DT08,K9UEV4,Q9L1X1,A0A1H3LE92,A0A496APJ8,A0A1V9G9U4,S7VLM7,A0A1A5X8H4,A0A1I2T6Q1,A0A1R3T9N6,H8KXJ0,D3S0S6,A0A2D1U4H7,I3TE64,A0A0B7I4Z6,A0LL61,Q8DKB1,A0A139WY18,A0A2T1E1K4,A0A1Q8ZD62,A0A4Q6XKV6,A0A1Z3HNN4,A0A239JE83,A0A2N4XBY2,Q53W94,R5JEI2,A0A0Q0ZC47,A0A2T0XH18,A0A1V4CHV0,A0A1K1RQP7,A0A2T1EKT1,A0A1N6LUI7,A0A0P0NGR6,A0A1X7IML5,A0A0A2LKJ7,K1L112,A0A0U3AL92,A0A1H3A054,E0UCX3,K9XZC6,A0A0C1VHB4,Q31N05,A0A0C5JKF3,R5NJJ8,A5D4D9,Q2JI93,A0A142Y7A9,A0A432MEQ5,A0A372DKU2,A0A3R7KLK4,C1F5Q7,A0A4R3EV39,A0A1P8WP90,A0A222F7P0,A0A1C9VH88,A0A2T2YMB1,A0A329TD61,A0A101R2A0,A0A1U9ND56,A0A4R7BQC4,A0A1H3DGN3,A0A1Q1FPH0,E0TGY3,A0A259TUP4,F6EYI8,A0A2S9Q9J0,A0A4Q2UIU6,A0A1H0LH25,A0A318LG42,L0JS08,A0A345E7N0,M0AF24,A0A1H3X247,M0D2X3,A0A2R5G167,A0A346PK63,R7RTW6,B9LVP8,M5RSF0,W0JW77,B7K585,F8D8G0,A0A343TL88,L0AJX6,A0A2A5QS34,A0A343JEE2,A0A3P3RGE5,A0A329TBQ3,A0A285N2A8,A0A0W1S8B8,A0A1V4C8L7,L9VRQ2,E4NRV1,A0A1I6HGN0,A0A1I0NI68,,",366,37
"281","C.L25.7","C.L3.9",177,127,50,1.42496062992126,"4F3T,5GUH,6KR6,7KX7,A0A163JTZ6,J9D5G4,R1FDF0,A0A074TLL7,A0A0D1ZAJ4,Q1K660,A0A3M7S814,S7WCF7,I0YVB2,C1DZY0,A0A1U7LLR0,A0A4S2MWZ7,K1VVQ6,A0A158P1R9,G7DVX0,G4N9J3,E3KLI3,B7Q5I1,A0A1E3QC61,S8ANP9,A0A139AUH8,L2GMR6,U4LBG4,A0A177URI1,O74957,A0A3N4IGK1,A0A0E9NDK5,T1KZ60,A0A250WXN5,A0A2G8JLH3,Q5KAT1,L2GUF2,W2T741,A0A1W0E4B5,A0A2J7QB22,A0A2K3CW87,A0A388KES6,A0A226EFL3,A0A3S3PD82,A0A0L0TEV1,A0A1S3J512,C4V9J2,A0A075AN09,Q5TW24,A0A2B4RHN2,A0A397UU01,A0A2T7PFL8,K7ISV0,A0A024FT57,H3HCL6,A0A0G4IME3,E9FUN9,D7FQK3,A0A1Y1YHC8,T1GSU4,F4S231,A0A1D8PMK0,Q5BD61,A0A1C7M8P2,A0A158PJG6,J9JZ66,A0A0C2XG51,A0A158QZT6,T0SAU8,R7YY92,A0A3S1A0C3,A0A074YJ47,A0A1Q3ENA6,A8P0D4,F4NYW7,A0A409Y6G2,A0A0L0HAB7,D8PZT7,A0A1D1W4K0,A7RQ46,W4YU94,A7BJS5,A0A1J8PPA3,X1WG39,M5FQK2,A0A2R6NSC2,A0A0D8XL16,A0A016WPN3,G5EES3,Q8CJG0,A0A1D5NTU6,V2WTL2,A0A0V0YLH8,A0A139WDH0,A0A0R3W9Q7,H3DS31,B7QCC4,A0A0B2UV00,M7BCJ9,E9GN30,Q7PZ41,A0A077Z361,A0A1X7V1N5,A0A0K0JDP1,A0A0N4UKJ1,A0A498N3A3,A0A3M0IQP5,A0A0L8GBV4,Q32KD4,A0A1J1JBJ0,E0W4C3,A0A482XDA9,A0A3P7EJD6,J9K2Z4,A0A2J7Q8V4,T1IBM6,V3ZRX0,A0A210QKF7,A0A423TSS1,K1PT78,A0A267E8R7,A0A1D2N447,A0A226D7A9,T1KTE4,A0A2C9JGZ6,A0A1V9X9F0,K5X5Z7,A0A3Q0KUG5,A0A1I7IXT4,A0A2W1JZ37,A0A2S7WBN3,A0A420DFE6,A0A4V1VDY2,A0A368P5I0,C4L1M1,A0A1M5ZSR3,A0A0K8QX04,A0A0B0H9B4,B7GJX9,A0A2G9DT08,Q9L1X1,A0A235B542,S7VLM7,A0A1A5X8H4,A0A1I2T6Q1,A0A1R3T9N6,H8KXJ0,A0A0B7I4Z6,A0LL61,R5JEI2,A0A1V4CHV0,A0A1N6LUI7,A0A0U3AL92,A0A0C5JKF3,A0A372DKU2,C1F5Q7,A0A1C9VH88,A0A2T2YMB1,A0A101R2A0,A0A2S9Q9J0,A0A1H0LH25,A0A318LG42,H1YCU5,A0A1Q5ZS75,A0A345E7N0,A0A0C1XUA0,A0A346PK63,A0A1H2RBI2,A0A1C3ZXN2,W0JW77,A0A343TL88,A0A3P3RGE5,A0A329TBQ3,A0A0W1S8B8,L9VRQ2,E4NRV1,A0A1I6HGN0,A0A1I0NI68,,",366,37
"288","C.L2.1","C.L3.9",226,128,98,3.14931441326531,"4F1N,4F3T,4KRE,6OON,7KX7,7SWF,A0A163JTZ6,S4RWI0,D2VMG4,A0A074TLL7,Q1K660,A0A164ZA52,A0A383WDW5,R7QGN7,C1DZY0,A0A2C5Z0M1,A0A1Z5TVE5,A0A1U7LLR0,K1VVQ6,A0A158P1R9,G7DVX0,V6R0U9,G4N9J3,E3KLI3,B7Q5I1,A0A1E3QC61,D5GGK8,S8ANP9,A0A139AUH8,L2GMR6,O74957,A0A3N4IGK1,A6N7Y9,A0A0E9NDK5,A0A2G8JLH3,Q5KAT1,W2T741,A0A1W0E4B5,A0A2J7QB22,A0A2K3CW87,A0A388KES6,A0A226EFL3,A0A1J1HRI1,C4V9J2,Q9JMB7,A0A075AN09,Q5TW24,A0A401PRI6,Q96J94,G2QEV0,A0A397UU01,A0A2T7PFL8,A0A024FT57,H3HCL6,A0A0G4IME3,E9FUN9,A0A1S3CYL5,D7FQK3,A0A1Y1YHC8,F4S231,A0A1D8PMK0,A0A2G5B1D8,A0A1C7M8P2,A0A4D8YSQ3,A0A0C2XG51,T0SAU8,R7YY92,A0A074YJ47,A0A2K1J482,A0A1Q3ENA6,O04379,A0A371I3C8,M8AEW7,A8P0D4,A0A2K3NY65,F4NYW7,A0A409Y6G2,A0A0L0HAB7,D8PZT7,A0A1D1W4K0,A7RQ46,A7BJS5,D8SNM6,A0A1J8PPA3,X1WG39,Q69VD5,A0A2R6NSC2,A0A0D8XL16,A0A016WPN3,Q9QZ81,G5EES3,A0A0K0EFP6,V2WTL2,A0A0V0YLH8,A0A139WDH0,A0A0R3W9Q7,H3DS31,A0A1Y1HWP2,G4T5G9,A0A0B2UV00,E9GN30,Q7PZ41,A0A077Z361,R7U9I3,A0A1X7V1N5,A0A0K0JDP1,A0A0N4UKJ1,A0A498N3A3,A0A0L8GBV4,Q32KD4,A0A1J1JBJ0,E0W4C3,A0A482XDA9,A0A3P7EJD6,A0A2J7Q8V4,T1IBM6,V3ZRX0,A0A210QKF7,A0A423TSS1,K1PT78,A0A1D2N447,A0A226D7A9,T1KTE4,A0A2C9JGZ6,A0A1V9X9F0,K5X5Z7,A0A3Q0KUG5,T1FY40,5AWH,5I4A,7R8K,A0A1I7IXT4,A0A2W1JZ37,A0A2S7WBN3,A0A420DFE6,A0A4V1VDY2,A0A368P5I0,A0A4R1RMM2,A0A1M5ZSR3,A0A0K8QX04,A0A1I3LMA1,A0A1L3JHM3,A0A1W6MIP2,A0A3D8L290,A0A1T4Y3A2,A0A2G9DT08,Q9L1X1,A0A060HNJ0,R5XQK4,A0A496APJ8,H0HWQ5,A0A1V9G9U4,F8ERC7,S7VLM7,A0A1A5X8H4,A0A1I2T6Q1,A0A1R3T9N6,H8KXJ0,A0A2D1U4H7,A0A0B7I4Z6,A0LL61,A0A139WY18,A0A2T1E1K4,A0A1Q8ZD62,A0A4Q6XKV6,A0A1Z3HNN4,A0A239JE83,A0A2N4XBY2,R5JEI2,A0A0Q0ZC47,A0A2T0XH18,A0A1V4CHV0,A0A1K1RQP7,A0A1N6LUI7,A0A0P0NGR6,A0A1X7IML5,A0A0A2LKJ7,K1L112,A0A0U3AL92,A0A1H3A054,E0UCX3,A0A0C5JKF3,A5D4D9,A0A142Y7A9,A0A432MEQ5,A0A372DKU2,A0A4R3EV39,A0A1P8WP90,A0A222F7P0,A0A1C9VH88,A0A2T2YMB1,A0A101R2A0,A0A1E3XF49,A0A1U9ND56,A0A4R7BQC4,A0A1H3DGN3,A0A1Q1FPH0,E0TGY3,A0A259TUP4,F6EYI8,A0A2S9Q9J0,A0A4Q2UIU6,A0A1H0LH25,A0A318LG42,H1YCU5,A0A1Q5ZS75,A0A345E7N0,A0A1W2A082,A0A1H3X247,A0A0C1XUA0,A0A2R5G167,A0A346PK63,A0A1C3ZXN2,B9LVP8,M5RSF0,B7K585,F8D8G0,A0A343TL88,A0A3P3RGE5,A0A329TBQ3,A0A0W1S8B8,A0A1V4C8L7,L9VRQ2,E4NRV1,A0A1I6HGN0,A0A1I0NI68,,",366,37
"291","C.S15.1","C.S16.4",236,128,108,2.70109953703704,"4F1N,5VM9,6KR6,7KX7,7SWF,A0A163JTZ6,A0A0N4X8S8,A0A196SDB4,J9D5G4,C4LVV2,A0A2P6N8X7,A2DPV7,A0A0G4H2S4,R1FDF0,A0A074TLL7,Q1K660,A0A3M7S814,A0A164ZA52,A0A383WDW5,S7WCF7,I0YVB2,R7QGN7,C1DZY0,A0A2C5Z0M1,D3BMP8,A0A1Z5TVE5,W7XD45,A0A1U7LLR0,A0A4S2MWZ7,E3KLI3,D5GGK8,S8ANP9,A0A139AUH8,A0A250WXN5,L2GUF2,W2T741,A0A2K3CW87,A0A388KES6,A0A0L0TEV1,U5HIG6,A0A2B4RHN2,A0A397UU01,A0A2T7PFL8,A0A024FT57,H3HCL6,A0A0G4IME3,E9FUN9,D7FQK3,A0A1Y1YHC8,T1GSU4,F4S231,A0A1D8PMK0,A0A2G5B1D8,Q5BD61,A0A1C7M8P2,A0A4D8YSQ3,A0A158PJG6,A0A158QZT6,A0A165QYQ9,T0SAU8,R7YY92,A0A3S1A0C3,A0A074YJ47,A0A2K1J482,O04379,A0A371I3C8,M8AEW7,A8P0D4,A0A2K3NY65,F4NYW7,A0A0L0HAB7,D8PZT7,A0A1D1W4K0,A7RQ46,W4YU94,A7BJS5,D8SNM6,A0A1J8PPA3,X1WG39,Q69VD5,A0A2R6NSC2,A0A0D8XL16,A0A016WPN3,Q9QZ81,G5EES3,A0A0K0EFP6,Q8CJG0,A0A1D5NTU6,V2WTL2,A0A0V0YLH8,A0A139WDH0,A0A0R3W9Q7,H3DS31,A0A1Y1HWP2,G4T5G9,B7QCC4,A0A0B2UV00,E9GN30,Q7PZ41,A0A077Z361,R7U9I3,A0A1X7V1N5,A0A0K0JDP1,A0A0N4UKJ1,A0A498N3A3,A0A0L8GBV4,Q32KD4,A0A1J1JBJ0,E0W4C3,A0A482XDA9,A0A3P7EJD6,J9K2Z4,A0A2J7Q8V4,T1IBM6,V3ZRX0,A0A210QKF7,A0A423TSS1,K1PT78,A0A267E8R7,A0A1D2N447,A0A226D7A9,F6YK55,T1KTE4,A0A2C9JGZ6,A0A1V9X9F0,K5X5Z7,A0A3Q0KUG5,T1FY40,1Z26,3DLB,5AWH,5G5T,6QZK,7R8K,A0A328VKE4,E0ST67,A0A4R1RMM2,A0A1M5ZSR3,A0A0K8QX04,A0A1L3JHM3,A0A1W6MIP2,A0A2Z6E1D5,A0A0F4NXW8,L8D0R3,A0A326U7G5,A0A3D8L290,A0A0D8ZUC0,A0A139XGN8,A0A1T4Y3A2,Q5P0R2,A0A2T1EFY0,G6FTN0,A0A433NB65,A0A1Z4L0A1,K9VUN0,A0A0P6X5X2,K9ZDE3,A0A1Z4K1Y3,A0A0P4UVI8,A0A1J0AGK2,K9PFF9,A0A2G9DT08,A0A060HNJ0,A0A235B542,A0A496APJ8,H0HWQ5,A0A1V9G9U4,S7VLM7,A0A1A5X8H4,A0A1I2T6Q1,A0A0Q2M2Z1,H8KXJ0,D3S0S6,A0A2D1U4H7,A0A0B7I4Z6,Q8DKB1,A0A139WY18,A0A1J1EK56,A0A2T1E1K4,A0A1Q8ZD62,A0A4Q6XKV6,A0A1Z3HNN4,A0A239JE83,A0A2N4XBY2,R5JEI2,A0A0Q0ZC47,A0A2T0XH18,A0A1V4CHV0,A0A1K1RQP7,A0A2T1EKT1,A0A0P0NGR6,A0A1X7IML5,A0A0A2LKJ7,K1L112,A0A0U3AL92,A0A1H3A054,E0UCX3,K9XZC6,A0A0C5JKF3,R5NJJ8,A5D4D9,A0A142Y7A9,A0A432MEQ5,A0A372DKU2,A0A3R7KLK4,A0A4R3EV39,A0A1P8WP90,A0A1C9VH88,A0A2T2YMB1,A0A101R2A0,A0A1E3XF49,A0A1H3DGN3,A0A1Q1FPH0,A0A2S9Q9J0,A0A1H0LH25,A0A318LG42,A0A345E7N0,A0A1W2A082,A0A1H3X247,A0A0C1XUA0,A0A2R5G167,A0A346PK63,A0A1H2RBI2,M5RSF0,B7K585,A0A343TL88,L0AJX6,A0A2A5QS34,A0A343JEE2,A0A3P3RGE5,A0A329TBQ3,A0A285N2A8,A0A0W1S8B8,L9VRQ2,A0A1I6HGN0,A0A1I0NI68,,",366,37
"292","C.S3.3","C.S4.1",233,128,105,2.18575148809524,"4F3T,4KRE,5GUH,5VM9,6KR6,6OON,A0A163JTZ6,J9D5G4,C4LVV2,T1H8B3,S4RWI0,F4PH46,A0A3M7S814,A0A383WDW5,Q54G64,S7WCF7,R7QGN7,A0CB11,D3BMP8,W7XD45,A0A158P1R9,B7Q5I1,L2GMR6,O74957,A6N7Y9,T1KZ60,A0A250WXN5,A0A2G8JLH3,Q5KAT1,L2GUF2,W2T741,A0A1W0E4B5,A0A2J7QB22,S4RYE2,A0A388KES6,A0A226EFL3,A0A3S3PD82,A0A1S3J512,G0QTT2,A0A1J1HRI1,C4V9J2,Q9JMB7,A0A075AN09,Q5TW24,U5HIG6,A0A401PRI6,Q96J94,A0A2B4RHN2,A0A397UU01,A0A2T7PFL8,K7ISV0,A0A024FT57,H3HCL6,A0A0G4IME3,E9FUN9,A0A1S3CYL5,D7FQK3,A0A1Y1YHC8,A0A1D8PMK0,A0A2G5B1D8,A0A1C7M8P2,A0A158PJG6,J9JZ66,A0A0C2XG51,A0A158QZT6,A0A165QYQ9,T0SAU8,A0A3S1A0C3,A0A1Q3ENA6,A8P0D4,F4NYW7,A0A409Y6G2,A0A0L0HAB7,D8PZT7,A0A1D1W4K0,W4YU94,A7BJS5,A0A1J8PPA3,X1WG39,M5FQK2,A0A2R6NSC2,A0A0D8XL16,A0A016WPN3,Q9QZ81,G5EES3,A0A0K0EFP6,Q8CJG0,A0A1D5NTU6,V2WTL2,A0A0V0YLH8,A0A139WDH0,A0A0R3W9Q7,H3DS31,G4T5G9,B7QCC4,A0A0B2UV00,M7BCJ9,E9GN30,Q7PZ41,A0A077Z361,R7U9I3,A0A1X7V1N5,A0A0K0JDP1,A0A0N4UKJ1,A0A498N3A3,A0A3M0IQP5,A0A0L8GBV4,Q32KD4,A0A1J1JBJ0,E0W4C3,A0A482XDA9,A0A3P7EJD6,J9K2Z4,A0A2J7Q8V4,T1IBM6,V3ZRX0,A0A210QKF7,A0A423TSS1,K1PT78,A0A267E8R7,A0A1D2N447,A0A226D7A9,T1KTE4,A0A2C9JGZ6,A0A1V9X9F0,K5X5Z7,A0A3Q0KUG5,T1FY40,1YVU,1Z26,3DLB,5AWH,5G5T,5I4A,7R8K,E0ST67,A0A1T4Y3A2,A0A2G9DT08,Q9L1X1,A0A1H3LE92,A0A496APJ8,A0A062U2W9,H0HWQ5,A0A1V9G9U4,A0A1I2ZGP1,A0A317EJY3,A0A1I2BD20,F8ERC7,S7VLM7,A0A1A5X8H4,A0A1I2T6Q1,A0A1R3T9N6,A0A0Q2M2Z1,H8KXJ0,D3S0S6,A0A2D1U4H7,I3TE64,A0A0B7I4Z6,A0LL61,A0A139WY18,A0A1J1EK56,A0A2T1E1K4,A0A1Q8ZD62,A0A4Q6XKV6,A0A1Z3HNN4,A0A239JE83,A0A2N4XBY2,Q53W94,R5JEI2,A0A0Q0ZC47,A0A2T0XH18,A0A1V4CHV0,A0A1K1RQP7,A0A1N6LUI7,A0A0P0NGR6,A0A1X7IML5,A0A0A2LKJ7,K1L112,A0A0U3AL92,A0A1H3A054,B9LVW4,A0A0C5JKF3,R5NJJ8,A5D4D9,A0A142Y7A9,A0A432MEQ5,A0A372DKU2,C1F5Q7,A0A4R3EV39,A0A1P8WP90,A0A222F7P0,A0A1C9VH88,A0A2T2YMB1,A0A101R2A0,A0A1E3XF49,A0A1U9ND56,A0A4R7BQC4,E0TGY3,A0A259TUP4,F6EYI8,A0A2S9Q9J0,A0A4Q2UIU6,A0A1H0LH25,A0A318LG42,H1YCU5,L0JS08,A0A1Q5ZS75,M0AF24,A0A1W2A082,A0A0C1XUA0,M0D2X3,A0A2R5G167,A0A346PK63,R7RTW6,A0A1H2RBI2,A0A1C3ZXN2,M5RSF0,W0JW77,B7K585,F8D8G0,A0A343TL88,L0AJX6,A0A2A5QS34,A0A343JEE2,A0A3P3RGE5,A0A329TBQ3,A0A285N2A8,A0A0W1S8B8,A0A1V4C8L7,L9VRQ2,E4NRV1,A0A1I6HGN0,A0A1I0NI68,,",366,37
"293","N.H8.5","N.S12.7",211,128,83,2.53322665662651,"4F3T,4KRE,5GUH,5VM9,6OON,7KX7,A0A163JTZ6,A0A0N4X8S8,J9D5G4,Q389P5,C4LVV2,A8BCK6,A2DPV7,A0A0G4H2S4,R1FDF0,S4RWI0,D2VMG4,F4PH46,A0A3M7S814,A0A383WDW5,Q54G64,S7WCF7,I0YVB2,A0CB11,R9ACY5,D3BMP8,A0A4S2MWZ7,G7DVX0,E3KLI3,L2GMR6,U4LBG4,O74957,A0A2G8JLH3,Q5KAT1,W2T741,S4RYE2,A0A388KES6,A0A226EFL3,A0A3S3PD82,A0A0L0TEV1,A0A1S3J512,G0QTT2,C4V9J2,A0A075AN09,U5HIG6,A0A401PRI6,A0A397UU01,A0A2T7PFL8,K7ISV0,A0A024FT57,A0A0G4IME3,A0A1S3CYL5,D7FQK3,A0A1Y1YHC8,T1GSU4,F4S231,A0A1D8PMK0,A0A2G5B1D8,A0A1C7M8P2,A0A4D8YSQ3,A0A158PJG6,J9JZ66,A0A0C2XG51,A0A165QYQ9,T0SAU8,A0A3S1A0C3,A0A2K1J482,A0A1Q3ENA6,O04379,A0A371I3C8,M8AEW7,A0A2K3NY65,F4NYW7,A0A409Y6G2,A0A0L0HAB7,D8PZT7,A0A1D1W4K0,A7RQ46,W4YU94,A7BJS5,D8SNM6,A0A1J8PPA3,M5FQK2,A0A016WPN3,Q9QZ81,G5EES3,A0A0K0EFP6,Q8CJG0,A0A1D5NTU6,V2WTL2,A0A0V0YLH8,A0A139WDH0,A0A0R3W9Q7,H3DS31,A0A1Y1HWP2,G4T5G9,B7QCC4,A0A0B2UV00,E9GN30,Q7PZ41,A0A077Z361,R7U9I3,A0A1X7V1N5,A0A0K0JDP1,A0A0N4UKJ1,A0A498N3A3,A0A0L8GBV4,Q32KD4,A0A1J1JBJ0,E0W4C3,A0A482XDA9,A0A3P7EJD6,J9K2Z4,A0A2J7Q8V4,T1IBM6,V3ZRX0,A0A210QKF7,A0A423TSS1,K1PT78,A0A267E8R7,A0A1D2N447,A0A226D7A9,F6YK55,T1KTE4,A0A2C9JGZ6,A0A1V9X9F0,A0A3Q0KUG5,T1FY40,1Z26,3DLB,5AWH,6QZK,A0A1I3LMA1,H1KXR6,A0A1T4Y3A2,A0A1N6SSK9,Q9L1X1,A0A060HNJ0,A0A062U2W9,H0HWQ5,A0A1V9G9U4,A0A1I2ZGP1,A0A317EJY3,A0A1I2BD20,F8ERC7,A0A1I2T6Q1,A0A1R3T9N6,A0A0Q2M2Z1,A0A2D1U4H7,A0LL61,Q8DKB1,A0A139WY18,A0A1J1EK56,A0A2T1E1K4,A0A1Q8ZD62,A0A4Q6XKV6,A0A1Z3HNN4,Q53W94,A0A2T1EKT1,A0A1X7IML5,A0A0U3AL92,A0A1H3A054,E0UCX3,A0A0C1VHB4,Q31N05,A0A0C5JKF3,R5NJJ8,Q2JI93,A0A142Y7A9,A0A432MEQ5,A0A372DKU2,A0A3R7KLK4,C1F5Q7,A0A4R3EV39,A0A1P8WP90,A0A1C9VH88,A0A2T2YMB1,A0A329TD61,A0A101R2A0,A0A1U9ND56,A0A4R7BQC4,A0A1H3DGN3,A0A1Q1FPH0,F6EYI8,A0A2S9Q9J0,A0A1H0LH25,A0A318LG42,H1YCU5,L0JS08,A0A1Q5ZS75,A0A345E7N0,M0AF24,A0A1W2A082,A0A1H3X247,A0A0C1XUA0,M0D2X3,A0A346PK63,R7RTW6,B9LVP8,M5RSF0,B7K585,F8D8G0,A0A343TL88,A0A343JEE2,A0A3P3RGE5,A0A329TBQ3,A0A285N2A8,A0A0W1S8B8,A0A1V4C8L7,L9VRQ2,E4NRV1,,",366,37
"294","N.L7.2","N.L7.4",176,128,48,1.625,"4KRE,5GUH,5VM9,6OON,7KX7,7SWF,C4LVV2,A2DPV7,T1H8B3,S4RWI0,D2VMG4,A0A164ZA52,S7WCF7,R7QGN7,R9ACY5,W7XD45,A0A1U7LLR0,A0A4S2MWZ7,A0A158P1R9,G7DVX0,G4N9J3,E3KLI3,A0A1E3QC61,D5GGK8,S8ANP9,A0A139AUH8,L2GMR6,U4LBG4,O74957,A0A3N4IGK1,A0A0E9NDK5,L2GUF2,W2T741,A0A1W0E4B5,A0A2J7QB22,A0A226EFL3,A0A0L0TEV1,G0QTT2,A0A1J1HRI1,C4V9J2,A0A075AN09,Q5TW24,U5HIG6,A0A401PRI6,A0A2B4RHN2,G2QEV0,A0A397UU01,A0A2T7PFL8,K7ISV0,A0A024FT57,A0A0G4IME3,E9FUN9,A0A1S3CYL5,D7FQK3,A0A1Y1YHC8,T1GSU4,A0A1D8PMK0,A0A2G5B1D8,Q5BD61,A0A1C7M8P2,A0A158PJG6,J9JZ66,A0A158QZT6,A0A165QYQ9,T0SAU8,R7YY92,A0A3S1A0C3,A0A074YJ47,A0A1Q3ENA6,A8P0D4,F4NYW7,A0A409Y6G2,A0A0L0HAB7,D8PZT7,A0A1D1W4K0,A7RQ46,W4YU94,A7BJS5,A0A1J8PPA3,M5FQK2,A0A2R6NSC2,A0A0D8XL16,A0A016WPN3,Q9QZ81,G5EES3,A0A0K0EFP6,Q8CJG0,A0A1D5NTU6,V2WTL2,A0A0V0YLH8,A0A139WDH0,A0A0R3W9Q7,H3DS31,B7QCC4,A0A0B2UV00,M7BCJ9,E9GN30,Q7PZ41,A0A077Z361,R7U9I3,A0A1X7V1N5,A0A0K0JDP1,A0A0N4UKJ1,A0A498N3A3,A0A3M0IQP5,A0A0L8GBV4,Q32KD4,A0A1J1JBJ0,E0W4C3,A0A482XDA9,A0A3P7EJD6,J9K2Z4,A0A2J7Q8V4,T1IBM6,V3ZRX0,A0A210QKF7,A0A423TSS1,K1PT78,A0A267E8R7,A0A1D2N447,A0A226D7A9,F6YK55,T1KTE4,A0A2C9JGZ6,A0A1V9X9F0,K5X5Z7,A0A3Q0KUG5,T1FY40,1Z26,3DLB,5AWH,5I4A,6QZK,7R8K,A0A1I3LMA1,A0A0B0H9B4,R6KUL9,B7GJX9,A0A1N6SSK9,A0A235B542,R5XQK4,A0A062U2W9,A0A0Q2M2Z1,D3S0S6,I3TE64,Q8DKB1,A0A1Z3HNN4,A0A2T1EKT1,K1L112,E0UCX3,K9XZC6,B9LVW4,A0A0C1VHB4,Q31N05,A0A0C5JKF3,R5NJJ8,Q2JI93,A0A372DKU2,A0A3R7KLK4,A0A1C9VH88,A0A1H3DGN3,L0JS08,M0AF24,M0D2X3,R7RTW6,W0JW77,A0A343TL88,L0AJX6,A0A343JEE2,A0A3P3RGE5,A0A329TBQ3,A0A285N2A8,A0A0W1S8B8,L9VRQ2,E4NRV1,A0A1I6HGN0,,",366,37
"296","N.S8.1","N.S9.2",190,128,62,1.97832661290323,"4F1N,4F3T,4KRE,5GUH,5VM9,6KR6,6OON,7KX7,7SWF,C4LVV2,A0A0G4H2S4,T1H8B3,S4RWI0,D2VMG4,A0A0D1ZAJ4,Q1K660,F4PH46,A0A3M7S814,A0A164ZA52,Q54G64,S7WCF7,I0YVB2,R7QGN7,C1DZY0,A0A2C5Z0M1,A0CB11,D3BMP8,A0A1Z5TVE5,W7XD45,A0A4S2MWZ7,A0A158P1R9,V6R0U9,G4N9J3,E3KLI3,B7Q5I1,A0A1E3QC61,D5GGK8,S8ANP9,A0A139AUH8,L2GMR6,U4LBG4,O74957,A0A3N4IGK1,A6N7Y9,A0A0E9NDK5,T1KZ60,A0A250WXN5,A0A2G8JLH3,L2GUF2,W2T741,A0A1W0E4B5,A0A2J7QB22,S4RYE2,A0A388KES6,A0A226EFL3,A0A3S3PD82,A0A0L0TEV1,A0A1S3J512,G0QTT2,A0A1J1HRI1,Q9JMB7,A0A075AN09,Q5TW24,U5HIG6,A0A401PRI6,Q96J94,A0A2B4RHN2,G2QEV0,A0A397UU01,A0A2T7PFL8,K7ISV0,A0A024FT57,H3HCL6,A0A0G4IME3,E9FUN9,A0A1S3CYL5,D7FQK3,A0A1Y1YHC8,F4S231,A0A1D8PMK0,A0A2G5B1D8,Q5BD61,A0A1C7M8P2,A0A4D8YSQ3,A0A158PJG6,J9JZ66,A0A0C2XG51,A0A158QZT6,A0A165QYQ9,T0SAU8,R7YY92,A0A074YJ47,A0A1Q3ENA6,O04379,A0A371I3C8,M8AEW7,A8P0D4,A0A2K3NY65,F4NYW7,A0A409Y6G2,A0A0L0HAB7,D8PZT7,D8SNM6,A0A1J8PPA3,X1WG39,M5FQK2,Q69VD5,A0A2R6NSC2,A0A0D8XL16,A0A016WPN3,Q9QZ81,G5EES3,A0A0K0EFP6,V2WTL2,A0A0V0YLH8,H3DS31,A0A1Y1HWP2,G4T5G9,A0A0B2UV00,M7BCJ9,A0A077Z361,A0A0K0JDP1,A0A0N4UKJ1,A0A3M0IQP5,A0A3P7EJD6,A0A423TSS1,A0A267E8R7,K5X5Z7,3DLB,5AWH,5I4A,7R8K,C4L1M1,A0A2G9DT08,Q9L1X1,A0A1H3LE92,A0A496APJ8,A0A062U2W9,A0A1V9G9U4,A0A1A5X8H4,A0A1I2T6Q1,A0A1R3T9N6,A0LL61,A0A139WY18,A0A1J1EK56,A0A2T1E1K4,A0A1Q8ZD62,A0A1Z3HNN4,Q53W94,A0A1V4CHV0,A0A1N6LUI7,A5D4D9,A0A142Y7A9,A0A4R3EV39,A0A1P8WP90,A0A222F7P0,A0A329TD61,A0A101R2A0,A0A1E3XF49,A0A1Q1FPH0,E0TGY3,A0A259TUP4,F6EYI8,A0A2S9Q9J0,A0A4Q2UIU6,A0A1H0LH25,A0A318LG42,H1YCU5,L0JS08,A0A1Q5ZS75,A0A345E7N0,M0AF24,A0A1W2A082,A0A1H3X247,A0A0C1XUA0,M0D2X3,A0A2R5G167,A0A346PK63,A0A1H2RBI2,A0A1C3ZXN2,B9LVP8,A0A343TL88,A0A3P3RGE5,A0A329TBQ3,A0A285N2A8,A0A0W1S8B8,L9VRQ2,E4NRV1,A0A1I6HGN0,A0A1I0NI68,,",366,37
"297","C.H1.8","C.H5.5",214,129,85,1.74819881440948,"4F3T,4KRE,5GUH,5VM9,6OON,A0A163JTZ6,A0A2P6N8X7,A2DPV7,S4RWI0,A0A0D1ZAJ4,A0A3M7S814,A0A164ZA52,A0A383WDW5,A0A2C5Z0M1,D3BMP8,A0A1Z5TVE5,A0A4S2MWZ7,K1VVQ6,A0A158P1R9,G7DVX0,V6R0U9,G4N9J3,E3KLI3,B7Q5I1,A0A1E3QC61,D5GGK8,U4LBG4,O74957,A6N7Y9,A0A0E9NDK5,A0A2G8JLH3,Q5KAT1,W2T741,A0A2J7QB22,S4RYE2,A0A388KES6,A0A226EFL3,A0A3S3PD82,A0A0L0TEV1,A0A075AN09,Q5TW24,U5HIG6,A0A2B4RHN2,A0A2T7PFL8,K7ISV0,A0A1S3CYL5,D7FQK3,T1GSU4,F4S231,A0A1D8PMK0,Q5BD61,A0A1C7M8P2,A0A4D8YSQ3,A0A158PJG6,J9JZ66,A0A0C2XG51,A0A158QZT6,A0A165QYQ9,T0SAU8,R7YY92,A0A3S1A0C3,A0A2K1J482,A0A1Q3ENA6,O04379,A0A371I3C8,M8AEW7,A8P0D4,A0A2K3NY65,F4NYW7,A0A409Y6G2,D8PZT7,A0A1D1W4K0,A7RQ46,W4YU94,A7BJS5,D8SNM6,A0A1J8PPA3,X1WG39,M5FQK2,A0A2R6NSC2,A0A0D8XL16,A0A016WPN3,Q9QZ81,G5EES3,A0A0K0EFP6,Q8CJG0,A0A1D5NTU6,V2WTL2,A0A0V0YLH8,A0A139WDH0,A0A0R3W9Q7,H3DS31,A0A1Y1HWP2,G4T5G9,B7QCC4,A0A0B2UV00,M7BCJ9,E9GN30,Q7PZ41,A0A077Z361,R7U9I3,A0A1X7V1N5,A0A0K0JDP1,A0A0N4UKJ1,A0A498N3A3,A0A3M0IQP5,A0A0L8GBV4,Q32KD4,A0A1J1JBJ0,E0W4C3,A0A482XDA9,A0A3P7EJD6,J9K2Z4,A0A2J7Q8V4,T1IBM6,V3ZRX0,A0A210QKF7,A0A423TSS1,K1PT78,A0A267E8R7,A0A1D2N447,A0A226D7A9,F6YK55,T1KTE4,A0A2C9JGZ6,A0A1V9X9F0,K5X5Z7,A0A3Q0KUG5,T1FY40,1Z26,5AWH,7R8K,E8N0K8,A0A1I3LMA1,A0A1W6MIP2,A0A2U2J9E0,A0A0F4NXW8,L8D0R3,K9U8J6,A0A0D8ZUC0,A0A139XGN8,Q5P0R2,A0A2T1EFY0,G6FTN0,R6KUL9,A0A433NB65,A0A1Z4L0A1,K9UQR0,A0A2T1G8M7,B7GJX9,A0A1Z4K1Y3,A0A2Z6E0R7,A0A1J0AGK2,K9PFF9,A0A2G9DT08,K9UEV4,Q9L1X1,A0A060HNJ0,A0A235B542,R5XQK4,H0HWQ5,S7VLM7,A0A1A5X8H4,A0A1R3T9N6,A0A0Q2M2Z1,H8KXJ0,A0A2D1U4H7,A0A0B7I4Z6,A0LL61,A0A4Q6XKV6,A0A239JE83,A0A2N4XBY2,R5JEI2,A0A0Q0ZC47,A0A2T0XH18,A0A1V4CHV0,A0A1K1RQP7,A0A1N6LUI7,A0A0P0NGR6,A0A1X7IML5,A0A0A2LKJ7,K1L112,A0A0U3AL92,A0A1H3A054,A0A0C5JKF3,A5D4D9,A0A142Y7A9,A0A432MEQ5,A0A372DKU2,C1F5Q7,A0A4R3EV39,A0A1P8WP90,A0A222F7P0,A0A1C9VH88,A0A101R2A0,A0A1E3XF49,A0A1U9ND56,A0A4R7BQC4,A0A1Q1FPH0,A0A259TUP4,A0A1H0LH25,A0A318LG42,L0JS08,A0A2R5G167,A0A346PK63,B9LVP8,M5RSF0,B7K585,A0A3P3RGE5,A0A285N2A8,A0A0W1S8B8,L9VRQ2,E4NRV1,A0A1I6HGN0,,",366,37
"300","C.L20.4","N.S12.6",181,129,52,2.48747763864043,"4F1N,4F3T,4KRE,5GUH,5VM9,6KR6,6OON,7KX7,A0A163JTZ6,A0A196SDB4,Q389P5,A0A2P6N8X7,S4RWI0,D2VMG4,A0A0D1ZAJ4,Q1K660,A0A3M7S814,A0A164ZA52,S7WCF7,I0YVB2,R7QGN7,A0A2C5Z0M1,A0CB11,R9ACY5,A0A1Z5TVE5,A0A1U7LLR0,A0A4S2MWZ7,G7DVX0,G4N9J3,E3KLI3,A0A1E3QC61,S8ANP9,L2GMR6,U4LBG4,A0A177URI1,O74957,A0A3N4IGK1,A6N7Y9,A0A0E9NDK5,A0A250WXN5,Q5KAT1,W2T741,A0A2J7QB22,S4RYE2,A0A2K3CW87,A0A388KES6,A0A0L0TEV1,A0A1S3J512,A0A1J1HRI1,A0A075AN09,Q5TW24,U5HIG6,Q96J94,G2QEV0,A0A397UU01,A0A2T7PFL8,K7ISV0,A0A024FT57,H3HCL6,A0A0G4IME3,E9FUN9,D7FQK3,A0A1Y1YHC8,T1GSU4,F4S231,A0A1D8PMK0,A0A2G5B1D8,Q5BD61,A0A4D8YSQ3,A0A158PJG6,J9JZ66,A0A0C2XG51,A0A158QZT6,A0A165QYQ9,T0SAU8,R7YY92,A0A3S1A0C3,A0A2K1J482,A0A1Q3ENA6,O04379,A0A371I3C8,M8AEW7,A0A2K3NY65,F4NYW7,A0A409Y6G2,A0A1D1W4K0,A7RQ46,W4YU94,D8SNM6,A0A1J8PPA3,X1WG39,M5FQK2,Q69VD5,A0A0D8XL16,A0A016WPN3,Q9QZ81,G5EES3,A0A0K0EFP6,Q8CJG0,A0A1D5NTU6,A0A0V0YLH8,A0A139WDH0,A0A0R3W9Q7,H3DS31,A0A1Y1HWP2,G4T5G9,A0A0B2UV00,M7BCJ9,E9GN30,Q7PZ41,A0A077Z361,R7U9I3,A0A1X7V1N5,A0A0K0JDP1,A0A0N4UKJ1,A0A498N3A3,A0A3M0IQP5,A0A1J1JBJ0,A0A482XDA9,A0A2J7Q8V4,A0A210QKF7,K1PT78,A0A267E8R7,A0A1D2N447,A0A226D7A9,F6YK55,A0A2C9JGZ6,A0A3Q0KUG5,T1FY40,1Z26,5AWH,5G5T,5I4A,6QZK,C4L1M1,A0A3D8L290,H1KXR6,A0A097QRL6,A0A0B0H9B4,R6KUL9,B7GJX9,A0A1N6SSK9,A0A060HNJ0,A0A235B542,R5XQK4,S7VLM7,A0A0Q2M2Z1,I3TE64,A0A0B7I4Z6,A0A139WY18,A0A2T1E1K4,A0A1Q8ZD62,A0A4Q6XKV6,A0A1Z3HNN4,A0A239JE83,A0A2N4XBY2,R5JEI2,A0A0Q0ZC47,A0A2T0XH18,A0A1K1RQP7,A0A0P0NGR6,A0A1X7IML5,A0A0A2LKJ7,K1L112,A0A1H3A054,B9LVW4,A0A0C5JKF3,A5D4D9,A0A142Y7A9,A0A432MEQ5,A0A372DKU2,A0A3R7KLK4,A0A1C9VH88,A0A2T2YMB1,A0A1U9ND56,A0A4R7BQC4,A0A1H3DGN3,A0A1H0LH25,A0A318LG42,B7K585,A0A285N2A8,,",366,37
"302","C.S13.2","N.H8.6",192,129,63,2.78626799557032,"4F1N,4F3T,4KRE,5GUH,5VM9,6OON,7SWF,C4LVV2,T1H8B3,R1FDF0,S4RWI0,D2VMG4,A0A074TLL7,Q1K660,F4PH46,A0A3M7S814,A0A164ZA52,S7WCF7,I0YVB2,R7QGN7,A0A2C5Z0M1,R9ACY5,D3BMP8,A0A1Z5TVE5,W7XD45,A0A1U7LLR0,A0A4S2MWZ7,G7DVX0,V6R0U9,G4N9J3,B7Q5I1,D5GGK8,S8ANP9,L2GMR6,U4LBG4,A0A177URI1,O74957,A0A3N4IGK1,A0A0E9NDK5,Q5KAT1,L2GUF2,W2T741,A0A2J7QB22,A0A388KES6,A0A226EFL3,A0A3S3PD82,A0A0L0TEV1,A0A1S3J512,A0A1J1HRI1,A0A075AN09,Q5TW24,U5HIG6,A0A2T7PFL8,A0A024FT57,H3HCL6,A0A0G4IME3,E9FUN9,D7FQK3,T1GSU4,A0A1D8PMK0,A0A2G5B1D8,A0A1C7M8P2,J9JZ66,A0A0C2XG51,A0A158QZT6,A0A165QYQ9,T0SAU8,A0A3S1A0C3,A0A2K1J482,A0A371I3C8,M8AEW7,A8P0D4,A0A2K3NY65,F4NYW7,A0A0L0HAB7,D8PZT7,A0A1D1W4K0,A7RQ46,W4YU94,A7BJS5,A0A1J8PPA3,X1WG39,A0A0D8XL16,A0A016WPN3,Q9QZ81,G5EES3,A0A0K0EFP6,Q8CJG0,A0A1D5NTU6,A0A0V0YLH8,A0A139WDH0,A0A0R3W9Q7,H3DS31,A0A1Y1HWP2,G4T5G9,B7QCC4,A0A0B2UV00,M7BCJ9,E9GN30,Q7PZ41,A0A077Z361,R7U9I3,A0A1X7V1N5,A0A0K0JDP1,A0A0N4UKJ1,A0A498N3A3,A0A3M0IQP5,A0A0L8GBV4,Q32KD4,A0A1J1JBJ0,E0W4C3,A0A482XDA9,A0A3P7EJD6,J9K2Z4,A0A2J7Q8V4,T1IBM6,V3ZRX0,A0A210QKF7,A0A423TSS1,K1PT78,A0A267E8R7,A0A1D2N447,A0A226D7A9,F6YK55,T1KTE4,A0A2C9JGZ6,A0A1V9X9F0,A0A3Q0KUG5,T1FY40,1YVU,1Z26,5G5T,5I4A,7R8K,E0ST67,A0A3D8L290,A0A496APJ8,S7VLM7,A0A1I2T6Q1,A0A1R3T9N6,A0A0Q2M2Z1,H8KXJ0,A0A2D1U4H7,A0A0B7I4Z6,A0A139WY18,A0A4Q6XKV6,A0A1Z3HNN4,A0A239JE83,A0A2N4XBY2,R5JEI2,A0A0Q0ZC47,A0A2T0XH18,A0A1K1RQP7,A0A1N6LUI7,A0A0P0NGR6,A0A1X7IML5,A0A0A2LKJ7,K1L112,A0A0U3AL92,A0A1H3A054,A0A0C5JKF3,A0A142Y7A9,A0A372DKU2,A0A3R7KLK4,C1F5Q7,A0A4R3EV39,A0A222F7P0,A0A1C9VH88,A0A2T2YMB1,A0A101R2A0,A0A1E3XF49,A0A1Q1FPH0,A0A4Q2UIU6,H1YCU5,L0JS08,A0A1Q5ZS75,M0AF24,A0A1W2A082,A0A1H3X247,M0D2X3,A0A346PK63,A0A1H2RBI2,A0A1C3ZXN2,B9LVP8,W0JW77,A0A343TL88,L0AJX6,A0A2A5QS34,A0A3P3RGE5,A0A329TBQ3,A0A0W1S8B8,L9VRQ2,,",366,37
"304","N.S12.3","N.S12.5",196,129,67,1.98281846581048,"4F3T,6OON,7SWF,A0A163JTZ6,J9D5G4,C4LVV2,A8BCK6,A2DPV7,A0A0G4H2S4,R1FDF0,S4RWI0,D2VMG4,A0A074TLL7,A0A0D1ZAJ4,Q1K660,A0A3M7S814,A0A164ZA52,A0A383WDW5,Q54G64,S7WCF7,I0YVB2,R9ACY5,A0A1Z5TVE5,W7XD45,K1VVQ6,A0A158P1R9,G7DVX0,V6R0U9,G4N9J3,E3KLI3,B7Q5I1,A0A1E3QC61,D5GGK8,S8ANP9,A0A139AUH8,L2GMR6,U4LBG4,O74957,A0A3N4IGK1,A0A0E9NDK5,A0A250WXN5,A0A2G8JLH3,A0A2K3CW87,A0A388KES6,A0A226EFL3,A0A0L0TEV1,G0QTT2,A0A1J1HRI1,C4V9J2,Q9JMB7,A0A075AN09,Q5TW24,U5HIG6,Q96J94,A0A2B4RHN2,G2QEV0,A0A397UU01,A0A2T7PFL8,K7ISV0,A0A024FT57,H3HCL6,E9FUN9,D7FQK3,A0A1Y1YHC8,T1GSU4,F4S231,A0A4D8YSQ3,A0A158PJG6,A0A158QZT6,A0A165QYQ9,T0SAU8,A0A3S1A0C3,A0A074YJ47,A0A2K1J482,O04379,A0A371I3C8,M8AEW7,A0A2K3NY65,F4NYW7,A0A409Y6G2,A0A0L0HAB7,A0A1D1W4K0,A7RQ46,W4YU94,A7BJS5,D8SNM6,X1WG39,M5FQK2,A0A0D8XL16,A0A016WPN3,Q9QZ81,G5EES3,A0A0K0EFP6,Q8CJG0,A0A1D5NTU6,A0A0V0YLH8,A0A0R3W9Q7,H3DS31,A0A1Y1HWP2,B7QCC4,A0A0B2UV00,M7BCJ9,Q7PZ41,A0A077Z361,R7U9I3,A0A1X7V1N5,A0A0K0JDP1,A0A0N4UKJ1,A0A498N3A3,A0A3M0IQP5,A0A0L8GBV4,Q32KD4,A0A1J1JBJ0,E0W4C3,A0A482XDA9,A0A3P7EJD6,J9K2Z4,A0A2J7Q8V4,T1IBM6,V3ZRX0,A0A210QKF7,K1PT78,A0A267E8R7,A0A1D2N447,A0A226D7A9,F6YK55,A0A2C9JGZ6,A0A3Q0KUG5,T1FY40,1YVU,1Z26,5G5T,7R8K,A0A1I3LMA1,K9TPA9,A0A1C0UUC4,A0A2Z6E1D5,A0A0F4NXW8,L8D0R3,A0A3D8L290,K9U8J6,K9RC91,A0A139XGN8,Q5P0R2,A0A2T1G8M7,K9VUN0,A0A2Z6E0R7,A0A1N6SSK9,A0A0P4UVI8,A0A0V7ZCG4,A0A1J0AGK2,A0A060HNJ0,A0A235B542,A0A1H3LE92,A0A062U2W9,H0HWQ5,A0A1V9G9U4,A0A0Q2M2Z1,H8KXJ0,A0A139WY18,A0A1J1EK56,A0A2T1E1K4,A0A1Q8ZD62,Q53W94,A0A1N6LUI7,E0UCX3,K9XZC6,C1F5Q7,A0A4R3EV39,A0A1P8WP90,A0A329TD61,A0A1H3DGN3,A0A2S9Q9J0,A0A4Q2UIU6,H1YCU5,L0JS08,A0A1Q5ZS75,A0A345E7N0,M0AF24,A0A1H3X247,M0D2X3,A0A346PK63,A0A1C3ZXN2,B9LVP8,F8D8G0,A0A343TL88,A0A2A5QS34,A0A343JEE2,A0A3P3RGE5,A0A329TBQ3,A0A285N2A8,A0A0W1S8B8,A0A1V4C8L7,L9VRQ2,E4NRV1,A0A1I6HGN0,,",366,37
"305","C.H10.1","C.H9.12",262,130,132,1.61398601398601,"4F1N,4KRE,5GUH,5VM9,7KX7,Q389P5,C4LVV2,A8BCK6,A2DPV7,A0A0G4H2S4,D2VMG4,A0A074TLL7,A0A0D1ZAJ4,Q1K660,F4PH46,A0A3M7S814,A0A164ZA52,Q54G64,I0YVB2,A0A2C5Z0M1,A0CB11,R9ACY5,A0A1Z5TVE5,W7XD45,A0A1U7LLR0,A0A4S2MWZ7,A0A158P1R9,V6R0U9,G4N9J3,B7Q5I1,U4LBG4,A0A177URI1,O74957,A0A3N4IGK1,A6N7Y9,T1KZ60,A0A2G8JLH3,Q5KAT1,W2T741,A0A2J7QB22,S4RYE2,A0A388KES6,A0A226EFL3,A0A3S3PD82,A0A1S3J512,G0QTT2,A0A1J1HRI1,C4V9J2,Q9JMB7,A0A075AN09,Q5TW24,A0A401PRI6,Q96J94,A0A2B4RHN2,G2QEV0,A0A2T7PFL8,K7ISV0,H3HCL6,A0A0G4IME3,E9FUN9,A0A1S3CYL5,A0A1Y1YHC8,A0A1D8PMK0,A0A2G5B1D8,A0A1C7M8P2,A0A4D8YSQ3,A0A158PJG6,J9JZ66,A0A0C2XG51,A0A158QZT6,T0SAU8,A0A3S1A0C3,A0A2K1J482,A0A1Q3ENA6,O04379,A0A371I3C8,M8AEW7,A8P0D4,A0A2K3NY65,F4NYW7,A0A409Y6G2,D8PZT7,A0A1D1W4K0,W4YU94,D8SNM6,A0A1J8PPA3,X1WG39,Q69VD5,A0A2R6NSC2,A0A0D8XL16,A0A016WPN3,Q9QZ81,G5EES3,A0A0K0EFP6,V2WTL2,A0A0V0YLH8,A0A139WDH0,H3DS31,A0A1Y1HWP2,G4T5G9,B7QCC4,A0A0B2UV00,M7BCJ9,E9GN30,Q7PZ41,A0A077Z361,R7U9I3,A0A0K0JDP1,A0A0N4UKJ1,A0A498N3A3,A0A3M0IQP5,A0A0L8GBV4,Q32KD4,A0A1J1JBJ0,E0W4C3,A0A482XDA9,A0A3P7EJD6,J9K2Z4,A0A2J7Q8V4,T1IBM6,A0A210QKF7,K1PT78,A0A267E8R7,A0A226D7A9,F6YK55,T1KTE4,A0A2C9JGZ6,K5X5Z7,A0A3Q0KUG5,T1FY40,1Z26,5AWH,5G5T,5I4A,7R8K,A0A1I7IXT4,A0A2W1JZ37,A0A2S7WBN3,A0A328VKE4,A0A420DFE6,A0A4V1VDY2,A0A368P5I0,C4L1M1,A0A4R1RMM2,A0A1Y2RDH8,A0A1M5ZSR3,A0A0K8QX04,A0A0M2PXX3,A0A1L3JHM3,A0A1W6MIP2,A0A1C0UUC4,A0A2U2J9E0,B1XJG0,A0A3D8L290,A0A1Q4R485,A0A097QRL6,Q5P0R2,B6YTQ5,A0A0B0H9B4,R6KUL9,K9UQR0,B7GJX9,A0A2Z6E0R7,A0A1N6SSK9,A0A2G9DT08,K9UEV4,Q9L1X1,A0A060HNJ0,A0A235B542,R5XQK4,A0A1H3LE92,A0A496APJ8,A0A062U2W9,H0HWQ5,A0A1V9G9U4,A0A1I2ZGP1,A0A317EJY3,A0A1I2BD20,F8ERC7,A0A1A5X8H4,A0A1I2T6Q1,A0A1R3T9N6,A0A0Q2M2Z1,H8KXJ0,A0A2D1U4H7,A0A0B7I4Z6,A0LL61,A0A139WY18,A0A2T1E1K4,A0A1Q8ZD62,A0A4Q6XKV6,A0A1Z3HNN4,A0A239JE83,A0A2N4XBY2,R5JEI2,A0A0Q0ZC47,A0A2T0XH18,A0A1V4CHV0,A0A1K1RQP7,A0A1N6LUI7,A0A0P0NGR6,A0A1X7IML5,A0A0A2LKJ7,K1L112,A0A0U3AL92,A0A1H3A054,E0UCX3,K9XZC6,A0A0C1VHB4,A0A0C5JKF3,R5NJJ8,A5D4D9,A0A142Y7A9,A0A432MEQ5,A0A372DKU2,A0A3R7KLK4,C1F5Q7,A0A1P8WP90,A0A222F7P0,A0A1C9VH88,A0A2T2YMB1,A0A329TD61,A0A101R2A0,A0A1E3XF49,A0A1H3DGN3,A0A1Q1FPH0,A0A259TUP4,F6EYI8,A0A2S9Q9J0,A0A4Q2UIU6,A0A1H0LH25,A0A318LG42,H1YCU5,L0JS08,A0A1Q5ZS75,A0A345E7N0,M0AF24,A0A1W2A082,A0A1H3X247,A0A0C1XUA0,M0D2X3,A0A2R5G167,A0A346PK63,R7RTW6,A0A1H2RBI2,A0A1C3ZXN2,B9LVP8,M5RSF0,W0JW77,B7K585,F8D8G0,A0A343TL88,L0AJX6,A0A2A5QS34,A0A343JEE2,A0A3P3RGE5,A0A329TBQ3,A0A285N2A8,A0A0W1S8B8,L9VRQ2,E4NRV1,A0A1I6HGN0,,",366,37
"306","C.H9.10","C.L21.15",257,130,127,2.98891580860085,"4F3T,4KRE,5GUH,5VM9,6KR6,6OON,A0A163JTZ6,A0A0N4X8S8,Q389P5,C4LVV2,A2DPV7,A0A074TLL7,A0A0D1ZAJ4,Q1K660,F4PH46,A0A3M7S814,A0A164ZA52,A0A2C5Z0M1,A0CB11,R9ACY5,D3BMP8,A0A1Z5TVE5,W7XD45,A0A4S2MWZ7,A0A158P1R9,G7DVX0,V6R0U9,G4N9J3,E3KLI3,A0A1E3QC61,D5GGK8,S8ANP9,A0A139AUH8,L2GMR6,U4LBG4,O74957,A0A3N4IGK1,A6N7Y9,A0A0E9NDK5,T1KZ60,A0A250WXN5,A0A2G8JLH3,L2GUF2,W2T741,A0A1W0E4B5,A0A2J7QB22,S4RYE2,A0A2K3CW87,A0A0L0TEV1,A0A1S3J512,G0QTT2,A0A1J1HRI1,C4V9J2,Q9JMB7,U5HIG6,A0A401PRI6,Q96J94,A0A2B4RHN2,A0A397UU01,A0A2T7PFL8,K7ISV0,A0A024FT57,H3HCL6,A0A0G4IME3,A0A1S3CYL5,D7FQK3,A0A1Y1YHC8,T1GSU4,F4S231,A0A1D8PMK0,A0A2G5B1D8,A0A158PJG6,J9JZ66,A0A158QZT6,A0A165QYQ9,A0A3S1A0C3,F4NYW7,A0A0L0HAB7,A0A1D1W4K0,A7RQ46,W4YU94,A7BJS5,X1WG39,M5FQK2,A0A0D8XL16,A0A016WPN3,Q9QZ81,G5EES3,A0A0K0EFP6,Q8CJG0,A0A1D5NTU6,A0A0V0YLH8,A0A139WDH0,A0A0R3W9Q7,H3DS31,A0A1Y1HWP2,B7QCC4,A0A0B2UV00,M7BCJ9,E9GN30,Q7PZ41,A0A077Z361,R7U9I3,A0A1X7V1N5,A0A0K0JDP1,A0A0N4UKJ1,A0A498N3A3,A0A3M0IQP5,A0A0L8GBV4,Q32KD4,A0A1J1JBJ0,E0W4C3,A0A482XDA9,A0A3P7EJD6,J9K2Z4,A0A2J7Q8V4,T1IBM6,V3ZRX0,A0A210QKF7,A0A423TSS1,K1PT78,A0A267E8R7,A0A1D2N447,A0A226D7A9,F6YK55,T1KTE4,A0A2C9JGZ6,A0A1V9X9F0,A0A3Q0KUG5,T1FY40,1YVU,5AWH,6QZK,7R8K,A0A1I7IXT4,A0A2W1JZ37,A0A2S7WBN3,A0A328VKE4,A0A420DFE6,A0A4V1VDY2,A0A368P5I0,C4L1M1,A0A4R1RMM2,A0A1Y2RDH8,Q11QW7,A0A1M5ZSR3,A0A1L3JHM3,A0A1W6MIP2,A0A2U2J9E0,A0A2Z6E1D5,A0A0F4NXW8,L8D0R3,A0A3D8L290,A0A139XGN8,A0A1T4Y3A2,Q5P0R2,A0A0B0H9B4,R6KUL9,K9UQR0,B7GJX9,A0A0P6X5X2,A0A2Z6E0R7,A0A1N6SSK9,A0A2G9DT08,Q9L1X1,A0A060HNJ0,R5XQK4,A0A1H3LE92,A0A496APJ8,A0A062U2W9,H0HWQ5,A0A1V9G9U4,A0A1I2ZGP1,A0A317EJY3,A0A1I2BD20,F8ERC7,S7VLM7,A0A1A5X8H4,A0A1R3T9N6,H8KXJ0,A0A2D1U4H7,A0A0B7I4Z6,A0LL61,A0A139WY18,A0A1J1EK56,A0A2T1E1K4,A0A1Q8ZD62,A0A4Q6XKV6,A0A1Z3HNN4,A0A239JE83,A0A2N4XBY2,Q53W94,R5JEI2,A0A0Q0ZC47,A0A2T0XH18,A0A1V4CHV0,A0A1K1RQP7,A0A1N6LUI7,A0A0P0NGR6,A0A1X7IML5,A0A0A2LKJ7,K1L112,A0A0U3AL92,A0A1H3A054,A0A0C5JKF3,R5NJJ8,A5D4D9,A0A432MEQ5,A0A372DKU2,A0A3R7KLK4,C1F5Q7,A0A4R3EV39,A0A1P8WP90,A0A222F7P0,A0A1C9VH88,A0A2T2YMB1,A0A329TD61,A0A101R2A0,A0A1E3XF49,A0A1U9ND56,A0A4R7BQC4,A0A1H3DGN3,A0A1Q1FPH0,E0TGY3,A0A259TUP4,F6EYI8,A0A2S9Q9J0,A0A4Q2UIU6,A0A1H0LH25,A0A318LG42,H1YCU5,L0JS08,A0A1Q5ZS75,M0AF24,A0A1W2A082,A0A1H3X247,A0A0C1XUA0,M0D2X3,A0A2R5G167,A0A346PK63,R7RTW6,A0A1H2RBI2,A0A1C3ZXN2,M5RSF0,W0JW77,B7K585,A0A343TL88,L0AJX6,A0A2A5QS34,A0A343JEE2,A0A3P3RGE5,A0A329TBQ3,A0A0W1S8B8,L9VRQ2,E4NRV1,A0A1I6HGN0,A0A1I0NI68,,",366,37
"308","C.S13.1","C.S14.3",184,130,54,1.61153846153846,"4F1N,4F3T,4KRE,5GUH,5VM9,6KR6,6OON,7SWF,A0A196SDB4,C4LVV2,R1FDF0,A0A074TLL7,A0A0D1ZAJ4,Q1K660,A0A3M7S814,A0A164ZA52,Q54G64,I0YVB2,R7QGN7,A0A2C5Z0M1,A0CB11,R9ACY5,D3BMP8,A0A1Z5TVE5,W7XD45,A0A1U7LLR0,A0A4S2MWZ7,A0A158P1R9,G7DVX0,V6R0U9,G4N9J3,E3KLI3,B7Q5I1,D5GGK8,A0A139AUH8,U4LBG4,O74957,A0A3N4IGK1,A0A0E9NDK5,T1KZ60,A0A250WXN5,Q5KAT1,L2GUF2,W2T741,A0A2J7QB22,S4RYE2,A0A2K3CW87,A0A226EFL3,A0A3S3PD82,A0A0L0TEV1,A0A1S3J512,G0QTT2,A0A1J1HRI1,Q9JMB7,Q5TW24,A0A401PRI6,Q96J94,G2QEV0,A0A2T7PFL8,K7ISV0,A0A0G4IME3,E9FUN9,A0A1Y1YHC8,T1GSU4,F4S231,A0A1D8PMK0,Q5BD61,A0A1C7M8P2,A0A158PJG6,A0A0C2XG51,A0A158QZT6,A0A165QYQ9,T0SAU8,R7YY92,A0A3S1A0C3,A0A074YJ47,A0A1Q3ENA6,A8P0D4,F4NYW7,A0A409Y6G2,A0A0L0HAB7,D8PZT7,W4YU94,A7BJS5,A0A1J8PPA3,X1WG39,M5FQK2,A0A2R6NSC2,A0A0D8XL16,A0A016WPN3,G5EES3,A0A0K0EFP6,Q8CJG0,A0A1D5NTU6,V2WTL2,A0A0V0YLH8,A0A139WDH0,A0A0R3W9Q7,H3DS31,A0A1Y1HWP2,G4T5G9,B7QCC4,A0A0B2UV00,M7BCJ9,Q7PZ41,A0A077Z361,R7U9I3,A0A1X7V1N5,A0A0K0JDP1,A0A0N4UKJ1,A0A3M0IQP5,Q32KD4,A0A1J1JBJ0,E0W4C3,A0A482XDA9,A0A3P7EJD6,J9K2Z4,A0A2J7Q8V4,T1IBM6,V3ZRX0,A0A423TSS1,K1PT78,A0A267E8R7,A0A1D2N447,A0A226D7A9,F6YK55,T1KTE4,A0A1V9X9F0,K5X5Z7,T1FY40,6QZK,E8N0K8,A0A2Z6E1D5,A0A1Q4R485,A0A097QRL6,A0A1T4Y3A2,Q5P0R2,A0A2T1G8M7,A0A062U2W9,A0A1V9G9U4,A0A1I2BD20,S7VLM7,A0A1A5X8H4,A0A1R3T9N6,A0A0Q2M2Z1,H8KXJ0,A0A2D1U4H7,A0A139WY18,A0A2T1E1K4,A0A1Q8ZD62,A0A4Q6XKV6,R5JEI2,A0A1V4CHV0,A0A0P0NGR6,A0A1X7IML5,R5NJJ8,A0A432MEQ5,A0A3R7KLK4,C1F5Q7,A0A1P8WP90,A0A222F7P0,A0A2T2YMB1,A0A1U9ND56,A0A1Q1FPH0,E0TGY3,A0A259TUP4,F6EYI8,A0A1H0LH25,A0A318LG42,A0A1H3X247,A0A2R5G167,A0A346PK63,B9LVP8,M5RSF0,B7K585,F8D8G0,A0A343TL88,A0A3P3RGE5,A0A329TBQ3,A0A0W1S8B8,A0A1V4C8L7,E4NRV1,A0A1I6HGN0,A0A1I0NI68,,",366,37
"312","C.H5.15","C.L28.1",217,131,86,1.82922066394461,"4F3T,5VM9,6KR6,7SWF,A0A163JTZ6,A0A196SDB4,J9D5G4,Q389P5,A8BCK6,A2DPV7,A0A0G4H2S4,D2VMG4,A0A0D1ZAJ4,Q1K660,F4PH46,A0A3M7S814,Q54G64,I0YVB2,R7QGN7,A0A2C5Z0M1,D3BMP8,W7XD45,A0A1U7LLR0,K1VVQ6,A0A158P1R9,V6R0U9,G4N9J3,B7Q5I1,L2GMR6,U4LBG4,A0A177URI1,O74957,A0A3N4IGK1,A6N7Y9,A0A0E9NDK5,T1KZ60,A0A2G8JLH3,L2GUF2,W2T741,A0A1W0E4B5,A0A2J7QB22,S4RYE2,A0A388KES6,A0A226EFL3,A0A3S3PD82,A0A1S3J512,G0QTT2,C4V9J2,Q9JMB7,A0A075AN09,Q5TW24,U5HIG6,A0A401PRI6,Q96J94,A0A2B4RHN2,A0A397UU01,A0A2T7PFL8,K7ISV0,A0A024FT57,A0A0G4IME3,E9FUN9,A0A1S3CYL5,A0A1Y1YHC8,A0A4D8YSQ3,A0A158PJG6,J9JZ66,A0A0C2XG51,T0SAU8,A0A2K1J482,A0A1Q3ENA6,O04379,M8AEW7,A0A2K3NY65,F4NYW7,A0A409Y6G2,A0A0L0HAB7,A0A1D1W4K0,W4YU94,A7BJS5,D8SNM6,A0A1J8PPA3,X1WG39,M5FQK2,Q69VD5,A0A0D8XL16,A0A016WPN3,Q9QZ81,G5EES3,A0A0K0EFP6,Q8CJG0,A0A1D5NTU6,A0A0V0YLH8,A0A139WDH0,A0A0R3W9Q7,H3DS31,A0A1Y1HWP2,G4T5G9,B7QCC4,A0A0B2UV00,M7BCJ9,E9GN30,Q7PZ41,A0A077Z361,R7U9I3,A0A1X7V1N5,A0A0K0JDP1,A0A0N4UKJ1,A0A498N3A3,A0A3M0IQP5,A0A0L8GBV4,Q32KD4,A0A1J1JBJ0,E0W4C3,A0A482XDA9,A0A3P7EJD6,J9K2Z4,A0A2J7Q8V4,T1IBM6,V3ZRX0,A0A210QKF7,A0A423TSS1,A0A267E8R7,A0A1D2N447,A0A226D7A9,F6YK55,T1KTE4,A0A2C9JGZ6,A0A1V9X9F0,K5X5Z7,A0A3Q0KUG5,T1FY40,1YVU,5AWH,5I4A,6QZK,A0A0M2PXX3,K9TPA9,A0A1C0UUC4,B1XJG0,A0A3D8L290,K9U8J6,K9RC91,A0A0D8ZUC0,A0A139XGN8,A0A1T4Y3A2,A0A0B0H9B4,A0YYT3,A0A2T1EFY0,G6FTN0,R6KUL9,A0A433NB65,A0A1Z4L0A1,K9UQR0,A0A2T1G8M7,K9VUN0,K9ZDE3,B0JXD6,A0A2T1LS63,A0A1Z4K1Y3,A0A0P4UVI8,A0A0V7ZCG4,A0A1J0AGK2,A0A2G9DT08,Q9L1X1,A0A060HNJ0,A0A235B542,A0A1H3LE92,A0A496APJ8,A0A1I2T6Q1,A0A1R3T9N6,H8KXJ0,A0A2D1U4H7,A0A0B7I4Z6,A0LL61,A0A139WY18,A0A1J1EK56,A0A2T1E1K4,A0A1Q8ZD62,A0A4Q6XKV6,A0A239JE83,A0A2N4XBY2,Q53W94,R5JEI2,A0A0Q0ZC47,A0A2T0XH18,A0A1K1RQP7,A0A0P0NGR6,A0A1X7IML5,A0A0A2LKJ7,K1L112,A0A0U3AL92,A0A1H3A054,E0UCX3,K9XZC6,A0A0C1VHB4,A0A0C5JKF3,R5NJJ8,A5D4D9,A0A432MEQ5,A0A372DKU2,C1F5Q7,A0A4R3EV39,A0A222F7P0,A0A1C9VH88,A0A2T2YMB1,A0A101R2A0,A0A1U9ND56,A0A4R7BQC4,E0TGY3,F6EYI8,A0A1H0LH25,A0A2R5G167,R7RTW6,M5RSF0,W0JW77,L0AJX6,A0A343JEE2,,",366,37
"313","C.L20.6","N.S12.6",218,131,87,2.49863999298061,"4F3T,4KRE,5GUH,6KR6,6OON,7KX7,A0A0N4X8S8,A0A196SDB4,J9D5G4,Q389P5,A0A2P6N8X7,A8BCK6,A0A0G4H2S4,T1H8B3,R1FDF0,S4RWI0,D2VMG4,F4PH46,A0A3M7S814,A0A383WDW5,Q54G64,I0YVB2,A0CB11,D3BMP8,G7DVX0,B7Q5I1,A0A1E3QC61,D5GGK8,S8ANP9,A0A139AUH8,L2GMR6,A6N7Y9,A0A250WXN5,A0A2G8JLH3,W2T741,A0A1W0E4B5,A0A2J7QB22,S4RYE2,A0A2K3CW87,A0A388KES6,A0A226EFL3,A0A1S3J512,G0QTT2,A0A1J1HRI1,Q9JMB7,Q5TW24,A0A401PRI6,Q96J94,G2QEV0,A0A397UU01,A0A2T7PFL8,K7ISV0,A0A024FT57,H3HCL6,E9FUN9,A0A1S3CYL5,D7FQK3,A0A1Y1YHC8,T1GSU4,A0A1D8PMK0,A0A2G5B1D8,Q5BD61,A0A1C7M8P2,A0A4D8YSQ3,A0A158PJG6,J9JZ66,A0A0C2XG51,A0A158QZT6,A0A165QYQ9,T0SAU8,R7YY92,A0A3S1A0C3,A0A2K1J482,O04379,A0A371I3C8,M8AEW7,A0A2K3NY65,F4NYW7,A0A0L0HAB7,A0A1D1W4K0,A7RQ46,W4YU94,A7BJS5,D8SNM6,X1WG39,M5FQK2,Q69VD5,A0A2R6NSC2,A0A0D8XL16,A0A016WPN3,Q9QZ81,G5EES3,A0A0K0EFP6,Q8CJG0,A0A1D5NTU6,A0A0V0YLH8,A0A139WDH0,A0A0R3W9Q7,H3DS31,A0A1Y1HWP2,B7QCC4,A0A0B2UV00,M7BCJ9,E9GN30,Q7PZ41,A0A077Z361,R7U9I3,A0A1X7V1N5,A0A0K0JDP1,A0A0N4UKJ1,A0A498N3A3,A0A3M0IQP5,A0A0L8GBV4,Q32KD4,A0A1J1JBJ0,A0A3P7EJD6,J9K2Z4,A0A2J7Q8V4,T1IBM6,A0A210QKF7,A0A423TSS1,K1PT78,A0A267E8R7,A0A1D2N447,A0A226D7A9,F6YK55,T1KTE4,A0A2C9JGZ6,K5X5Z7,A0A3Q0KUG5,T1FY40,1YVU,1Z26,3DLB,7R8K,C4L1M1,A0A0M2PXX3,A0A1I3LMA1,K9TPA9,A0A1C0UUC4,B1XJG0,A0A3D8L290,A0A1T4Y3A2,A0A0B0H9B4,R6KUL9,B7GJX9,A0A060HNJ0,A0A235B542,R5XQK4,A0A1H3LE92,A0A496APJ8,A0A062U2W9,H0HWQ5,A0A1V9G9U4,A0A1I2ZGP1,A0A317EJY3,A0A1I2BD20,F8ERC7,A0A0Q2M2Z1,D3S0S6,I3TE64,A0A0B7I4Z6,A0LL61,Q8DKB1,A0A139WY18,A0A1J1EK56,A0A2T1E1K4,A0A1Q8ZD62,A0A4Q6XKV6,A0A1Z3HNN4,A0A239JE83,A0A2N4XBY2,Q53W94,R5JEI2,A0A0Q0ZC47,A0A2T0XH18,A0A1K1RQP7,A0A2T1EKT1,A0A1N6LUI7,A0A0P0NGR6,A0A1X7IML5,A0A0A2LKJ7,K1L112,A0A0U3AL92,A0A1H3A054,B9LVW4,A0A0C1VHB4,Q31N05,A0A0C5JKF3,A5D4D9,Q2JI93,A0A142Y7A9,A0A372DKU2,A0A3R7KLK4,A0A4R3EV39,A0A1C9VH88,A0A2T2YMB1,A0A1U9ND56,A0A4R7BQC4,A0A1H3DGN3,E0TGY3,A0A259TUP4,A0A4Q2UIU6,H1YCU5,A0A1Q5ZS75,A0A345E7N0,M0AF24,A0A1W2A082,A0A1H3X247,M0D2X3,A0A1H2RBI2,A0A1C3ZXN2,B9LVP8,W0JW77,F8D8G0,A0A2A5QS34,A0A285N2A8,A0A1I0NI68,,",366,37
"320","C.S11.5","C.S12.7",196,132,64,1.68844696969697,"4F3T,4KRE,5GUH,5VM9,6KR6,6OON,A0A163JTZ6,A0A196SDB4,J9D5G4,C4LVV2,A0A2P6N8X7,A2DPV7,A0A0G4H2S4,D2VMG4,F4PH46,A0A3M7S814,Q54G64,I0YVB2,A0CB11,D3BMP8,A0A4S2MWZ7,K1VVQ6,A0A158P1R9,E3KLI3,A0A1E3QC61,D5GGK8,A0A139AUH8,U4LBG4,A0A3N4IGK1,A6N7Y9,T1KZ60,A0A2G8JLH3,Q5KAT1,A0A2J7QB22,A0A226EFL3,A0A3S3PD82,A0A0L0TEV1,A0A1S3J512,G0QTT2,A0A1J1HRI1,Q9JMB7,A0A075AN09,Q5TW24,U5HIG6,A0A401PRI6,Q96J94,A0A2B4RHN2,G2QEV0,A0A397UU01,A0A2T7PFL8,K7ISV0,A0A024FT57,H3HCL6,A0A0G4IME3,E9FUN9,A0A1S3CYL5,D7FQK3,A0A1Y1YHC8,T1GSU4,F4S231,A0A1D8PMK0,Q5BD61,A0A1C7M8P2,A0A158PJG6,J9JZ66,A0A0C2XG51,A0A158QZT6,A0A165QYQ9,T0SAU8,R7YY92,A0A3S1A0C3,A0A074YJ47,A0A1Q3ENA6,A8P0D4,F4NYW7,A0A409Y6G2,A0A0L0HAB7,D8PZT7,A0A1D1W4K0,A7RQ46,W4YU94,A7BJS5,A0A1J8PPA3,X1WG39,M5FQK2,A0A2R6NSC2,A0A0D8XL16,A0A016WPN3,Q9QZ81,G5EES3,A0A0K0EFP6,Q8CJG0,A0A1D5NTU6,V2WTL2,A0A0V0YLH8,A0A139WDH0,A0A0R3W9Q7,H3DS31,G4T5G9,B7QCC4,A0A0B2UV00,M7BCJ9,Q7PZ41,A0A077Z361,R7U9I3,A0A1X7V1N5,A0A0K0JDP1,A0A0N4UKJ1,A0A498N3A3,A0A3M0IQP5,A0A0L8GBV4,Q32KD4,A0A1J1JBJ0,E0W4C3,A0A482XDA9,A0A3P7EJD6,J9K2Z4,A0A2J7Q8V4,T1IBM6,V3ZRX0,A0A210QKF7,A0A423TSS1,K1PT78,A0A1D2N447,A0A226D7A9,F6YK55,T1KTE4,A0A2C9JGZ6,A0A1V9X9F0,K5X5Z7,A0A3Q0KUG5,T1FY40,1YVU,5G5T,A0A1I7IXT4,A0A2W1JZ37,A0A2S7WBN3,A0A420DFE6,A0A4V1VDY2,A0A368P5I0,C4L1M1,Q11QW7,A0A1L3JHM3,A0A1W6MIP2,A0A2U2J9E0,A0A326U7G5,A0A3D8L290,K9RC91,R6KUL9,A0A1Z4L0A1,K9VUN0,K9ZDE3,A0A1J0AGK2,K9PFF9,K9UEV4,A0A1V9G9U4,A0A1R3T9N6,A0A0Q2M2Z1,H8KXJ0,D3S0S6,A0A2D1U4H7,A0A0B7I4Z6,Q8DKB1,A0A2T1E1K4,A0A4Q6XKV6,A0A239JE83,R5JEI2,A0A0Q0ZC47,A0A2T0XH18,A0A1K1RQP7,A0A2T1EKT1,A0A0P0NGR6,A0A1X7IML5,A0A0A2LKJ7,K1L112,Q31N05,A0A0C5JKF3,A5D4D9,Q2JI93,A0A1P8WP90,A0A1C9VH88,A0A1U9ND56,A0A4R7BQC4,A0A1Q1FPH0,A0A259TUP4,F6EYI8,A0A2S9Q9J0,H1YCU5,A0A1H3X247,A0A0C1XUA0,B9LVP8,W0JW77,L0AJX6,A0A2A5QS34,A0A343JEE2,A0A1V4C8L7,,",366,37
"327","C.H5.12","C.S5.1",241,133,108,1.61239905318853,"4F1N,4F3T,4KRE,5GUH,5VM9,6KR6,6OON,7KX7,7SWF,J9D5G4,Q389P5,C4LVV2,A2DPV7,S4RWI0,D2VMG4,A0A074TLL7,F4PH46,A0A3M7S814,A0A164ZA52,A0A383WDW5,Q54G64,R7QGN7,C1DZY0,A0CB11,D3BMP8,A0A1Z5TVE5,W7XD45,A0A1U7LLR0,A0A158P1R9,V6R0U9,G4N9J3,A0A1E3QC61,D5GGK8,L2GMR6,A0A177URI1,A0A3N4IGK1,A0A0E9NDK5,A0A2G8JLH3,W2T741,A0A1W0E4B5,A0A2J7QB22,S4RYE2,A0A2K3CW87,A0A388KES6,A0A226EFL3,A0A3S3PD82,A0A0L0TEV1,C4V9J2,Q9JMB7,A0A075AN09,Q5TW24,A0A401PRI6,Q96J94,A0A2T7PFL8,H3HCL6,A0A0G4IME3,E9FUN9,A0A1S3CYL5,D7FQK3,F4S231,A0A1D8PMK0,Q5BD61,A0A4D8YSQ3,A0A158PJG6,J9JZ66,A0A158QZT6,T0SAU8,R7YY92,A0A3S1A0C3,A0A074YJ47,A0A2K1J482,A0A1Q3ENA6,O04379,A0A371I3C8,M8AEW7,A0A2K3NY65,A0A409Y6G2,A0A0L0HAB7,D8PZT7,A0A1D1W4K0,A7RQ46,W4YU94,A7BJS5,D8SNM6,X1WG39,M5FQK2,A0A2R6NSC2,A0A0D8XL16,A0A016WPN3,Q9QZ81,G5EES3,A0A0K0EFP6,Q8CJG0,A0A1D5NTU6,A0A0V0YLH8,A0A139WDH0,A0A0R3W9Q7,H3DS31,G4T5G9,B7QCC4,A0A0B2UV00,M7BCJ9,E9GN30,Q7PZ41,A0A077Z361,R7U9I3,A0A1X7V1N5,A0A0K0JDP1,A0A0N4UKJ1,A0A498N3A3,A0A3M0IQP5,A0A0L8GBV4,Q32KD4,A0A1J1JBJ0,E0W4C3,A0A482XDA9,A0A3P7EJD6,J9K2Z4,A0A2J7Q8V4,T1IBM6,V3ZRX0,A0A210QKF7,A0A423TSS1,K1PT78,A0A267E8R7,A0A1D2N447,A0A226D7A9,F6YK55,T1KTE4,A0A2C9JGZ6,A0A1V9X9F0,A0A3Q0KUG5,T1FY40,1YVU,3DLB,5G5T,5I4A,A0A328VKE4,E0ST67,A0A0M2PXX3,A0A1I3LMA1,A0A1C0UUC4,A0A2Z6E1D5,A0A0F4NXW8,B1XJG0,A0A3D8L290,H1KXR6,K9U8J6,K9RC91,A0A0D8ZUC0,A0A139XGN8,A0A1T4Y3A2,Q5P0R2,A0YYT3,A0A2T1EFY0,G6FTN0,A0A433NB65,K9UQR0,K9VUN0,A0A0P6X5X2,K9ZDE3,B0JXD6,A0A2T1LS63,A0A2Z6E0R7,A0A0P4UVI8,A0A0V7ZCG4,A0A2G9DT08,K9UEV4,Q9L1X1,A0A060HNJ0,A0A235B542,A0A1H3LE92,A0A496APJ8,S7VLM7,A0A1A5X8H4,A0A1I2T6Q1,A0A1R3T9N6,A0A0Q2M2Z1,D3S0S6,I3TE64,Q8DKB1,A0A1J1EK56,A0A1Q8ZD62,A0A4Q6XKV6,A0A1Z3HNN4,A0A239JE83,A0A2N4XBY2,Q53W94,R5JEI2,A0A2T0XH18,A0A1V4CHV0,A0A2T1EKT1,A0A1N6LUI7,A0A0P0NGR6,A0A1X7IML5,A0A0A2LKJ7,K1L112,A0A0U3AL92,A0A1H3A054,E0UCX3,K9XZC6,A0A0C1VHB4,Q31N05,A0A0C5JKF3,A5D4D9,Q2JI93,A0A142Y7A9,A0A432MEQ5,A0A372DKU2,A0A3R7KLK4,C1F5Q7,A0A4R3EV39,A0A1P8WP90,A0A222F7P0,A0A1C9VH88,A0A101R2A0,A0A1U9ND56,A0A4R7BQC4,A0A1H3DGN3,A0A259TUP4,F6EYI8,A0A2S9Q9J0,A0A4Q2UIU6,A0A1H0LH25,A0A318LG42,L0JS08,M0AF24,A0A1W2A082,M0D2X3,R7RTW6,A0A1H2RBI2,M5RSF0,W0JW77,F8D8G0,L0AJX6,A0A343JEE2,A0A3P3RGE5,A0A329TBQ3,A0A285N2A8,A0A1V4C8L7,A0A1I0NI68,,",366,37
"332","N.H8.9","N.L2.1",172,133,39,1.20426065162907,"4F3T,5GUH,6KR6,7SWF,Q389P5,C4LVV2,A2DPV7,T1H8B3,R1FDF0,S4RWI0,D2VMG4,A0A0D1ZAJ4,Q1K660,F4PH46,A0A164ZA52,Q54G64,C1DZY0,A0A2C5Z0M1,A0CB11,D3BMP8,W7XD45,A0A1U7LLR0,A0A4S2MWZ7,K1VVQ6,A0A158P1R9,V6R0U9,G4N9J3,E3KLI3,B7Q5I1,A0A1E3QC61,D5GGK8,S8ANP9,U4LBG4,A0A3N4IGK1,A6N7Y9,A0A0E9NDK5,T1KZ60,A0A2G8JLH3,Q5KAT1,A0A2J7QB22,A0A226EFL3,A0A3S3PD82,A0A0L0TEV1,A0A1S3J512,A0A1J1HRI1,A0A075AN09,Q5TW24,U5HIG6,A0A401PRI6,A0A397UU01,A0A2T7PFL8,K7ISV0,H3HCL6,A0A0G4IME3,E9FUN9,A0A1Y1YHC8,T1GSU4,F4S231,A0A1D8PMK0,A0A2G5B1D8,Q5BD61,A0A4D8YSQ3,A0A158PJG6,J9JZ66,A0A0C2XG51,A0A158QZT6,A0A165QYQ9,T0SAU8,A0A3S1A0C3,A0A2K1J482,A0A1Q3ENA6,O04379,A0A371I3C8,M8AEW7,A0A2K3NY65,F4NYW7,A0A409Y6G2,A0A0L0HAB7,A0A1D1W4K0,A7RQ46,W4YU94,A7BJS5,D8SNM6,A0A1J8PPA3,X1WG39,M5FQK2,Q69VD5,A0A0D8XL16,A0A016WPN3,Q9QZ81,G5EES3,A0A0K0EFP6,Q8CJG0,A0A1D5NTU6,A0A0V0YLH8,A0A139WDH0,A0A0R3W9Q7,H3DS31,G4T5G9,B7QCC4,A0A0B2UV00,M7BCJ9,E9GN30,Q7PZ41,A0A077Z361,R7U9I3,A0A1X7V1N5,A0A0K0JDP1,A0A0N4UKJ1,A0A498N3A3,A0A3M0IQP5,A0A0L8GBV4,Q32KD4,A0A1J1JBJ0,E0W4C3,A0A482XDA9,A0A3P7EJD6,J9K2Z4,A0A2J7Q8V4,T1IBM6,V3ZRX0,A0A210QKF7,A0A423TSS1,K1PT78,A0A267E8R7,A0A1D2N447,A0A226D7A9,F6YK55,T1KTE4,A0A2C9JGZ6,A0A1V9X9F0,A0A3Q0KUG5,T1FY40,1YVU,1Z26,5I4A,6QZK,A0A1I3LMA1,A0A0B0H9B4,R6KUL9,B7GJX9,A0A1N6SSK9,A0A235B542,A0A1I2BD20,F8ERC7,A0A0Q2M2Z1,H8KXJ0,A0A2D1U4H7,A0A0U3AL92,A0A1H3A054,R5NJJ8,A5D4D9,A0A372DKU2,C1F5Q7,A0A1U9ND56,A0A4R7BQC4,A0A1Q1FPH0,A0A1H0LH25,A0A318LG42,H1YCU5,A0A1Q5ZS75,A0A2R5G167,R7RTW6,A0A1C3ZXN2,B7K585,A0A343TL88,A0A343JEE2,A0A3P3RGE5,A0A329TBQ3,A0A285N2A8,A0A0W1S8B8,L9VRQ2,,",366,37
"335","N.S3.5","N.S5.1",221,133,88,2.06771189336979,"4F1N,4F3T,5GUH,7KX7,7SWF,A0A0N4X8S8,Q389P5,A0A2P6N8X7,A2DPV7,T1H8B3,D2VMG4,A0A0D1ZAJ4,Q1K660,F4PH46,A0A164ZA52,Q54G64,S7WCF7,I0YVB2,R7QGN7,C1DZY0,A0A2C5Z0M1,A0CB11,R9ACY5,D3BMP8,A0A1Z5TVE5,W7XD45,A0A1U7LLR0,A0A4S2MWZ7,K1VVQ6,A0A158P1R9,G7DVX0,V6R0U9,G4N9J3,E3KLI3,B7Q5I1,A0A1E3QC61,D5GGK8,S8ANP9,L2GMR6,U4LBG4,A0A177URI1,O74957,A0A3N4IGK1,A6N7Y9,A0A0E9NDK5,A0A2G8JLH3,Q5KAT1,L2GUF2,A0A1W0E4B5,A0A2J7QB22,S4RYE2,A0A226EFL3,A0A3S3PD82,A0A0L0TEV1,A0A1S3J512,G0QTT2,A0A1J1HRI1,C4V9J2,Q9JMB7,Q5TW24,A0A401PRI6,Q96J94,A0A2B4RHN2,G2QEV0,A0A397UU01,K7ISV0,A0A024FT57,A0A0G4IME3,E9FUN9,A0A1S3CYL5,D7FQK3,T1GSU4,A0A1D8PMK0,A0A2G5B1D8,Q5BD61,A0A1C7M8P2,A0A4D8YSQ3,J9JZ66,A0A0C2XG51,T0SAU8,R7YY92,A0A3S1A0C3,A0A074YJ47,A0A2K1J482,O04379,A0A371I3C8,M8AEW7,A0A2K3NY65,F4NYW7,A0A1D1W4K0,A7BJS5,D8SNM6,X1WG39,Q69VD5,A0A2R6NSC2,A0A0D8XL16,A0A016WPN3,Q9QZ81,G5EES3,Q8CJG0,A0A1D5NTU6,V2WTL2,A0A0V0YLH8,A0A139WDH0,A0A0R3W9Q7,H3DS31,A0A1Y1HWP2,A0A0B2UV00,M7BCJ9,E9GN30,Q7PZ41,A0A077Z361,R7U9I3,A0A1X7V1N5,A0A0K0JDP1,A0A0N4UKJ1,A0A3M0IQP5,A0A0L8GBV4,A0A1J1JBJ0,E0W4C3,A0A482XDA9,A0A3P7EJD6,J9K2Z4,A0A2J7Q8V4,T1IBM6,A0A210QKF7,A0A423TSS1,K1PT78,A0A1D2N447,A0A226D7A9,A0A2C9JGZ6,A0A3Q0KUG5,T1FY40,1YVU,1Z26,3DLB,5AWH,5G5T,5I4A,6QZK,S7VLM7,A0A0Q2M2Z1,H8KXJ0,D3S0S6,A0A2D1U4H7,I3TE64,A0A0B7I4Z6,A0LL61,Q8DKB1,A0A1J1EK56,A0A4Q6XKV6,A0A239JE83,A0A2N4XBY2,Q53W94,R5JEI2,A0A0Q0ZC47,A0A2T0XH18,A0A1V4CHV0,A0A1K1RQP7,A0A2T1EKT1,A0A1N6LUI7,A0A0P0NGR6,A0A1X7IML5,A0A0A2LKJ7,K1L112,A0A0U3AL92,A0A1H3A054,E0UCX3,K9XZC6,B9LVW4,A0A0C1VHB4,Q31N05,A0A0C5JKF3,R5NJJ8,A5D4D9,Q2JI93,A0A142Y7A9,A0A372DKU2,C1F5Q7,A0A4R3EV39,A0A1P8WP90,A0A222F7P0,A0A1C9VH88,A0A2T2YMB1,A0A329TD61,A0A101R2A0,A0A1U9ND56,A0A4R7BQC4,A0A1Q1FPH0,E0TGY3,A0A259TUP4,F6EYI8,A0A2S9Q9J0,A0A4Q2UIU6,A0A1H0LH25,A0A318LG42,L0JS08,A0A345E7N0,M0AF24,A0A1H3X247,M0D2X3,A0A2R5G167,A0A346PK63,B9LVP8,M5RSF0,W0JW77,B7K585,F8D8G0,A0A343TL88,L0AJX6,A0A2A5QS34,A0A343JEE2,A0A3P3RGE5,A0A329TBQ3,A0A285N2A8,A0A0W1S8B8,A0A1V4C8L7,L9VRQ2,E4NRV1,A0A1I6HGN0,A0A1I0NI68,,",366,37
"336","C.H4.4","C.S6.6",252,134,118,1.90134075385783,"4F1N,4KRE,5VM9,6OON,7SWF,A0A163JTZ6,A0A0N4X8S8,A0A196SDB4,J9D5G4,A2DPV7,A0A0G4H2S4,S4RWI0,D2VMG4,A0A074TLL7,A0A0D1ZAJ4,Q1K660,F4PH46,A0A3M7S814,A0A164ZA52,Q54G64,S7WCF7,A0A2C5Z0M1,R9ACY5,D3BMP8,A0A1Z5TVE5,A0A1U7LLR0,A0A4S2MWZ7,A0A158P1R9,V6R0U9,G4N9J3,B7Q5I1,A0A1E3QC61,D5GGK8,S8ANP9,A0A139AUH8,U4LBG4,O74957,A0A3N4IGK1,A0A0E9NDK5,T1KZ60,L2GUF2,W2T741,A0A388KES6,A0A0L0TEV1,C4V9J2,Q5TW24,U5HIG6,G2QEV0,A0A397UU01,A0A2T7PFL8,A0A1S3CYL5,D7FQK3,T1GSU4,A0A1D8PMK0,Q5BD61,A0A1C7M8P2,A0A4D8YSQ3,A0A158PJG6,A0A0C2XG51,A0A158QZT6,A0A165QYQ9,R7YY92,A0A3S1A0C3,A0A074YJ47,A0A2K1J482,A0A1Q3ENA6,O04379,A0A371I3C8,M8AEW7,A8P0D4,A0A2K3NY65,F4NYW7,A0A409Y6G2,A0A0L0HAB7,D8PZT7,A0A1D1W4K0,A7RQ46,W4YU94,A7BJS5,D8SNM6,A0A1J8PPA3,X1WG39,M5FQK2,Q69VD5,A0A2R6NSC2,A0A0D8XL16,A0A016WPN3,Q9QZ81,G5EES3,A0A0K0EFP6,Q8CJG0,A0A1D5NTU6,V2WTL2,A0A0V0YLH8,A0A139WDH0,A0A0R3W9Q7,H3DS31,A0A1Y1HWP2,G4T5G9,B7QCC4,A0A0B2UV00,M7BCJ9,E9GN30,Q7PZ41,A0A077Z361,R7U9I3,A0A1X7V1N5,A0A0K0JDP1,A0A0N4UKJ1,A0A498N3A3,A0A3M0IQP5,A0A0L8GBV4,Q32KD4,A0A1J1JBJ0,E0W4C3,A0A482XDA9,A0A3P7EJD6,J9K2Z4,A0A2J7Q8V4,T1IBM6,V3ZRX0,A0A210QKF7,A0A423TSS1,K1PT78,A0A267E8R7,A0A1D2N447,A0A226D7A9,F6YK55,T1KTE4,A0A2C9JGZ6,A0A1V9X9F0,K5X5Z7,A0A3Q0KUG5,T1FY40,1Z26,5AWH,5G5T,5I4A,6QZK,E8N0K8,A0A1I7IXT4,A0A2W1JZ37,A0A2S7WBN3,A0A420DFE6,A0A4V1VDY2,A0A368P5I0,Q11QW7,A0A1M5ZSR3,A0A0K8QX04,A0A0M2PXX3,A0A1W6MIP2,A0A1C0UUC4,A0A2U2J9E0,A0A3D8L290,K9U8J6,K9RC91,A0A0D8ZUC0,A0A139XGN8,A0A1T4Y3A2,A0A2T1EFY0,K9UQR0,A0A2T1G8M7,K9VUN0,A0A0P6X5X2,B0JXD6,A0A1N6SSK9,A0A0P4UVI8,A0A0V7ZCG4,A0A1J0AGK2,A0A2G9DT08,K9UEV4,Q9L1X1,A0A1H3LE92,A0A496APJ8,A0A1V9G9U4,S7VLM7,A0A1A5X8H4,A0A1I2T6Q1,A0A1R3T9N6,A0A0Q2M2Z1,H8KXJ0,D3S0S6,A0A2D1U4H7,I3TE64,A0A0B7I4Z6,A0LL61,A0A139WY18,A0A2T1E1K4,A0A1Q8ZD62,A0A4Q6XKV6,A0A1Z3HNN4,A0A239JE83,A0A2N4XBY2,R5JEI2,A0A0Q0ZC47,A0A2T0XH18,A0A1V4CHV0,A0A1K1RQP7,A0A1N6LUI7,A0A0P0NGR6,A0A1X7IML5,A0A0A2LKJ7,K1L112,A0A1H3A054,B9LVW4,R5NJJ8,A5D4D9,A0A432MEQ5,A0A372DKU2,A0A3R7KLK4,C1F5Q7,A0A4R3EV39,A0A1P8WP90,A0A222F7P0,A0A1C9VH88,A0A2T2YMB1,A0A329TD61,A0A101R2A0,A0A1E3XF49,A0A1U9ND56,A0A4R7BQC4,A0A1H3DGN3,A0A1Q1FPH0,E0TGY3,A0A259TUP4,F6EYI8,A0A4Q2UIU6,A0A1H0LH25,A0A318LG42,H1YCU5,A0A1Q5ZS75,A0A345E7N0,A0A1W2A082,A0A1H3X247,A0A0C1XUA0,R7RTW6,A0A1H2RBI2,A0A1C3ZXN2,B9LVP8,M5RSF0,W0JW77,B7K585,F8D8G0,A0A343TL88,L0AJX6,A0A2A5QS34,A0A343JEE2,A0A329TBQ3,A0A0W1S8B8,A0A1V4C8L7,L9VRQ2,A0A1I0NI68,,",366,37
"339","C.S3.3","C.S4.2",253,134,119,2.19804339646306,"4F1N,4F3T,4KRE,5GUH,5VM9,6OON,C4LVV2,A8BCK6,T1H8B3,S4RWI0,D2VMG4,A0A074TLL7,A0A0D1ZAJ4,Q1K660,F4PH46,A0A3M7S814,A0A164ZA52,Q54G64,S7WCF7,I0YVB2,C1DZY0,A0CB11,R9ACY5,D3BMP8,A0A1Z5TVE5,W7XD45,A0A1U7LLR0,A0A4S2MWZ7,A0A158P1R9,G7DVX0,V6R0U9,G4N9J3,E3KLI3,B7Q5I1,A0A1E3QC61,D5GGK8,S8ANP9,A0A139AUH8,L2GMR6,U4LBG4,A0A3N4IGK1,A6N7Y9,A0A0E9NDK5,T1KZ60,A0A2G8JLH3,L2GUF2,W2T741,A0A1W0E4B5,A0A2J7QB22,S4RYE2,A0A2K3CW87,A0A226EFL3,A0A3S3PD82,A0A0L0TEV1,A0A1S3J512,G0QTT2,A0A1J1HRI1,C4V9J2,Q9JMB7,Q5TW24,A0A401PRI6,Q96J94,A0A2B4RHN2,A0A2T7PFL8,K7ISV0,E9FUN9,A0A1S3CYL5,A0A1D8PMK0,A0A2G5B1D8,A0A1C7M8P2,J9JZ66,A0A0C2XG51,A0A158QZT6,A0A165QYQ9,A0A3S1A0C3,A0A074YJ47,A0A1Q3ENA6,A8P0D4,D8PZT7,A0A1D1W4K0,W4YU94,A7BJS5,A0A1J8PPA3,X1WG39,M5FQK2,A0A2R6NSC2,A0A0D8XL16,A0A016WPN3,Q9QZ81,G5EES3,A0A0K0EFP6,Q8CJG0,A0A1D5NTU6,V2WTL2,A0A0V0YLH8,A0A139WDH0,A0A0R3W9Q7,H3DS31,G4T5G9,B7QCC4,A0A0B2UV00,M7BCJ9,E9GN30,Q7PZ41,A0A077Z361,R7U9I3,A0A1X7V1N5,A0A0K0JDP1,A0A0N4UKJ1,A0A498N3A3,A0A3M0IQP5,A0A0L8GBV4,Q32KD4,A0A1J1JBJ0,E0W4C3,A0A482XDA9,A0A3P7EJD6,J9K2Z4,A0A2J7Q8V4,T1IBM6,V3ZRX0,A0A210QKF7,A0A423TSS1,K1PT78,A0A267E8R7,A0A1D2N447,A0A226D7A9,F6YK55,T1KTE4,A0A2C9JGZ6,A0A1V9X9F0,K5X5Z7,A0A3Q0KUG5,T1FY40,1Z26,3DLB,5AWH,5G5T,5I4A,6QZK,7R8K,A0A1I7IXT4,A0A2W1JZ37,A0A2S7WBN3,A0A420DFE6,A0A4V1VDY2,A0A368P5I0,A0A4R1RMM2,A0A1Y2RDH8,A0A1M5ZSR3,A0A1I3LMA1,A0A1L3JHM3,A0A2U2J9E0,B1XJG0,A0A1T4Y3A2,A0A2G9DT08,Q9L1X1,A0A1H3LE92,A0A496APJ8,A0A062U2W9,H0HWQ5,A0A1V9G9U4,A0A1I2ZGP1,A0A317EJY3,A0A1I2BD20,F8ERC7,S7VLM7,A0A1A5X8H4,A0A1I2T6Q1,A0A1R3T9N6,A0A0Q2M2Z1,H8KXJ0,A0A2D1U4H7,A0A0B7I4Z6,A0LL61,Q8DKB1,A0A139WY18,A0A1J1EK56,A0A1Q8ZD62,A0A4Q6XKV6,A0A239JE83,A0A2N4XBY2,Q53W94,R5JEI2,A0A0Q0ZC47,A0A2T0XH18,A0A1V4CHV0,A0A1K1RQP7,A0A2T1EKT1,A0A1N6LUI7,A0A0P0NGR6,A0A1X7IML5,A0A0A2LKJ7,K1L112,A0A0U3AL92,A0A1H3A054,B9LVW4,A0A0C1VHB4,Q31N05,A0A0C5JKF3,R5NJJ8,A5D4D9,Q2JI93,A0A142Y7A9,A0A432MEQ5,A0A372DKU2,C1F5Q7,A0A4R3EV39,A0A1P8WP90,A0A222F7P0,A0A1C9VH88,A0A2T2YMB1,A0A329TD61,A0A101R2A0,A0A1E3XF49,A0A1U9ND56,A0A4R7BQC4,E0TGY3,A0A259TUP4,F6EYI8,A0A2S9Q9J0,A0A4Q2UIU6,A0A1H0LH25,A0A318LG42,H1YCU5,L0JS08,A0A1Q5ZS75,M0AF24,A0A1W2A082,A0A0C1XUA0,M0D2X3,A0A2R5G167,A0A346PK63,R7RTW6,A0A1H2RBI2,A0A1C3ZXN2,M5RSF0,W0JW77,B7K585,F8D8G0,A0A343TL88,L0AJX6,A0A2A5QS34,A0A343JEE2,A0A3P3RGE5,A0A329TBQ3,A0A285N2A8,A0A0W1S8B8,A0A1V4C8L7,L9VRQ2,E4NRV1,A0A1I6HGN0,A0A1I0NI68,,",366,37
"347","C.H10.10","C.L28.4",219,136,83,4.47873848334515,"4F1N,4F3T,4KRE,5GUH,5VM9,6KR6,6OON,7KX7,7SWF,A0A163JTZ6,J9D5G4,A2DPV7,A0A0G4H2S4,D2VMG4,A0A0D1ZAJ4,Q1K660,F4PH46,A0A3M7S814,Q54G64,S7WCF7,R7QGN7,A0A2C5Z0M1,R9ACY5,W7XD45,A0A1U7LLR0,K1VVQ6,A0A158P1R9,V6R0U9,G4N9J3,B7Q5I1,A0A1E3QC61,L2GMR6,U4LBG4,A0A177URI1,O74957,A6N7Y9,T1KZ60,A0A2G8JLH3,L2GUF2,W2T741,A0A1W0E4B5,A0A2J7QB22,S4RYE2,A0A2K3CW87,A0A226EFL3,A0A3S3PD82,A0A0L0TEV1,A0A1S3J512,G0QTT2,A0A1J1HRI1,C4V9J2,Q9JMB7,A0A075AN09,Q5TW24,U5HIG6,A0A401PRI6,Q96J94,A0A2B4RHN2,G2QEV0,A0A397UU01,A0A2T7PFL8,K7ISV0,A0A024FT57,H3HCL6,A0A0G4IME3,E9FUN9,A0A1S3CYL5,D7FQK3,A0A1Y1YHC8,A0A1D8PMK0,Q5BD61,A0A158PJG6,J9JZ66,A0A0C2XG51,A0A165QYQ9,T0SAU8,R7YY92,A0A074YJ47,A0A1Q3ENA6,F4NYW7,A0A409Y6G2,A0A0L0HAB7,A0A1D1W4K0,A7RQ46,W4YU94,A7BJS5,A0A1J8PPA3,X1WG39,M5FQK2,A0A2R6NSC2,A0A0D8XL16,A0A016WPN3,Q9QZ81,G5EES3,A0A0K0EFP6,Q8CJG0,A0A1D5NTU6,A0A0V0YLH8,A0A139WDH0,A0A0R3W9Q7,H3DS31,G4T5G9,B7QCC4,A0A0B2UV00,M7BCJ9,E9GN30,Q7PZ41,A0A077Z361,R7U9I3,A0A1X7V1N5,A0A0K0JDP1,A0A0N4UKJ1,A0A498N3A3,A0A3M0IQP5,A0A0L8GBV4,Q32KD4,A0A1J1JBJ0,E0W4C3,A0A482XDA9,A0A3P7EJD6,J9K2Z4,A0A2J7Q8V4,T1IBM6,V3ZRX0,A0A210QKF7,A0A423TSS1,A0A267E8R7,A0A1D2N447,A0A226D7A9,F6YK55,T1KTE4,A0A2C9JGZ6,A0A1V9X9F0,K5X5Z7,A0A3Q0KUG5,T1FY40,1YVU,5AWH,A0A1I7IXT4,A0A2W1JZ37,A0A2S7WBN3,A0A420DFE6,A0A4V1VDY2,A0A368P5I0,A0A4R1RMM2,A0A1Y2RDH8,Q11QW7,A0A1M5ZSR3,A0A0K8QX04,A0A0M2PXX3,A0A1W6MIP2,A0A1C0UUC4,A0A2U2J9E0,B1XJG0,A0A3D8L290,A0A1T4Y3A2,R6KUL9,A0A2G9DT08,Q9L1X1,A0A060HNJ0,A0A235B542,A0A496APJ8,A0A1V9G9U4,A0A1A5X8H4,A0A1I2T6Q1,A0A1R3T9N6,H8KXJ0,A0A2D1U4H7,A0A0B7I4Z6,A0LL61,A0A139WY18,A0A1J1EK56,A0A2T1E1K4,A0A1Q8ZD62,A0A4Q6XKV6,A0A1Z3HNN4,A0A239JE83,A0A2N4XBY2,Q53W94,R5JEI2,A0A0Q0ZC47,A0A2T0XH18,A0A1V4CHV0,A0A1K1RQP7,A0A1N6LUI7,A0A0P0NGR6,A0A1X7IML5,A0A0A2LKJ7,K1L112,A0A0U3AL92,A0A1H3A054,E0UCX3,A0A0C1VHB4,A0A0C5JKF3,A5D4D9,A0A142Y7A9,A0A432MEQ5,A0A372DKU2,C1F5Q7,A0A4R3EV39,A0A1P8WP90,A0A222F7P0,A0A1C9VH88,A0A2T2YMB1,A0A101R2A0,A0A1U9ND56,A0A4R7BQC4,E0TGY3,A0A259TUP4,F6EYI8,A0A2S9Q9J0,A0A4Q2UIU6,A0A1H0LH25,A0A318LG42,A0A2R5G167,A0A346PK63,M5RSF0,B7K585,A0A343JEE2,,",366,37
"350","C.H9.10","C.S15.4",194,136,58,1.58062880324544,"4F3T,4KRE,5GUH,6OON,A0A163JTZ6,A0A0N4X8S8,A0A196SDB4,A0A2P6N8X7,A8BCK6,A2DPV7,A0A0G4H2S4,R1FDF0,D2VMG4,A0A074TLL7,A0A0D1ZAJ4,Q1K660,Q54G64,R7QGN7,A0A2C5Z0M1,D3BMP8,W7XD45,K1VVQ6,A0A158P1R9,G7DVX0,V6R0U9,G4N9J3,A0A139AUH8,A0A177URI1,O74957,T1KZ60,A0A250WXN5,A0A2G8JLH3,Q5KAT1,L2GUF2,W2T741,A0A2J7QB22,S4RYE2,A0A2K3CW87,A0A388KES6,A0A226EFL3,A0A3S3PD82,A0A0L0TEV1,A0A1S3J512,G0QTT2,A0A1J1HRI1,A0A075AN09,Q5TW24,A0A2B4RHN2,G2QEV0,A0A397UU01,A0A2T7PFL8,A0A024FT57,H3HCL6,A0A0G4IME3,E9FUN9,A0A1S3CYL5,D7FQK3,A0A1Y1YHC8,T1GSU4,A0A2G5B1D8,Q5BD61,A0A1C7M8P2,A0A4D8YSQ3,A0A158PJG6,J9JZ66,A0A0C2XG51,A0A158QZT6,T0SAU8,R7YY92,A0A3S1A0C3,A0A074YJ47,A0A1Q3ENA6,O04379,A0A371I3C8,A8P0D4,F4NYW7,A0A409Y6G2,A0A0L0HAB7,D8PZT7,A0A1D1W4K0,A7RQ46,W4YU94,A7BJS5,A0A1J8PPA3,X1WG39,M5FQK2,Q69VD5,A0A2R6NSC2,A0A0D8XL16,A0A016WPN3,Q9QZ81,G5EES3,A0A0K0EFP6,Q8CJG0,A0A1D5NTU6,V2WTL2,A0A0V0YLH8,A0A139WDH0,A0A0R3W9Q7,H3DS31,G4T5G9,B7QCC4,A0A0B2UV00,M7BCJ9,E9GN30,Q7PZ41,A0A077Z361,R7U9I3,A0A1X7V1N5,A0A0K0JDP1,A0A0N4UKJ1,A0A498N3A3,A0A3M0IQP5,A0A0L8GBV4,Q32KD4,A0A1J1JBJ0,E0W4C3,A0A482XDA9,A0A3P7EJD6,J9K2Z4,A0A2J7Q8V4,T1IBM6,V3ZRX0,A0A210QKF7,A0A423TSS1,K1PT78,A0A267E8R7,A0A1D2N447,A0A226D7A9,F6YK55,T1KTE4,A0A2C9JGZ6,A0A1V9X9F0,K5X5Z7,A0A3Q0KUG5,T1FY40,5AWH,5G5T,5I4A,7R8K,E0ST67,Q11QW7,A0A1C0UUC4,B1XJG0,A0A326U7G5,A0A3D8L290,A0A1Q4R485,A0A097QRL6,A0A0D8ZUC0,A0A139XGN8,B6YTQ5,A0YYT3,A0A2T1EFY0,G6FTN0,R6KUL9,A0A433NB65,K9VUN0,A0A0P6X5X2,K9ZDE3,A0A1Z4K1Y3,A0A0V7ZCG4,A0A1J0AGK2,K9PFF9,A0A1I2ZGP1,A0A317EJY3,A0A0B7I4Z6,Q8DKB1,A0A2T1EKT1,E0UCX3,K9XZC6,B9LVW4,A0A0C1VHB4,Q31N05,Q2JI93,A0A142Y7A9,A0A432MEQ5,C1F5Q7,A0A1Q1FPH0,A0A4Q2UIU6,A0A1H0LH25,A0A318LG42,L0JS08,M0AF24,M0D2X3,A0A2R5G167,A0A1H2RBI2,W0JW77,B7K585,F8D8G0,A0A3P3RGE5,A0A285N2A8,L9VRQ2,E4NRV1,A0A1I6HGN0,,",366,37
"353","C.S1.1","C.S2.2",251,136,115,3.77608695652174,"4F1N,4F3T,4KRE,5GUH,5VM9,6OON,7SWF,A0A163JTZ6,A0A0N4X8S8,A0A196SDB4,J9D5G4,Q389P5,T1H8B3,S4RWI0,A0A074TLL7,A0A0D1ZAJ4,Q1K660,A0A3M7S814,A0A164ZA52,S7WCF7,I0YVB2,R7QGN7,C1DZY0,A0A2C5Z0M1,R9ACY5,A0A1Z5TVE5,A0A4S2MWZ7,V6R0U9,G4N9J3,E3KLI3,A0A1E3QC61,D5GGK8,S8ANP9,A0A139AUH8,L2GMR6,U4LBG4,A0A177URI1,O74957,A0A3N4IGK1,A0A0E9NDK5,L2GUF2,W2T741,A0A1W0E4B5,A0A2J7QB22,A0A388KES6,A0A0L0TEV1,A0A1J1HRI1,C4V9J2,A0A075AN09,Q5TW24,U5HIG6,A0A397UU01,A0A2T7PFL8,K7ISV0,A0A0G4IME3,E9FUN9,D7FQK3,A0A1Y1YHC8,T1GSU4,A0A1D8PMK0,A0A2G5B1D8,A0A1C7M8P2,A0A4D8YSQ3,A0A158PJG6,J9JZ66,A0A0C2XG51,A0A158QZT6,A0A165QYQ9,A0A3S1A0C3,A0A2K1J482,A0A1Q3ENA6,O04379,A0A371I3C8,M8AEW7,A8P0D4,A0A2K3NY65,F4NYW7,A0A409Y6G2,A0A0L0HAB7,A0A1D1W4K0,W4YU94,A7BJS5,D8SNM6,A0A1J8PPA3,X1WG39,M5FQK2,Q69VD5,A0A0D8XL16,A0A016WPN3,Q9QZ81,G5EES3,A0A0K0EFP6,Q8CJG0,A0A1D5NTU6,V2WTL2,A0A0V0YLH8,A0A139WDH0,A0A0R3W9Q7,H3DS31,A0A1Y1HWP2,G4T5G9,B7QCC4,A0A0B2UV00,M7BCJ9,E9GN30,Q7PZ41,A0A077Z361,R7U9I3,A0A1X7V1N5,A0A0K0JDP1,A0A0N4UKJ1,A0A498N3A3,A0A3M0IQP5,A0A0L8GBV4,Q32KD4,A0A1J1JBJ0,E0W4C3,A0A482XDA9,A0A3P7EJD6,J9K2Z4,A0A2J7Q8V4,T1IBM6,V3ZRX0,A0A210QKF7,A0A423TSS1,K1PT78,A0A267E8R7,A0A1D2N447,A0A226D7A9,F6YK55,T1KTE4,A0A2C9JGZ6,A0A1V9X9F0,K5X5Z7,A0A3Q0KUG5,T1FY40,1YVU,1Z26,3DLB,5AWH,5G5T,5I4A,6QZK,K9TPA9,A0A2Z6E1D5,A0A0F4NXW8,L8D0R3,B1XJG0,K9U8J6,K9RC91,A0A0D8ZUC0,A0A139XGN8,A0A1T4Y3A2,Q5P0R2,A0YYT3,A0A2T1EFY0,G6FTN0,A0A433NB65,K9UQR0,K9ZDE3,B0JXD6,A0A1Z4K1Y3,A0A0P4UVI8,A0A0V7ZCG4,K9PFF9,A0A2G9DT08,K9UEV4,Q9L1X1,A0A1H3LE92,A0A496APJ8,A0A1V9G9U4,A0A1A5X8H4,A0A1I2T6Q1,A0A1R3T9N6,A0A0Q2M2Z1,H8KXJ0,A0A2D1U4H7,A0LL61,Q8DKB1,A0A139WY18,A0A1J1EK56,A0A2T1E1K4,A0A1Q8ZD62,A0A1Z3HNN4,Q53W94,A0A1V4CHV0,A0A2T1EKT1,A0A1N6LUI7,A0A0U3AL92,A0A1H3A054,E0UCX3,K9XZC6,B9LVW4,A0A0C1VHB4,Q31N05,A0A0C5JKF3,R5NJJ8,A5D4D9,Q2JI93,A0A142Y7A9,A0A432MEQ5,A0A372DKU2,A0A4R3EV39,A0A1P8WP90,A0A222F7P0,A0A1C9VH88,A0A329TD61,A0A101R2A0,A0A1E3XF49,A0A1U9ND56,A0A4R7BQC4,A0A1Q1FPH0,E0TGY3,A0A259TUP4,F6EYI8,A0A2S9Q9J0,A0A4Q2UIU6,A0A1H0LH25,A0A318LG42,H1YCU5,L0JS08,A0A1Q5ZS75,A0A345E7N0,M0AF24,A0A1W2A082,A0A1H3X247,A0A0C1XUA0,M0D2X3,A0A2R5G167,A0A346PK63,R7RTW6,A0A1H2RBI2,A0A1C3ZXN2,B9LVP8,M5RSF0,W0JW77,B7K585,F8D8G0,A0A343TL88,L0AJX6,A0A2A5QS34,A0A343JEE2,A0A3P3RGE5,A0A329TBQ3,A0A285N2A8,A0A0W1S8B8,A0A1V4C8L7,L9VRQ2,E4NRV1,A0A1I6HGN0,A0A1I0NI68,,",366,37
"354","C.S3.4","C.S4.3",255,136,119,1.93855042016807,"4F1N,4KRE,5GUH,5VM9,6KR6,6OON,7KX7,C4LVV2,A8BCK6,A2DPV7,T1H8B3,S4RWI0,D2VMG4,A0A0D1ZAJ4,Q1K660,F4PH46,A0A3M7S814,A0A164ZA52,Q54G64,S7WCF7,I0YVB2,A0CB11,R9ACY5,D3BMP8,W7XD45,A0A1U7LLR0,A0A4S2MWZ7,A0A158P1R9,G7DVX0,G4N9J3,E3KLI3,B7Q5I1,A0A1E3QC61,D5GGK8,S8ANP9,L2GMR6,U4LBG4,A0A3N4IGK1,A6N7Y9,A0A0E9NDK5,T1KZ60,A0A2G8JLH3,L2GUF2,W2T741,A0A1W0E4B5,A0A2J7QB22,S4RYE2,A0A2K3CW87,A0A388KES6,A0A226EFL3,A0A3S3PD82,A0A0L0TEV1,A0A1S3J512,G0QTT2,A0A1J1HRI1,C4V9J2,Q9JMB7,Q5TW24,U5HIG6,A0A401PRI6,Q96J94,A0A2B4RHN2,A0A2T7PFL8,K7ISV0,E9FUN9,A0A1S3CYL5,T1GSU4,A0A1D8PMK0,A0A2G5B1D8,A0A1C7M8P2,J9JZ66,A0A0C2XG51,A0A158QZT6,A0A165QYQ9,A0A3S1A0C3,A0A074YJ47,A0A1Q3ENA6,A8P0D4,A0A409Y6G2,D8PZT7,A0A1D1W4K0,A7RQ46,W4YU94,A7BJS5,A0A1J8PPA3,X1WG39,M5FQK2,A0A2R6NSC2,A0A0D8XL16,A0A016WPN3,Q9QZ81,G5EES3,A0A0K0EFP6,Q8CJG0,A0A1D5NTU6,V2WTL2,A0A0V0YLH8,A0A139WDH0,A0A0R3W9Q7,H3DS31,G4T5G9,B7QCC4,A0A0B2UV00,M7BCJ9,E9GN30,Q7PZ41,A0A077Z361,R7U9I3,A0A1X7V1N5,A0A0K0JDP1,A0A0N4UKJ1,A0A498N3A3,A0A3M0IQP5,A0A0L8GBV4,Q32KD4,A0A1J1JBJ0,E0W4C3,A0A482XDA9,A0A3P7EJD6,J9K2Z4,A0A2J7Q8V4,T1IBM6,V3ZRX0,A0A210QKF7,A0A423TSS1,K1PT78,A0A267E8R7,A0A1D2N447,A0A226D7A9,F6YK55,T1KTE4,A0A2C9JGZ6,A0A1V9X9F0,K5X5Z7,A0A3Q0KUG5,T1FY40,1YVU,1Z26,3DLB,5AWH,5G5T,5I4A,7R8K,E8N0K8,A0A1I7IXT4,A0A2W1JZ37,A0A2S7WBN3,A0A420DFE6,A0A4V1VDY2,A0A368P5I0,A0A4R1RMM2,A0A1Y2RDH8,A0A1M5ZSR3,A0A1I3LMA1,K9TPA9,A0A1L3JHM3,A0A1W6MIP2,A0A2U2J9E0,A0A1T4Y3A2,K9PFF9,A0A2G9DT08,K9UEV4,Q9L1X1,A0A1H3LE92,A0A496APJ8,A0A062U2W9,H0HWQ5,A0A1V9G9U4,A0A1I2ZGP1,A0A317EJY3,A0A1I2BD20,F8ERC7,S7VLM7,A0A1A5X8H4,A0A1I2T6Q1,A0A1R3T9N6,A0A0Q2M2Z1,H8KXJ0,D3S0S6,A0A2D1U4H7,A0A0B7I4Z6,A0LL61,A0A139WY18,A0A1J1EK56,A0A2T1E1K4,A0A1Q8ZD62,A0A4Q6XKV6,A0A1Z3HNN4,A0A239JE83,A0A2N4XBY2,R5JEI2,A0A0Q0ZC47,A0A2T0XH18,A0A1V4CHV0,A0A1K1RQP7,A0A1N6LUI7,A0A0P0NGR6,A0A1X7IML5,A0A0A2LKJ7,K1L112,A0A0U3AL92,A0A1H3A054,B9LVW4,A0A0C5JKF3,R5NJJ8,A5D4D9,A0A142Y7A9,A0A432MEQ5,A0A372DKU2,C1F5Q7,A0A4R3EV39,A0A1P8WP90,A0A222F7P0,A0A1C9VH88,A0A2T2YMB1,A0A101R2A0,A0A1E3XF49,A0A1U9ND56,A0A4R7BQC4,E0TGY3,A0A259TUP4,F6EYI8,A0A2S9Q9J0,A0A4Q2UIU6,A0A1H0LH25,A0A318LG42,H1YCU5,L0JS08,A0A1Q5ZS75,M0AF24,A0A1W2A082,A0A0C1XUA0,M0D2X3,A0A2R5G167,A0A346PK63,R7RTW6,A0A1H2RBI2,A0A1C3ZXN2,M5RSF0,W0JW77,B7K585,F8D8G0,A0A343TL88,L0AJX6,A0A2A5QS34,A0A343JEE2,A0A3P3RGE5,A0A329TBQ3,A0A285N2A8,A0A0W1S8B8,A0A1V4C8L7,L9VRQ2,E4NRV1,A0A1I6HGN0,A0A1I0NI68,,",366,37
"355","N.H3.12","N.S11.9",177,136,41,2.35518292682927,"4F3T,4KRE,5GUH,5VM9,6OON,A0A196SDB4,T1H8B3,R1FDF0,S4RWI0,A0A074TLL7,A0A0D1ZAJ4,Q1K660,F4PH46,A0A3M7S814,A0A164ZA52,Q54G64,I0YVB2,R7QGN7,A0CB11,A0A1Z5TVE5,W7XD45,A0A1U7LLR0,A0A4S2MWZ7,K1VVQ6,A0A158P1R9,G7DVX0,A0A1E3QC61,D5GGK8,S8ANP9,A0A139AUH8,U4LBG4,A0A177URI1,O74957,A0A3N4IGK1,A6N7Y9,A0A0E9NDK5,T1KZ60,A0A250WXN5,A0A2G8JLH3,Q5KAT1,L2GUF2,W2T741,A0A2J7QB22,S4RYE2,A0A2K3CW87,A0A388KES6,A0A3S3PD82,A0A0L0TEV1,A0A1S3J512,A0A1J1HRI1,Q9JMB7,Q5TW24,A0A401PRI6,Q96J94,G2QEV0,A0A397UU01,A0A2T7PFL8,H3HCL6,A0A0G4IME3,E9FUN9,D7FQK3,A0A1Y1YHC8,T1GSU4,A0A1D8PMK0,A0A1C7M8P2,A0A4D8YSQ3,A0A158PJG6,J9JZ66,A0A0C2XG51,A0A158QZT6,A0A165QYQ9,T0SAU8,A0A3S1A0C3,A0A2K1J482,O04379,A0A371I3C8,M8AEW7,A0A2K3NY65,F4NYW7,A0A409Y6G2,A0A0L0HAB7,A0A1D1W4K0,A7RQ46,W4YU94,A7BJS5,D8SNM6,A0A1J8PPA3,X1WG39,M5FQK2,Q69VD5,A0A0D8XL16,A0A016WPN3,Q9QZ81,G5EES3,A0A0K0EFP6,Q8CJG0,A0A1D5NTU6,A0A0V0YLH8,A0A139WDH0,A0A0R3W9Q7,H3DS31,A0A1Y1HWP2,B7QCC4,A0A0B2UV00,M7BCJ9,E9GN30,Q7PZ41,A0A077Z361,R7U9I3,A0A1X7V1N5,A0A0K0JDP1,A0A0N4UKJ1,A0A498N3A3,A0A3M0IQP5,A0A0L8GBV4,Q32KD4,A0A1J1JBJ0,E0W4C3,A0A482XDA9,A0A3P7EJD6,J9K2Z4,A0A2J7Q8V4,T1IBM6,V3ZRX0,A0A210QKF7,A0A423TSS1,K1PT78,A0A267E8R7,A0A1D2N447,A0A226D7A9,F6YK55,T1KTE4,A0A2C9JGZ6,A0A1V9X9F0,A0A3Q0KUG5,T1FY40,1YVU,3DLB,6QZK,A0A3D8L290,A0A496APJ8,A0A062U2W9,A0A317EJY3,F8ERC7,A0A1R3T9N6,H8KXJ0,A0A2D1U4H7,A0A0B7I4Z6,A0LL61,Q8DKB1,R5JEI2,A0A1V4CHV0,A0A1K1RQP7,A0A2T1EKT1,A0A0A2LKJ7,A0A0U3AL92,A0A0C1VHB4,A0A0C5JKF3,A0A142Y7A9,A0A372DKU2,A0A222F7P0,A0A2T2YMB1,A0A1E3XF49,A0A1Q1FPH0,E0TGY3,F6EYI8,A0A4Q2UIU6,H1YCU5,L0JS08,A0A1Q5ZS75,A0A1W2A082,A0A0C1XUA0,A0A1H2RBI2,A0A1C3ZXN2,B7K585,A0A343JEE2,A0A1I0NI68,,",366,37
"360","C.H7.13","C.L17.1",177,137,40,2.12445255474453,"4F3T,4KRE,5GUH,5VM9,6KR6,6OON,7SWF,A0A163JTZ6,J9D5G4,T1H8B3,S4RWI0,D2VMG4,F4PH46,A0A3M7S814,Q54G64,S7WCF7,C1DZY0,A0CB11,D3BMP8,W7XD45,A0A158P1R9,E3KLI3,B7Q5I1,O74957,A6N7Y9,T1KZ60,A0A2G8JLH3,L2GUF2,W2T741,A0A1W0E4B5,A0A2J7QB22,A0A2K3CW87,A0A226EFL3,A0A3S3PD82,A0A0L0TEV1,A0A1S3J512,G0QTT2,A0A1J1HRI1,C4V9J2,Q9JMB7,A0A075AN09,Q5TW24,U5HIG6,A0A401PRI6,Q96J94,A0A2B4RHN2,G2QEV0,A0A397UU01,A0A2T7PFL8,K7ISV0,A0A024FT57,H3HCL6,E9FUN9,A0A1S3CYL5,D7FQK3,A0A1Y1YHC8,T1GSU4,F4S231,A0A1D8PMK0,A0A2G5B1D8,Q5BD61,A0A1C7M8P2,A0A4D8YSQ3,A0A158PJG6,J9JZ66,A0A158QZT6,T0SAU8,R7YY92,A0A3S1A0C3,A0A074YJ47,A0A2K1J482,A0A1Q3ENA6,O04379,A0A371I3C8,M8AEW7,A8P0D4,A0A2K3NY65,F4NYW7,A0A409Y6G2,A0A0L0HAB7,D8PZT7,A0A1D1W4K0,A7RQ46,W4YU94,A7BJS5,D8SNM6,X1WG39,Q69VD5,A0A2R6NSC2,A0A0D8XL16,A0A016WPN3,Q9QZ81,G5EES3,A0A0K0EFP6,Q8CJG0,A0A1D5NTU6,V2WTL2,A0A0V0YLH8,A0A139WDH0,A0A0R3W9Q7,H3DS31,A0A1Y1HWP2,B7QCC4,A0A0B2UV00,M7BCJ9,E9GN30,Q7PZ41,A0A077Z361,R7U9I3,A0A1X7V1N5,A0A0K0JDP1,A0A0N4UKJ1,A0A498N3A3,A0A3M0IQP5,A0A0L8GBV4,Q32KD4,A0A1J1JBJ0,E0W4C3,A0A482XDA9,A0A3P7EJD6,J9K2Z4,A0A2J7Q8V4,T1IBM6,V3ZRX0,A0A210QKF7,A0A423TSS1,K1PT78,A0A267E8R7,A0A1D2N447,A0A226D7A9,F6YK55,T1KTE4,A0A2C9JGZ6,A0A1V9X9F0,K5X5Z7,A0A3Q0KUG5,T1FY40,1YVU,1Z26,3DLB,5G5T,5I4A,6QZK,B1XJG0,A0A1H3LE92,A0A0Q2M2Z1,I3TE64,Q8DKB1,A0A1J1EK56,A0A1Z3HNN4,Q53W94,A0A2T1EKT1,E0UCX3,K9XZC6,B9LVW4,A0A0C1VHB4,Q31N05,R5NJJ8,Q2JI93,L0JS08,M0AF24,M0D2X3,A0A2R5G167,A0A346PK63,R7RTW6,W0JW77,A0A343TL88,L0AJX6,A0A2A5QS34,A0A343JEE2,A0A3P3RGE5,A0A329TBQ3,A0A285N2A8,A0A0W1S8B8,L9VRQ2,E4NRV1,A0A1I6HGN0,,",366,37
"361","C.L19.5","C.S11.2",219,137,82,1.24256720669396,"4F1N,4F3T,4KRE,6OON,7KX7,7SWF,A0A163JTZ6,A0A196SDB4,J9D5G4,C4LVV2,A0A2P6N8X7,A0A0G4H2S4,R1FDF0,S4RWI0,A0A074TLL7,A0A0D1ZAJ4,A0A3M7S814,A0A164ZA52,Q54G64,S7WCF7,I0YVB2,R7QGN7,A0CB11,R9ACY5,D3BMP8,A0A1Z5TVE5,A0A1U7LLR0,A0A4S2MWZ7,K1VVQ6,G7DVX0,G4N9J3,A0A1E3QC61,D5GGK8,S8ANP9,L2GMR6,U4LBG4,O74957,A0A3N4IGK1,A0A0E9NDK5,T1KZ60,A0A250WXN5,L2GUF2,W2T741,A0A1W0E4B5,A0A2K3CW87,A0A3S3PD82,A0A0L0TEV1,A0A1S3J512,G0QTT2,C4V9J2,A0A075AN09,U5HIG6,G2QEV0,A0A397UU01,A0A2T7PFL8,K7ISV0,A0A024FT57,H3HCL6,A0A0G4IME3,A0A1S3CYL5,D7FQK3,A0A1Y1YHC8,T1GSU4,F4S231,Q5BD61,A0A4D8YSQ3,A0A158PJG6,A0A158QZT6,A0A165QYQ9,T0SAU8,R7YY92,A0A3S1A0C3,A0A074YJ47,A0A2K1J482,A0A1Q3ENA6,O04379,A0A371I3C8,M8AEW7,A8P0D4,A0A2K3NY65,F4NYW7,A0A409Y6G2,A0A0L0HAB7,A0A1D1W4K0,A7RQ46,W4YU94,A7BJS5,D8SNM6,X1WG39,Q69VD5,A0A2R6NSC2,A0A0D8XL16,A0A016WPN3,Q9QZ81,G5EES3,A0A0K0EFP6,Q8CJG0,A0A1D5NTU6,A0A0V0YLH8,A0A139WDH0,A0A0R3W9Q7,H3DS31,A0A1Y1HWP2,G4T5G9,B7QCC4,A0A0B2UV00,M7BCJ9,E9GN30,Q7PZ41,A0A077Z361,R7U9I3,A0A1X7V1N5,A0A0K0JDP1,A0A0N4UKJ1,A0A498N3A3,A0A3M0IQP5,A0A0L8GBV4,Q32KD4,A0A1J1JBJ0,E0W4C3,A0A482XDA9,A0A3P7EJD6,J9K2Z4,A0A2J7Q8V4,T1IBM6,V3ZRX0,A0A210QKF7,A0A423TSS1,K1PT78,A0A267E8R7,A0A1D2N447,A0A226D7A9,T1KTE4,A0A2C9JGZ6,K5X5Z7,A0A3Q0KUG5,T1FY40,1YVU,3DLB,5AWH,5G5T,5I4A,6QZK,A0A1I7IXT4,A0A2W1JZ37,A0A420DFE6,A0A1Y2RDH8,A0A0K8QX04,A0A1W6MIP2,A0A2U2J9E0,A0A2Z6E1D5,B1XJG0,A0A1Q4R485,A0A1T4Y3A2,Q5P0R2,A0A0B0H9B4,R6KUL9,A0A1Z4L0A1,B7GJX9,A0A1Z4K1Y3,A0A2Z6E0R7,A0A1N6SSK9,A0A1J0AGK2,K9PFF9,A0A060HNJ0,A0A235B542,R5XQK4,A0A1H3LE92,S7VLM7,A0A0Q2M2Z1,H8KXJ0,A0A2D1U4H7,A0A0B7I4Z6,Q8DKB1,A0A1J1EK56,A0A4Q6XKV6,A0A2N4XBY2,Q53W94,R5JEI2,A0A0Q0ZC47,A0A2T0XH18,A0A1K1RQP7,A0A2T1EKT1,A0A1N6LUI7,A0A0P0NGR6,A0A1X7IML5,A0A0A2LKJ7,K1L112,E0UCX3,K9XZC6,B9LVW4,A0A0C1VHB4,Q31N05,R5NJJ8,A5D4D9,Q2JI93,A0A372DKU2,C1F5Q7,A0A1P8WP90,A0A2T2YMB1,A0A329TD61,A0A1U9ND56,A0A4R7BQC4,A0A1H3DGN3,A0A1Q1FPH0,E0TGY3,A0A4Q2UIU6,L0JS08,A0A345E7N0,M0AF24,A0A1H3X247,M0D2X3,R7RTW6,A0A1H2RBI2,W0JW77,L0AJX6,A0A2A5QS34,A0A343JEE2,A0A285N2A8,,",366,37
"363","C.S12.7","C.S16.2",265,137,128,1.69545506386861,"4F1N,4F3T,4KRE,5GUH,5VM9,6KR6,6OON,7KX7,A0A0N4X8S8,A0A196SDB4,J9D5G4,Q389P5,C4LVV2,A0A2P6N8X7,A8BCK6,A2DPV7,A0A0G4H2S4,D2VMG4,A0A074TLL7,A0A0D1ZAJ4,Q1K660,A0A164ZA52,A0A383WDW5,I0YVB2,R7QGN7,A0A2C5Z0M1,A0CB11,R9ACY5,A0A1Z5TVE5,W7XD45,A0A1U7LLR0,A0A4S2MWZ7,G7DVX0,V6R0U9,G4N9J3,E3KLI3,B7Q5I1,D5GGK8,S8ANP9,A0A139AUH8,L2GMR6,U4LBG4,A0A177URI1,O74957,A0A3N4IGK1,A6N7Y9,T1KZ60,A0A250WXN5,A0A2G8JLH3,A0A1W0E4B5,A0A2J7QB22,S4RYE2,A0A2K3CW87,A0A388KES6,A0A226EFL3,A0A3S3PD82,A0A0L0TEV1,A0A1S3J512,G0QTT2,A0A1J1HRI1,C4V9J2,A0A075AN09,Q5TW24,U5HIG6,Q96J94,G2QEV0,A0A397UU01,K7ISV0,E9FUN9,A0A1S3CYL5,D7FQK3,T1GSU4,F4S231,A0A1D8PMK0,Q5BD61,A0A4D8YSQ3,J9JZ66,A0A0C2XG51,A0A165QYQ9,R7YY92,A0A3S1A0C3,A0A074YJ47,A0A2K1J482,A0A1Q3ENA6,O04379,A0A371I3C8,M8AEW7,A8P0D4,A0A2K3NY65,A0A409Y6G2,D8PZT7,A0A1D1W4K0,A7RQ46,W4YU94,A7BJS5,D8SNM6,A0A1J8PPA3,X1WG39,M5FQK2,Q69VD5,A0A2R6NSC2,Q9QZ81,Q8CJG0,A0A1D5NTU6,V2WTL2,A0A0V0YLH8,A0A139WDH0,A0A0R3W9Q7,A0A1Y1HWP2,G4T5G9,B7QCC4,M7BCJ9,E9GN30,Q7PZ41,A0A077Z361,R7U9I3,A0A1X7V1N5,A0A498N3A3,A0A3M0IQP5,A0A0L8GBV4,Q32KD4,A0A1J1JBJ0,E0W4C3,A0A482XDA9,A0A3P7EJD6,A0A2J7Q8V4,T1IBM6,A0A210QKF7,A0A423TSS1,A0A267E8R7,A0A1D2N447,A0A226D7A9,F6YK55,A0A2C9JGZ6,A0A1V9X9F0,A0A3Q0KUG5,T1FY40,1Z26,5AWH,5G5T,5I4A,A0A1I7IXT4,A0A2W1JZ37,A0A2S7WBN3,A0A420DFE6,A0A4V1VDY2,A0A368P5I0,C4L1M1,K9TPA9,A0A1L3JHM3,A0A1W6MIP2,A0A2U2J9E0,B1XJG0,A0A3D8L290,A0A1Q4R485,K9U8J6,A0A097QRL6,K9RC91,A0A0D8ZUC0,A0A139XGN8,A0A1T4Y3A2,A0YYT3,A0A2T1EFY0,G6FTN0,R6KUL9,A0A433NB65,A0A1Z4L0A1,K9UQR0,A0A2T1G8M7,K9VUN0,B7GJX9,A0A0P6X5X2,K9ZDE3,B0JXD6,A0A2T1LS63,A0A1Z4K1Y3,A0A1N6SSK9,A0A0P4UVI8,A0A0V7ZCG4,A0A1J0AGK2,K9PFF9,A0A2G9DT08,K9UEV4,R5XQK4,A0A1H3LE92,A0A496APJ8,A0A062U2W9,H0HWQ5,A0A1V9G9U4,S7VLM7,A0A0Q2M2Z1,H8KXJ0,D3S0S6,A0A2D1U4H7,I3TE64,A0A0B7I4Z6,A0LL61,Q8DKB1,A0A139WY18,A0A2T1E1K4,A0A1Q8ZD62,A0A4Q6XKV6,A0A1Z3HNN4,A0A239JE83,A0A2N4XBY2,R5JEI2,A0A0Q0ZC47,A0A2T0XH18,A0A1K1RQP7,A0A2T1EKT1,A0A0P0NGR6,A0A1X7IML5,A0A0A2LKJ7,K1L112,A0A0U3AL92,A0A1H3A054,A0A0C5JKF3,R5NJJ8,Q2JI93,A0A142Y7A9,A0A432MEQ5,A0A372DKU2,A0A3R7KLK4,C1F5Q7,A0A4R3EV39,A0A222F7P0,A0A1C9VH88,A0A2T2YMB1,A0A329TD61,A0A101R2A0,A0A1U9ND56,A0A4R7BQC4,A0A1H3DGN3,A0A1Q1FPH0,E0TGY3,A0A259TUP4,F6EYI8,A0A2S9Q9J0,A0A4Q2UIU6,H1YCU5,A0A1Q5ZS75,A0A1W2A082,A0A1H3X247,A0A2R5G167,A0A346PK63,A0A1H2RBI2,A0A1C3ZXN2,B9LVP8,M5RSF0,W0JW77,B7K585,F8D8G0,A0A343TL88,L0AJX6,A0A2A5QS34,A0A343JEE2,A0A3P3RGE5,A0A329TBQ3,A0A285N2A8,A0A0W1S8B8,A0A1V4C8L7,L9VRQ2,E4NRV1,A0A1I6HGN0,A0A1I0NI68,,",366,37
"369","N.H3.9","N.S11.11",223,138,85,2.63290707587383,"4F1N,4F3T,4KRE,6KR6,6OON,7KX7,7SWF,A0A196SDB4,C4LVV2,A2DPV7,A0A0G4H2S4,T1H8B3,R1FDF0,D2VMG4,A0A074TLL7,F4PH46,A0A3M7S814,S7WCF7,I0YVB2,R7QGN7,A0CB11,R9ACY5,D3BMP8,A0A1Z5TVE5,W7XD45,A0A1U7LLR0,A0A4S2MWZ7,K1VVQ6,A0A158P1R9,G7DVX0,E3KLI3,B7Q5I1,A0A1E3QC61,D5GGK8,S8ANP9,A0A139AUH8,U4LBG4,A0A177URI1,O74957,A0A3N4IGK1,A6N7Y9,A0A0E9NDK5,T1KZ60,A0A250WXN5,A0A2G8JLH3,Q5KAT1,L2GUF2,W2T741,A0A1W0E4B5,A0A2J7QB22,S4RYE2,A0A388KES6,A0A226EFL3,A0A3S3PD82,A0A0L0TEV1,A0A1S3J512,G0QTT2,A0A1J1HRI1,C4V9J2,Q9JMB7,A0A075AN09,Q5TW24,U5HIG6,A0A401PRI6,Q96J94,A0A397UU01,K7ISV0,A0A024FT57,H3HCL6,E9FUN9,A0A1S3CYL5,D7FQK3,A0A1Y1YHC8,T1GSU4,F4S231,A0A1D8PMK0,A0A2G5B1D8,Q5BD61,A0A1C7M8P2,A0A4D8YSQ3,J9JZ66,A0A0C2XG51,A0A158QZT6,A0A165QYQ9,T0SAU8,R7YY92,A0A074YJ47,A0A2K1J482,A0A1Q3ENA6,O04379,A0A371I3C8,M8AEW7,A8P0D4,A0A2K3NY65,F4NYW7,A0A409Y6G2,A0A0L0HAB7,D8PZT7,A0A1D1W4K0,A7RQ46,A7BJS5,D8SNM6,A0A1J8PPA3,X1WG39,M5FQK2,A0A2R6NSC2,A0A016WPN3,V2WTL2,A0A0V0YLH8,A0A139WDH0,A0A1Y1HWP2,G4T5G9,B7QCC4,E9GN30,Q7PZ41,A0A1X7V1N5,A0A0N4UKJ1,A0A0L8GBV4,Q32KD4,A0A1J1JBJ0,E0W4C3,A0A482XDA9,A0A3P7EJD6,J9K2Z4,A0A2J7Q8V4,T1IBM6,V3ZRX0,A0A210QKF7,A0A423TSS1,K1PT78,A0A267E8R7,A0A1D2N447,A0A226D7A9,F6YK55,T1KTE4,A0A1V9X9F0,K5X5Z7,A0A3Q0KUG5,1Z26,3DLB,5AWH,5G5T,5I4A,6QZK,A0A1I3LMA1,A0A3D8L290,A0A097QRL6,A0A0B0H9B4,R6KUL9,B7GJX9,A0A1N6SSK9,A0A2G9DT08,Q9L1X1,A0A060HNJ0,A0A235B542,R5XQK4,A0A062U2W9,H0HWQ5,A0A1I2ZGP1,A0A317EJY3,A0A1I2BD20,F8ERC7,A0A1A5X8H4,A0A1I2T6Q1,A0A0Q2M2Z1,H8KXJ0,D3S0S6,A0A2D1U4H7,I3TE64,A0LL61,Q8DKB1,A0A1J1EK56,Q53W94,A0A2T1EKT1,A0A0U3AL92,A0A1H3A054,K9XZC6,A0A0C1VHB4,Q31N05,A0A0C5JKF3,R5NJJ8,A5D4D9,Q2JI93,A0A142Y7A9,A0A432MEQ5,A0A372DKU2,A0A3R7KLK4,C1F5Q7,A0A1C9VH88,A0A2T2YMB1,A0A101R2A0,A0A1E3XF49,A0A1U9ND56,A0A4R7BQC4,A0A1H3DGN3,A0A1Q1FPH0,A0A259TUP4,F6EYI8,A0A2S9Q9J0,A0A4Q2UIU6,A0A1H0LH25,A0A318LG42,H1YCU5,L0JS08,A0A345E7N0,M0AF24,A0A1W2A082,A0A0C1XUA0,M0D2X3,A0A2R5G167,A0A346PK63,A0A1H2RBI2,B9LVP8,M5RSF0,B7K585,A0A343TL88,L0AJX6,A0A2A5QS34,A0A343JEE2,A0A3P3RGE5,A0A285N2A8,A0A0W1S8B8,L9VRQ2,,",366,37
"374","C.L20.6","C.S13.2",211,139,72,1.65777378097522,"4F3T,4KRE,6OON,7KX7,7SWF,A0A163JTZ6,A0A196SDB4,C4LVV2,T1H8B3,R1FDF0,S4RWI0,D2VMG4,A0A074TLL7,F4PH46,A0A3M7S814,A0A164ZA52,A0A383WDW5,Q54G64,R7QGN7,C1DZY0,A0A2C5Z0M1,A0CB11,D3BMP8,A0A1Z5TVE5,W7XD45,A0A4S2MWZ7,A0A158P1R9,G4N9J3,B7Q5I1,A0A1E3QC61,D5GGK8,S8ANP9,A0A139AUH8,O74957,A0A3N4IGK1,A6N7Y9,A0A2G8JLH3,W2T741,S4RYE2,A0A388KES6,A0A226EFL3,A0A3S3PD82,A0A1S3J512,G0QTT2,A0A1J1HRI1,Q9JMB7,Q5TW24,U5HIG6,A0A401PRI6,Q96J94,A0A2B4RHN2,A0A397UU01,A0A2T7PFL8,K7ISV0,A0A024FT57,H3HCL6,A0A0G4IME3,E9FUN9,A0A1S3CYL5,D7FQK3,A0A1Y1YHC8,T1GSU4,Q5BD61,A0A4D8YSQ3,A0A158PJG6,J9JZ66,A0A158QZT6,A0A165QYQ9,R7YY92,A0A3S1A0C3,A0A074YJ47,A0A1Q3ENA6,O04379,A0A371I3C8,M8AEW7,A8P0D4,A0A2K3NY65,F4NYW7,A0A409Y6G2,A0A0L0HAB7,D8PZT7,A0A1D1W4K0,A7RQ46,W4YU94,A7BJS5,D8SNM6,A0A1J8PPA3,X1WG39,M5FQK2,Q69VD5,A0A2R6NSC2,A0A0D8XL16,A0A016WPN3,Q9QZ81,G5EES3,A0A0K0EFP6,Q8CJG0,A0A1D5NTU6,A0A0V0YLH8,A0A139WDH0,A0A0R3W9Q7,H3DS31,A0A1Y1HWP2,G4T5G9,B7QCC4,A0A0B2UV00,M7BCJ9,E9GN30,Q7PZ41,A0A077Z361,R7U9I3,A0A1X7V1N5,A0A0K0JDP1,A0A0N4UKJ1,A0A498N3A3,A0A3M0IQP5,A0A0L8GBV4,Q32KD4,A0A1J1JBJ0,E0W4C3,A0A482XDA9,A0A3P7EJD6,J9K2Z4,A0A2J7Q8V4,T1IBM6,V3ZRX0,A0A210QKF7,A0A423TSS1,K1PT78,A0A267E8R7,A0A1D2N447,A0A226D7A9,F6YK55,T1KTE4,A0A2C9JGZ6,A0A1V9X9F0,K5X5Z7,A0A3Q0KUG5,T1FY40,1YVU,3DLB,E0ST67,K9TPA9,A0A2Z6E1D5,A0A326U7G5,A0A3D8L290,A0A1Q4R485,K9U8J6,K9RC91,A0A0D8ZUC0,A0A139XGN8,A0A2T1EFY0,G6FTN0,A0A433NB65,K9UQR0,A0A2T1G8M7,K9VUN0,A0A0P6X5X2,K9ZDE3,B0JXD6,A0A2T1LS63,A0A1Z4K1Y3,A0A2Z6E0R7,A0A0V7ZCG4,K9PFF9,A0A2G9DT08,K9UEV4,Q9L1X1,A0A496APJ8,A0A1V9G9U4,S7VLM7,A0A1I2T6Q1,A0A1R3T9N6,H8KXJ0,D3S0S6,A0A2D1U4H7,A0A0B7I4Z6,A0LL61,A0A139WY18,A0A2T1E1K4,A0A1Q8ZD62,A0A4Q6XKV6,A0A1Z3HNN4,A0A2N4XBY2,Q53W94,R5JEI2,A0A0Q0ZC47,A0A2T0XH18,A0A1V4CHV0,A0A1K1RQP7,A0A1N6LUI7,A0A0P0NGR6,A0A1X7IML5,A0A0A2LKJ7,K1L112,A5D4D9,A0A142Y7A9,A0A1P8WP90,A0A329TD61,A0A101R2A0,A0A1U9ND56,A0A4R7BQC4,A0A259TUP4,F6EYI8,A0A2S9Q9J0,A0A4Q2UIU6,A0A1H0LH25,A0A318LG42,A0A345E7N0,A0A1H3X247,B9LVP8,,",366,37
"376","C.S12.4","C.S16.5",260,139,121,1.76642487662762,"4F1N,4F3T,4KRE,5GUH,6KR6,6OON,A0A0N4X8S8,A0A196SDB4,C4LVV2,A8BCK6,A2DPV7,A0A0G4H2S4,R1FDF0,D2VMG4,A0A0D1ZAJ4,Q1K660,F4PH46,A0A164ZA52,Q54G64,C1DZY0,A0A2C5Z0M1,A0CB11,R9ACY5,D3BMP8,A0A1Z5TVE5,W7XD45,A0A1U7LLR0,A0A4S2MWZ7,A0A158P1R9,V6R0U9,G4N9J3,E3KLI3,A0A1E3QC61,D5GGK8,S8ANP9,A0A139AUH8,U4LBG4,O74957,A0A3N4IGK1,A6N7Y9,A0A0E9NDK5,Q5KAT1,A0A1W0E4B5,A0A2J7QB22,S4RYE2,A0A226EFL3,A0A3S3PD82,A0A0L0TEV1,A0A1S3J512,G0QTT2,A0A1J1HRI1,C4V9J2,Q9JMB7,A0A075AN09,U5HIG6,A0A401PRI6,Q96J94,A0A2B4RHN2,G2QEV0,A0A2T7PFL8,K7ISV0,A0A024FT57,H3HCL6,A0A0G4IME3,E9FUN9,A0A1S3CYL5,A0A1Y1YHC8,T1GSU4,F4S231,Q5BD61,A0A1C7M8P2,A0A4D8YSQ3,A0A158PJG6,J9JZ66,A0A158QZT6,T0SAU8,R7YY92,A0A3S1A0C3,A0A074YJ47,A0A2K1J482,O04379,A0A371I3C8,M8AEW7,A8P0D4,A0A2K3NY65,A0A0L0HAB7,D8PZT7,A0A1D1W4K0,A7RQ46,W4YU94,A7BJS5,D8SNM6,A0A1J8PPA3,X1WG39,M5FQK2,Q69VD5,A0A2R6NSC2,A0A0D8XL16,A0A016WPN3,Q9QZ81,G5EES3,A0A0K0EFP6,Q8CJG0,A0A1D5NTU6,V2WTL2,A0A0V0YLH8,A0A139WDH0,A0A0R3W9Q7,H3DS31,B7QCC4,A0A0B2UV00,E9GN30,Q7PZ41,A0A077Z361,R7U9I3,A0A0K0JDP1,A0A0N4UKJ1,A0A498N3A3,Q32KD4,A0A1J1JBJ0,E0W4C3,A0A482XDA9,A0A3P7EJD6,J9K2Z4,A0A2J7Q8V4,T1IBM6,A0A210QKF7,A0A423TSS1,K1PT78,A0A267E8R7,A0A1D2N447,A0A226D7A9,F6YK55,T1KTE4,A0A2C9JGZ6,A0A1V9X9F0,K5X5Z7,A0A3Q0KUG5,T1FY40,1YVU,5AWH,5G5T,5I4A,6QZK,7R8K,A0A1I7IXT4,A0A2W1JZ37,A0A2S7WBN3,A0A420DFE6,E0ST67,A0A4V1VDY2,A0A368P5I0,C4L1M1,A0A4R1RMM2,A0A1Y2RDH8,A0A1M5ZSR3,A0A0K8QX04,K9TPA9,A0A1L3JHM3,A0A1W6MIP2,A0A2U2J9E0,A0A142XB92,A0A3D8L290,K9U8J6,K9RC91,A0A0D8ZUC0,A0A139XGN8,A0A0B0H9B4,A0YYT3,A0A2T1EFY0,G6FTN0,R6KUL9,A0A433NB65,A0A1Z4L0A1,K9UQR0,A0A2T1G8M7,K9VUN0,B7GJX9,A0A0P6X5X2,K9ZDE3,B0JXD6,A0A2T1LS63,A0A1Z4K1Y3,A0A1N6SSK9,A0A0P4UVI8,A0A0V7ZCG4,A0A1J0AGK2,K9PFF9,A0A2G9DT08,K9UEV4,Q9L1X1,A0A060HNJ0,A0A235B542,R5XQK4,A0A1H3LE92,A0A496APJ8,A0A062U2W9,H0HWQ5,A0A1V9G9U4,A0A1I2ZGP1,A0A317EJY3,A0A1I2BD20,F8ERC7,S7VLM7,A0A1I2T6Q1,A0A1R3T9N6,H8KXJ0,A0A2D1U4H7,A0A0B7I4Z6,Q8DKB1,A0A139WY18,A0A1J1EK56,A0A2T1E1K4,A0A4Q6XKV6,A0A1Z3HNN4,A0A239JE83,A0A2N4XBY2,Q53W94,R5JEI2,A0A0Q0ZC47,A0A2T0XH18,A0A1K1RQP7,A0A2T1EKT1,A0A0P0NGR6,A0A1X7IML5,A0A0A2LKJ7,K1L112,A0A0U3AL92,A0A1H3A054,Q31N05,A0A0C5JKF3,A5D4D9,Q2JI93,A0A142Y7A9,A0A432MEQ5,A0A372DKU2,C1F5Q7,A0A1P8WP90,A0A222F7P0,A0A2T2YMB1,A0A329TD61,A0A101R2A0,A0A1Q1FPH0,E0TGY3,A0A259TUP4,A0A4Q2UIU6,A0A1H0LH25,A0A318LG42,H1YCU5,A0A1Q5ZS75,A0A345E7N0,A0A1W2A082,A0A2R5G167,A0A1H2RBI2,B9LVP8,M5RSF0,W0JW77,B7K585,L0AJX6,A0A2A5QS34,,",366,37
"383","C.S8.2","C.S8.4",181,141,40,1.93998226950355,"4F1N,4F3T,4KRE,5VM9,6KR6,6OON,7KX7,7SWF,A0A163JTZ6,A0A196SDB4,J9D5G4,C4LVV2,A0A2P6N8X7,A8BCK6,R1FDF0,S4RWI0,D2VMG4,A0A074TLL7,F4PH46,S7WCF7,I0YVB2,R7QGN7,C1DZY0,A0CB11,R9ACY5,A0A1U7LLR0,A0A4S2MWZ7,K1VVQ6,A0A158P1R9,V6R0U9,E3KLI3,A0A1E3QC61,S8ANP9,A0A139AUH8,U4LBG4,A0A177URI1,O74957,A0A0E9NDK5,T1KZ60,A0A250WXN5,Q5KAT1,L2GUF2,W2T741,A0A1W0E4B5,A0A2J7QB22,S4RYE2,A0A388KES6,A0A226EFL3,A0A0L0TEV1,A0A1S3J512,G0QTT2,C4V9J2,A0A075AN09,Q5TW24,G2QEV0,A0A397UU01,A0A2T7PFL8,A0A024FT57,H3HCL6,A0A0G4IME3,A0A1S3CYL5,D7FQK3,A0A1Y1YHC8,T1GSU4,F4S231,A0A1D8PMK0,A0A4D8YSQ3,A0A158PJG6,A0A0C2XG51,A0A158QZT6,A0A165QYQ9,T0SAU8,R7YY92,A0A3S1A0C3,A0A074YJ47,A0A2K1J482,A0A1Q3ENA6,O04379,A0A371I3C8,M8AEW7,A8P0D4,A0A2K3NY65,F4NYW7,A0A409Y6G2,A0A0L0HAB7,D8PZT7,A0A1D1W4K0,A7RQ46,W4YU94,A7BJS5,D8SNM6,A0A1J8PPA3,X1WG39,Q69VD5,A0A2R6NSC2,A0A0D8XL16,A0A016WPN3,Q9QZ81,G5EES3,A0A0K0EFP6,Q8CJG0,A0A1D5NTU6,V2WTL2,A0A0V0YLH8,A0A139WDH0,A0A0R3W9Q7,H3DS31,A0A1Y1HWP2,B7QCC4,A0A0B2UV00,M7BCJ9,E9GN30,Q7PZ41,A0A077Z361,R7U9I3,A0A1X7V1N5,A0A0K0JDP1,A0A0N4UKJ1,A0A498N3A3,A0A3M0IQP5,Q32KD4,A0A1J1JBJ0,E0W4C3,A0A482XDA9,A0A3P7EJD6,J9K2Z4,A0A2J7Q8V4,T1IBM6,V3ZRX0,A0A210QKF7,A0A423TSS1,K1PT78,A0A267E8R7,A0A1D2N447,A0A226D7A9,F6YK55,T1KTE4,A0A2C9JGZ6,A0A1V9X9F0,K5X5Z7,T1FY40,5AWH,5G5T,5I4A,E8N0K8,Q11QW7,A0A1M5ZSR3,A0A2Z6E1D5,A0A097QRL6,A0A1T4Y3A2,A0A0P6X5X2,Q9L1X1,A0A060HNJ0,A0A062U2W9,A0A1I2ZGP1,A0A317EJY3,A0A1A5X8H4,A0A1R3T9N6,D3S0S6,A0A2D1U4H7,A0A0B7I4Z6,A0LL61,A0A4Q6XKV6,A0A0Q0ZC47,A0A2T0XH18,A0A1K1RQP7,A0A0P0NGR6,A0A1X7IML5,K1L112,A0A1H3A054,A5D4D9,A0A4R3EV39,A0A222F7P0,A0A1C9VH88,A0A2T2YMB1,E0TGY3,A0A4Q2UIU6,A0A1H0LH25,L0AJX6,A0A2A5QS34,A0A285N2A8,,",366,37
"386","C.H10.13","C.H3.7",202,142,60,7.23415492957746,"4F1N,4F3T,4KRE,5VM9,6OON,7SWF,A0A163JTZ6,J9D5G4,A0A2P6N8X7,A0A074TLL7,A0A0D1ZAJ4,Q1K660,A0A3M7S814,A0A164ZA52,S7WCF7,I0YVB2,R7QGN7,C1DZY0,A0A2C5Z0M1,R9ACY5,A0A1Z5TVE5,A0A1U7LLR0,A0A4S2MWZ7,G7DVX0,V6R0U9,G4N9J3,E3KLI3,A0A1E3QC61,D5GGK8,S8ANP9,A0A139AUH8,L2GMR6,U4LBG4,O74957,A0A3N4IGK1,A0A0E9NDK5,A0A250WXN5,A0A2G8JLH3,Q5KAT1,L2GUF2,W2T741,A0A1W0E4B5,A0A2K3CW87,A0A388KES6,A0A0L0TEV1,G0QTT2,C4V9J2,A0A075AN09,U5HIG6,G2QEV0,A0A397UU01,A0A2T7PFL8,A0A024FT57,H3HCL6,A0A0G4IME3,D7FQK3,A0A1Y1YHC8,F4S231,A0A1D8PMK0,A0A2G5B1D8,Q5BD61,A0A1C7M8P2,A0A4D8YSQ3,A0A158PJG6,J9JZ66,A0A0C2XG51,A0A158QZT6,A0A165QYQ9,T0SAU8,R7YY92,A0A3S1A0C3,A0A074YJ47,A0A2K1J482,A0A1Q3ENA6,O04379,A0A371I3C8,M8AEW7,A8P0D4,A0A2K3NY65,F4NYW7,A0A409Y6G2,A0A0L0HAB7,D8PZT7,A0A1D1W4K0,A7RQ46,W4YU94,A7BJS5,D8SNM6,A0A1J8PPA3,X1WG39,M5FQK2,Q69VD5,A0A2R6NSC2,A0A0D8XL16,A0A016WPN3,Q9QZ81,G5EES3,A0A0K0EFP6,Q8CJG0,A0A1D5NTU6,V2WTL2,A0A0V0YLH8,A0A139WDH0,A0A0R3W9Q7,H3DS31,A0A1Y1HWP2,G4T5G9,B7QCC4,A0A0B2UV00,M7BCJ9,E9GN30,Q7PZ41,A0A077Z361,R7U9I3,A0A1X7V1N5,A0A0K0JDP1,A0A0N4UKJ1,A0A498N3A3,A0A3M0IQP5,A0A0L8GBV4,Q32KD4,A0A1J1JBJ0,E0W4C3,A0A482XDA9,A0A3P7EJD6,J9K2Z4,A0A2J7Q8V4,T1IBM6,V3ZRX0,A0A210QKF7,A0A423TSS1,K1PT78,A0A267E8R7,A0A1D2N447,A0A226D7A9,F6YK55,T1KTE4,A0A2C9JGZ6,A0A1V9X9F0,K5X5Z7,A0A3Q0KUG5,T1FY40,5AWH,A0A1M5ZSR3,A0A097QRL6,A0A0D8ZUC0,A0A139XGN8,A0A1T4Y3A2,B6YTQ5,A0A2T1EFY0,G6FTN0,A0A433NB65,A0A1Z4L0A1,K9UQR0,K9VUN0,K9ZDE3,A0A2T1LS63,A0A1Z4K1Y3,A0A1J0AGK2,K9PFF9,A0A2G9DT08,K9UEV4,Q9L1X1,A0A1I2T6Q1,H8KXJ0,A0A2D1U4H7,A0LL61,A0A1J1EK56,A0A2T1E1K4,A0A1Z3HNN4,A0A239JE83,A0A2N4XBY2,Q53W94,R5JEI2,A0A0Q0ZC47,A0A2T0XH18,A0A1K1RQP7,A0A1X7IML5,A0A0A2LKJ7,K1L112,A0A1H3A054,E0UCX3,A0A0C1VHB4,A5D4D9,A0A142Y7A9,A0A432MEQ5,C1F5Q7,A0A1P8WP90,A0A101R2A0,A0A1U9ND56,A0A4R7BQC4,E0TGY3,A0A259TUP4,A0A4Q2UIU6,A0A1H0LH25,A0A318LG42,A0A2R5G167,B7K585,F8D8G0,A0A329TBQ3,A0A1V4C8L7,L9VRQ2,,",366,37
"390","C.L9.4","C.S6.2",214,142,72,1.48620892018779,"4F1N,4F3T,4KRE,5GUH,6KR6,6OON,7KX7,7SWF,A0A163JTZ6,A0A0N4X8S8,C4LVV2,A0A2P6N8X7,T1H8B3,S4RWI0,D2VMG4,A0A3M7S814,A0A383WDW5,S7WCF7,I0YVB2,R7QGN7,R9ACY5,A0A4S2MWZ7,K1VVQ6,A0A158P1R9,G7DVX0,G4N9J3,E3KLI3,B7Q5I1,A0A1E3QC61,A0A139AUH8,U4LBG4,A0A177URI1,O74957,A0A3N4IGK1,A6N7Y9,A0A0E9NDK5,T1KZ60,A0A250WXN5,A0A2G8JLH3,Q5KAT1,W2T741,A0A2J7QB22,S4RYE2,A0A2K3CW87,A0A388KES6,A0A226EFL3,A0A3S3PD82,A0A0L0TEV1,A0A1S3J512,A0A1J1HRI1,C4V9J2,Q9JMB7,A0A075AN09,Q5TW24,U5HIG6,A0A401PRI6,Q96J94,A0A2B4RHN2,G2QEV0,A0A397UU01,A0A2T7PFL8,K7ISV0,H3HCL6,A0A0G4IME3,E9FUN9,A0A1S3CYL5,D7FQK3,A0A1Y1YHC8,T1GSU4,F4S231,A0A1D8PMK0,Q5BD61,A0A4D8YSQ3,A0A158PJG6,J9JZ66,A0A0C2XG51,A0A158QZT6,A0A165QYQ9,T0SAU8,R7YY92,A0A3S1A0C3,A0A1Q3ENA6,A0A371I3C8,A8P0D4,A0A409Y6G2,A0A0L0HAB7,D8PZT7,A0A1D1W4K0,A7RQ46,W4YU94,A7BJS5,A0A1J8PPA3,X1WG39,M5FQK2,A0A0D8XL16,A0A016WPN3,Q9QZ81,G5EES3,A0A0K0EFP6,Q8CJG0,A0A1D5NTU6,V2WTL2,A0A0V0YLH8,A0A139WDH0,A0A0R3W9Q7,H3DS31,G4T5G9,B7QCC4,A0A0B2UV00,M7BCJ9,E9GN30,Q7PZ41,A0A077Z361,R7U9I3,A0A1X7V1N5,A0A0K0JDP1,A0A0N4UKJ1,A0A498N3A3,A0A3M0IQP5,A0A0L8GBV4,Q32KD4,A0A1J1JBJ0,E0W4C3,A0A482XDA9,A0A3P7EJD6,J9K2Z4,A0A2J7Q8V4,T1IBM6,V3ZRX0,A0A210QKF7,A0A423TSS1,K1PT78,A0A267E8R7,A0A1D2N447,A0A226D7A9,F6YK55,T1KTE4,A0A2C9JGZ6,A0A1V9X9F0,K5X5Z7,A0A3Q0KUG5,T1FY40,1YVU,5I4A,E8N0K8,A0A328VKE4,A0A1M5ZSR3,A0A0M2PXX3,A0A1I3LMA1,A0A142XB92,L8D0R3,A0A1T4Y3A2,R6KUL9,K9UQR0,A0A0P6X5X2,Q9L1X1,A0A235B542,A0A496APJ8,A0A062U2W9,H0HWQ5,A0A1V9G9U4,A0A1I2ZGP1,A0A317EJY3,A0A1I2BD20,A0A1A5X8H4,A0A1R3T9N6,A0A139WY18,A0A1J1EK56,A0A2T1E1K4,A0A1Q8ZD62,A0A1Z3HNN4,R5JEI2,A0A1V4CHV0,A0A1N6LUI7,A0A0U3AL92,A0A1H3A054,A0A0C5JKF3,A0A142Y7A9,A0A432MEQ5,A0A372DKU2,A0A3R7KLK4,C1F5Q7,A0A4R3EV39,A0A1C9VH88,A0A329TD61,A0A1E3XF49,A0A1U9ND56,A0A4R7BQC4,A0A1H3DGN3,A0A1Q1FPH0,E0TGY3,A0A1H0LH25,L0JS08,A0A345E7N0,M0AF24,A0A1W2A082,A0A1H3X247,A0A0C1XUA0,M0D2X3,A0A2R5G167,A0A346PK63,A0A1H2RBI2,B9LVP8,M5RSF0,B7K585,A0A343TL88,A0A3P3RGE5,A0A329TBQ3,A0A0W1S8B8,A0A1V4C8L7,L9VRQ2,E4NRV1,A0A1I6HGN0,A0A1I0NI68,,",366,37
"395","N.S3.7","N.S5.2",215,142,73,1.80074281304264,"4F1N,4KRE,5GUH,6OON,7SWF,A0A2P6N8X7,A2DPV7,T1H8B3,S4RWI0,D2VMG4,A0A0D1ZAJ4,Q1K660,F4PH46,A0A164ZA52,I0YVB2,C1DZY0,A0A2C5Z0M1,A0CB11,R9ACY5,D3BMP8,A0A1Z5TVE5,W7XD45,A0A1U7LLR0,A0A4S2MWZ7,K1VVQ6,A0A158P1R9,G7DVX0,G4N9J3,B7Q5I1,A0A1E3QC61,D5GGK8,S8ANP9,L2GMR6,U4LBG4,A0A177URI1,O74957,A0A3N4IGK1,A6N7Y9,A0A0E9NDK5,A0A250WXN5,A0A2G8JLH3,L2GUF2,A0A1W0E4B5,A0A2J7QB22,S4RYE2,A0A2K3CW87,A0A388KES6,A0A226EFL3,A0A3S3PD82,A0A0L0TEV1,A0A1S3J512,G0QTT2,C4V9J2,Q9JMB7,A0A075AN09,Q5TW24,A0A401PRI6,Q96J94,A0A2B4RHN2,A0A397UU01,A0A2T7PFL8,K7ISV0,A0A024FT57,A0A0G4IME3,E9FUN9,A0A1S3CYL5,D7FQK3,A0A1Y1YHC8,T1GSU4,A0A2G5B1D8,Q5BD61,A0A1C7M8P2,A0A4D8YSQ3,A0A158PJG6,J9JZ66,A0A158QZT6,T0SAU8,R7YY92,A0A3S1A0C3,A0A2K1J482,A0A1Q3ENA6,O04379,A0A371I3C8,M8AEW7,A8P0D4,A0A2K3NY65,F4NYW7,A0A0L0HAB7,D8PZT7,A0A1D1W4K0,W4YU94,A7BJS5,D8SNM6,A0A1J8PPA3,X1WG39,Q69VD5,A0A2R6NSC2,A0A0D8XL16,A0A016WPN3,G5EES3,A0A0K0EFP6,V2WTL2,A0A0V0YLH8,A0A139WDH0,A0A0R3W9Q7,H3DS31,G4T5G9,B7QCC4,A0A0B2UV00,M7BCJ9,E9GN30,Q7PZ41,A0A077Z361,R7U9I3,A0A1X7V1N5,A0A0K0JDP1,A0A0N4UKJ1,A0A498N3A3,A0A3M0IQP5,A0A0L8GBV4,Q32KD4,A0A1J1JBJ0,E0W4C3,A0A482XDA9,A0A3P7EJD6,J9K2Z4,A0A2J7Q8V4,T1IBM6,V3ZRX0,A0A210QKF7,A0A423TSS1,K1PT78,A0A267E8R7,A0A1D2N447,A0A226D7A9,F6YK55,T1KTE4,A0A2C9JGZ6,A0A1V9X9F0,K5X5Z7,A0A3Q0KUG5,T1FY40,3DLB,5G5T,A0A0P6X5X2,A0A062U2W9,H0HWQ5,A0A317EJY3,A0A1I2BD20,F8ERC7,S7VLM7,A0A0B7I4Z6,A0LL61,A0A1J1EK56,A0A4Q6XKV6,A0A239JE83,A0A2N4XBY2,Q53W94,R5JEI2,A0A0Q0ZC47,A0A2T0XH18,A0A1V4CHV0,A0A1K1RQP7,A0A0P0NGR6,A0A1X7IML5,A0A0A2LKJ7,K1L112,A0A0U3AL92,A0A1H3A054,E0UCX3,K9XZC6,A0A0C5JKF3,A5D4D9,A0A372DKU2,C1F5Q7,A0A4R3EV39,A0A1P8WP90,A0A222F7P0,A0A1C9VH88,A0A2T2YMB1,A0A329TD61,A0A101R2A0,A0A1E3XF49,A0A1U9ND56,A0A4R7BQC4,E0TGY3,F6EYI8,A0A2S9Q9J0,A0A4Q2UIU6,H1YCU5,L0JS08,A0A1Q5ZS75,A0A345E7N0,A0A1W2A082,A0A0C1XUA0,M0D2X3,A0A2R5G167,A0A346PK63,R7RTW6,A0A1H2RBI2,A0A1C3ZXN2,B9LVP8,M5RSF0,F8D8G0,A0A343TL88,A0A2A5QS34,A0A343JEE2,A0A3P3RGE5,A0A329TBQ3,A0A285N2A8,A0A0W1S8B8,A0A1V4C8L7,L9VRQ2,E4NRV1,A0A1I6HGN0,,",366,37
"396","C.H10.11","C.H10.15",233,143,90,1.99638694638695,"4F1N,4F3T,4KRE,5GUH,6KR6,6OON,7KX7,A0A163JTZ6,J9D5G4,A2DPV7,A0A0G4H2S4,D2VMG4,A0A074TLL7,A0A0D1ZAJ4,Q1K660,F4PH46,Q54G64,I0YVB2,R7QGN7,C1DZY0,A0CB11,R9ACY5,D3BMP8,W7XD45,A0A1U7LLR0,A0A4S2MWZ7,K1VVQ6,A0A158P1R9,G7DVX0,V6R0U9,G4N9J3,E3KLI3,B7Q5I1,A0A1E3QC61,A0A139AUH8,L2GMR6,O74957,A6N7Y9,A0A0E9NDK5,T1KZ60,A0A250WXN5,A0A2G8JLH3,Q5KAT1,L2GUF2,W2T741,A0A1W0E4B5,A0A2J7QB22,S4RYE2,A0A2K3CW87,A0A388KES6,A0A226EFL3,A0A3S3PD82,A0A0L0TEV1,A0A1S3J512,G0QTT2,A0A1J1HRI1,C4V9J2,Q9JMB7,A0A075AN09,Q5TW24,U5HIG6,A0A401PRI6,Q96J94,A0A2B4RHN2,G2QEV0,A0A397UU01,A0A2T7PFL8,K7ISV0,H3HCL6,A0A0G4IME3,E9FUN9,A0A1S3CYL5,D7FQK3,A0A1Y1YHC8,T1GSU4,F4S231,A0A1D8PMK0,Q5BD61,A0A1C7M8P2,A0A4D8YSQ3,A0A158PJG6,J9JZ66,R7YY92,A0A074YJ47,A0A2K1J482,O04379,A0A371I3C8,M8AEW7,A8P0D4,A0A2K3NY65,F4NYW7,A0A0L0HAB7,D8PZT7,A0A1D1W4K0,A7RQ46,A7BJS5,D8SNM6,X1WG39,Q69VD5,A0A2R6NSC2,A0A0D8XL16,A0A016WPN3,G5EES3,A0A0K0EFP6,Q8CJG0,A0A1D5NTU6,V2WTL2,A0A0V0YLH8,A0A139WDH0,A0A0R3W9Q7,H3DS31,A0A1Y1HWP2,B7QCC4,A0A0B2UV00,M7BCJ9,Q7PZ41,A0A077Z361,R7U9I3,A0A1X7V1N5,A0A0K0JDP1,A0A0N4UKJ1,A0A3M0IQP5,A0A0L8GBV4,Q32KD4,A0A1J1JBJ0,E0W4C3,A0A3P7EJD6,J9K2Z4,A0A2J7Q8V4,T1IBM6,V3ZRX0,A0A210QKF7,A0A423TSS1,K1PT78,A0A267E8R7,A0A1D2N447,A0A226D7A9,F6YK55,A0A2C9JGZ6,A0A1V9X9F0,K5X5Z7,A0A3Q0KUG5,T1FY40,1Z26,5AWH,5G5T,A0A1I7IXT4,A0A2W1JZ37,A0A2S7WBN3,A0A420DFE6,E0ST67,A0A4V1VDY2,A0A368P5I0,C4L1M1,A0A4R1RMM2,A0A1Y2RDH8,Q11QW7,A0A1M5ZSR3,A0A0K8QX04,A0A1L3JHM3,A0A1W6MIP2,A0A2U2J9E0,B1XJG0,A0A3D8L290,A0A1T4Y3A2,B6YTQ5,A0A2G9DT08,Q9L1X1,A0A060HNJ0,A0A235B542,A0A496APJ8,A0A1V9G9U4,A0A1A5X8H4,A0A1I2T6Q1,A0A0Q2M2Z1,H8KXJ0,A0A2D1U4H7,A0A0B7I4Z6,A0LL61,A0A139WY18,A0A2T1E1K4,A0A1Q8ZD62,A0A4Q6XKV6,A0A1Z3HNN4,A0A239JE83,A0A2N4XBY2,Q53W94,R5JEI2,A0A2T0XH18,A0A1V4CHV0,A0A1K1RQP7,A0A1N6LUI7,A0A0P0NGR6,A0A1X7IML5,A0A0A2LKJ7,K1L112,A0A0U3AL92,A0A1H3A054,E0UCX3,A0A0C5JKF3,A5D4D9,A0A142Y7A9,A0A432MEQ5,A0A372DKU2,C1F5Q7,A0A4R3EV39,A0A222F7P0,A0A1C9VH88,A0A2T2YMB1,A0A101R2A0,A0A1U9ND56,A0A4R7BQC4,E0TGY3,A0A259TUP4,F6EYI8,A0A2S9Q9J0,A0A4Q2UIU6,A0A1H0LH25,A0A318LG42,A0A2R5G167,A0A346PK63,M5RSF0,B7K585,F8D8G0,A0A343TL88,A0A3P3RGE5,A0A329TBQ3,A0A285N2A8,A0A0W1S8B8,A0A1V4C8L7,L9VRQ2,E4NRV1,A0A1I6HGN0,,",366,37
"397","C.H10.7","C.S8.7",247,143,104,2.05987762237762,"4F1N,4KRE,5VM9,6KR6,7KX7,7SWF,A0A163JTZ6,A0A196SDB4,J9D5G4,A0A2P6N8X7,A2DPV7,A0A0G4H2S4,D2VMG4,A0A074TLL7,A0A3M7S814,S7WCF7,I0YVB2,R7QGN7,C1DZY0,A0A2C5Z0M1,R9ACY5,D3BMP8,A0A1Z5TVE5,W7XD45,A0A1U7LLR0,A0A158P1R9,G7DVX0,G4N9J3,E3KLI3,B7Q5I1,L2GMR6,O74957,A6N7Y9,T1KZ60,A0A250WXN5,A0A2G8JLH3,Q5KAT1,L2GUF2,W2T741,A0A1W0E4B5,S4RYE2,A0A2K3CW87,A0A388KES6,A0A226EFL3,A0A3S3PD82,A0A0L0TEV1,G0QTT2,C4V9J2,Q9JMB7,A0A075AN09,U5HIG6,A0A401PRI6,Q96J94,A0A2B4RHN2,A0A397UU01,A0A2T7PFL8,A0A024FT57,H3HCL6,A0A0G4IME3,E9FUN9,A0A1S3CYL5,D7FQK3,A0A1Y1YHC8,F4S231,A0A1D8PMK0,Q5BD61,A0A1C7M8P2,A0A4D8YSQ3,A0A158PJG6,J9JZ66,A0A0C2XG51,A0A158QZT6,A0A165QYQ9,T0SAU8,R7YY92,A0A3S1A0C3,A0A074YJ47,A0A2K1J482,A0A1Q3ENA6,O04379,A0A371I3C8,M8AEW7,A8P0D4,A0A2K3NY65,F4NYW7,A0A0L0HAB7,D8PZT7,A0A1D1W4K0,A7RQ46,W4YU94,A7BJS5,D8SNM6,A0A1J8PPA3,X1WG39,Q69VD5,A0A2R6NSC2,A0A0D8XL16,A0A016WPN3,Q9QZ81,G5EES3,A0A0K0EFP6,Q8CJG0,A0A1D5NTU6,V2WTL2,A0A0V0YLH8,A0A139WDH0,A0A0R3W9Q7,H3DS31,A0A1Y1HWP2,B7QCC4,A0A0B2UV00,M7BCJ9,E9GN30,Q7PZ41,A0A077Z361,R7U9I3,A0A1X7V1N5,A0A0K0JDP1,A0A0N4UKJ1,A0A498N3A3,A0A3M0IQP5,A0A0L8GBV4,Q32KD4,A0A1J1JBJ0,E0W4C3,A0A482XDA9,A0A3P7EJD6,J9K2Z4,A0A2J7Q8V4,T1IBM6,V3ZRX0,A0A210QKF7,A0A423TSS1,A0A267E8R7,A0A1D2N447,A0A226D7A9,F6YK55,T1KTE4,A0A2C9JGZ6,A0A1V9X9F0,K5X5Z7,A0A3Q0KUG5,T1FY40,1Z26,5AWH,5I4A,6QZK,7R8K,A0A1I7IXT4,A0A2W1JZ37,A0A2S7WBN3,A0A328VKE4,A0A420DFE6,E0ST67,A0A4V1VDY2,A0A368P5I0,C4L1M1,Q11QW7,A0A1M5ZSR3,A0A0K8QX04,A0A0M2PXX3,K9TPA9,A0A1W6MIP2,A0A1C0UUC4,A0A2U2J9E0,A0A2Z6E1D5,A0A0F4NXW8,L8D0R3,A0A326U7G5,A0A3D8L290,A0A1Q4R485,K9U8J6,A0A097QRL6,A0A0D8ZUC0,A0A139XGN8,A0A1T4Y3A2,A0A0B0H9B4,A0YYT3,A0A2T1EFY0,G6FTN0,R6KUL9,A0A433NB65,A0A2T1G8M7,K9VUN0,K9ZDE3,A0A2T1LS63,A0A1Z4K1Y3,A0A2Z6E0R7,A0A1N6SSK9,A0A0P4UVI8,A0A0V7ZCG4,A0A1J0AGK2,K9UEV4,A0A060HNJ0,A0A235B542,R5XQK4,A0A1H3LE92,A0A496APJ8,A0A062U2W9,H0HWQ5,A0A1V9G9U4,A0A1I2ZGP1,A0A317EJY3,A0A1I2BD20,F8ERC7,D3S0S6,A0LL61,Q8DKB1,A0A139WY18,A0A2T1E1K4,A0A1Q8ZD62,A0A1Z3HNN4,Q31N05,R5NJJ8,A5D4D9,Q2JI93,A0A3R7KLK4,A0A4R3EV39,A0A1C9VH88,A0A329TD61,A0A1H3DGN3,A0A1Q1FPH0,F6EYI8,A0A4Q2UIU6,L0JS08,A0A345E7N0,M0AF24,A0A1W2A082,A0A1H3X247,M0D2X3,A0A346PK63,R7RTW6,A0A1H2RBI2,A0A1C3ZXN2,B9LVP8,W0JW77,B7K585,A0A343TL88,L0AJX6,A0A2A5QS34,A0A343JEE2,A0A329TBQ3,A0A285N2A8,A0A0W1S8B8,L9VRQ2,E4NRV1,A0A1I6HGN0,,",366,37
"399","C.H9.10","C.L1.1",236,143,93,1.78806677193774,"4KRE,5GUH,5VM9,6KR6,6OON,7KX7,7SWF,A0A163JTZ6,A0A196SDB4,J9D5G4,A2DPV7,R1FDF0,D2VMG4,A0A0D1ZAJ4,Q1K660,F4PH46,A0A3M7S814,A0A164ZA52,Q54G64,I0YVB2,C1DZY0,A0A2C5Z0M1,A0CB11,R9ACY5,D3BMP8,A0A1Z5TVE5,W7XD45,A0A1U7LLR0,A0A4S2MWZ7,K1VVQ6,V6R0U9,G4N9J3,A0A1E3QC61,D5GGK8,S8ANP9,A0A139AUH8,L2GMR6,U4LBG4,A0A177URI1,A0A3N4IGK1,A6N7Y9,A0A0E9NDK5,T1KZ60,A0A250WXN5,A0A2G8JLH3,Q5KAT1,L2GUF2,W2T741,A0A2J7QB22,S4RYE2,A0A2K3CW87,A0A388KES6,A0A3S3PD82,A0A0L0TEV1,A0A1S3J512,A0A1J1HRI1,C4V9J2,Q9JMB7,A0A075AN09,Q5TW24,U5HIG6,A0A401PRI6,Q96J94,G2QEV0,A0A397UU01,A0A2T7PFL8,K7ISV0,A0A024FT57,H3HCL6,A0A0G4IME3,E9FUN9,A0A1S3CYL5,D7FQK3,A0A1Y1YHC8,A0A1D8PMK0,Q5BD61,A0A1C7M8P2,A0A4D8YSQ3,A0A158PJG6,J9JZ66,T0SAU8,R7YY92,A0A3S1A0C3,A0A074YJ47,A0A2K1J482,O04379,A0A371I3C8,M8AEW7,A8P0D4,A0A2K3NY65,F4NYW7,A0A409Y6G2,A0A0L0HAB7,D8PZT7,A0A1D1W4K0,A7BJS5,D8SNM6,A0A1J8PPA3,X1WG39,M5FQK2,Q69VD5,A0A2R6NSC2,A0A0D8XL16,A0A016WPN3,Q9QZ81,G5EES3,A0A0K0EFP6,Q8CJG0,A0A1D5NTU6,A0A0V0YLH8,A0A139WDH0,A0A0R3W9Q7,H3DS31,A0A1Y1HWP2,G4T5G9,B7QCC4,A0A0B2UV00,M7BCJ9,E9GN30,A0A077Z361,A0A1X7V1N5,A0A0K0JDP1,A0A0N4UKJ1,A0A498N3A3,A0A3M0IQP5,A0A0L8GBV4,Q32KD4,A0A1J1JBJ0,A0A3P7EJD6,J9K2Z4,A0A2J7Q8V4,T1IBM6,V3ZRX0,A0A210QKF7,A0A423TSS1,A0A267E8R7,A0A1D2N447,F6YK55,T1KTE4,A0A2C9JGZ6,A0A1V9X9F0,A0A3Q0KUG5,T1FY40,1Z26,3DLB,5G5T,6QZK,7R8K,A0A2Z6E1D5,A0A139XGN8,A0A1T4Y3A2,A0A2T1EFY0,G6FTN0,A0A1Z4L0A1,K9UQR0,A0A2T1G8M7,K9VUN0,B0JXD6,A0A0P4UVI8,A0A0V7ZCG4,A0A2G9DT08,K9UEV4,Q9L1X1,A0A062U2W9,H0HWQ5,A0A1I2ZGP1,A0A317EJY3,A0A1I2BD20,F8ERC7,S7VLM7,A0A1A5X8H4,A0A1R3T9N6,A0A0Q2M2Z1,Q8DKB1,A0A2T1E1K4,A0A1Q8ZD62,A0A4Q6XKV6,A0A239JE83,Q53W94,A0A2T0XH18,A0A1V4CHV0,A0A1K1RQP7,A0A2T1EKT1,A0A1N6LUI7,A0A1X7IML5,A0A0A2LKJ7,A0A0U3AL92,A0A1H3A054,A0A0C1VHB4,Q31N05,A0A0C5JKF3,R5NJJ8,A5D4D9,Q2JI93,A0A142Y7A9,A0A432MEQ5,A0A372DKU2,A0A3R7KLK4,C1F5Q7,A0A4R3EV39,A0A1P8WP90,A0A222F7P0,A0A1C9VH88,A0A2T2YMB1,A0A101R2A0,A0A1E3XF49,A0A1U9ND56,A0A4R7BQC4,A0A1H3DGN3,E0TGY3,A0A1H0LH25,A0A318LG42,H1YCU5,L0JS08,A0A1Q5ZS75,M0AF24,A0A1W2A082,A0A0C1XUA0,M0D2X3,A0A2R5G167,A0A346PK63,R7RTW6,A0A1H2RBI2,A0A1C3ZXN2,B7K585,F8D8G0,A0A343TL88,A0A343JEE2,A0A3P3RGE5,A0A329TBQ3,A0A0W1S8B8,A0A1V4C8L7,L9VRQ2,E4NRV1,A0A1I6HGN0,A0A1I0NI68,,",366,37
"400","C.L18.1","C.S12.7",230,143,87,1.60811028052407,"4F1N,4F3T,4KRE,5GUH,5VM9,7KX7,A0A163JTZ6,A0A0N4X8S8,A0A196SDB4,A0A2P6N8X7,A8BCK6,T1H8B3,R1FDF0,D2VMG4,A0A074TLL7,Q1K660,F4PH46,A0A3M7S814,A0A383WDW5,Q54G64,I0YVB2,R7QGN7,C1DZY0,A0CB11,R9ACY5,D3BMP8,A0A1Z5TVE5,W7XD45,A0A4S2MWZ7,K1VVQ6,A0A158P1R9,E3KLI3,B7Q5I1,A0A139AUH8,U4LBG4,A0A177URI1,A6N7Y9,A0A0E9NDK5,T1KZ60,A0A250WXN5,A0A2G8JLH3,Q5KAT1,L2GUF2,W2T741,A0A2J7QB22,A0A2K3CW87,A0A226EFL3,A0A3S3PD82,A0A0L0TEV1,A0A1S3J512,G0QTT2,Q9JMB7,A0A075AN09,Q5TW24,U5HIG6,A0A401PRI6,Q96J94,A0A2B4RHN2,G2QEV0,A0A397UU01,A0A2T7PFL8,K7ISV0,A0A024FT57,H3HCL6,A0A0G4IME3,E9FUN9,A0A1S3CYL5,A0A1Y1YHC8,T1GSU4,F4S231,A0A1D8PMK0,A0A2G5B1D8,Q5BD61,A0A1C7M8P2,A0A4D8YSQ3,A0A158PJG6,J9JZ66,A0A0C2XG51,A0A158QZT6,A0A165QYQ9,T0SAU8,R7YY92,A0A3S1A0C3,A0A074YJ47,A0A2K1J482,A0A1Q3ENA6,O04379,A0A371I3C8,A8P0D4,A0A2K3NY65,F4NYW7,A0A409Y6G2,A0A0L0HAB7,D8PZT7,A0A1D1W4K0,W4YU94,A7BJS5,D8SNM6,A0A1J8PPA3,M5FQK2,Q69VD5,A0A2R6NSC2,A0A0D8XL16,A0A016WPN3,Q9QZ81,G5EES3,A0A0K0EFP6,Q8CJG0,V2WTL2,A0A0V0YLH8,A0A0R3W9Q7,H3DS31,A0A1Y1HWP2,G4T5G9,B7QCC4,A0A0B2UV00,Q7PZ41,A0A077Z361,R7U9I3,A0A0K0JDP1,A0A0N4UKJ1,A0A0L8GBV4,Q32KD4,A0A1J1JBJ0,E0W4C3,A0A482XDA9,A0A3P7EJD6,J9K2Z4,A0A2J7Q8V4,T1IBM6,V3ZRX0,A0A210QKF7,A0A423TSS1,K1PT78,A0A1D2N447,A0A226D7A9,F6YK55,T1KTE4,A0A2C9JGZ6,A0A1V9X9F0,K5X5Z7,A0A3Q0KUG5,T1FY40,1YVU,3DLB,5AWH,5G5T,6QZK,E8N0K8,A0A328VKE4,K9TPA9,A0A2Z6E1D5,A0A0F4NXW8,A0A142XB92,L8D0R3,B1XJG0,A0A326U7G5,H1KXR6,A0A1Q4R485,K9U8J6,A0A097QRL6,K9RC91,A0A0D8ZUC0,A0A139XGN8,A0A1T4Y3A2,Q5P0R2,B6YTQ5,A0YYT3,A0A2T1EFY0,G6FTN0,A0A433NB65,A0A1Z4L0A1,K9UQR0,A0A2T1G8M7,K9VUN0,K9ZDE3,B0JXD6,A0A2T1LS63,A0A1Z4K1Y3,A0A2Z6E0R7,A0A0P4UVI8,A0A0V7ZCG4,A0A1J0AGK2,K9PFF9,K9UEV4,R5XQK4,A0A1H3LE92,A0A496APJ8,A0A062U2W9,A0A1V9G9U4,A0A1I2ZGP1,A0A317EJY3,A0A1I2BD20,F8ERC7,A0A0Q2M2Z1,D3S0S6,I3TE64,Q8DKB1,A0A139WY18,A0A1J1EK56,A0A2T1E1K4,A0A1Q8ZD62,A0A1Z3HNN4,Q53W94,A0A0U3AL92,A0A1H3A054,E0UCX3,K9XZC6,B9LVW4,A0A0C1VHB4,Q31N05,A0A0C5JKF3,Q2JI93,A0A432MEQ5,A0A372DKU2,A0A3R7KLK4,A0A1C9VH88,A0A1E3XF49,A0A1H3DGN3,A0A259TUP4,H1YCU5,A0A1W2A082,A0A1H3X247,A0A2R5G167,A0A346PK63,A0A1C3ZXN2,W0JW77,B7K585,F8D8G0,A0A2A5QS34,,",366,37
"401","C.L2.1","C.L3.12",210,143,67,2.2386494102912,"4F1N,4KRE,5GUH,6KR6,6OON,7KX7,7SWF,T1H8B3,R1FDF0,S4RWI0,A0A0D1ZAJ4,Q1K660,A0A3M7S814,A0A164ZA52,A0A383WDW5,I0YVB2,R7QGN7,A0A2C5Z0M1,R9ACY5,A0A1Z5TVE5,W7XD45,A0A1U7LLR0,A0A4S2MWZ7,K1VVQ6,G7DVX0,V6R0U9,G4N9J3,E3KLI3,B7Q5I1,A0A1E3QC61,D5GGK8,A0A139AUH8,L2GMR6,A0A177URI1,O74957,A0A3N4IGK1,A6N7Y9,T1KZ60,A0A250WXN5,A0A2G8JLH3,Q5KAT1,L2GUF2,W2T741,A0A2J7QB22,S4RYE2,A0A2K3CW87,A0A388KES6,A0A226EFL3,A0A1S3J512,G0QTT2,A0A1J1HRI1,C4V9J2,Q9JMB7,Q5TW24,A0A401PRI6,Q96J94,A0A2B4RHN2,G2QEV0,A0A2T7PFL8,A0A024FT57,H3HCL6,A0A0G4IME3,E9FUN9,A0A1S3CYL5,D7FQK3,A0A1Y1YHC8,T1GSU4,F4S231,A0A1D8PMK0,A0A2G5B1D8,Q5BD61,A0A4D8YSQ3,A0A158PJG6,A0A0C2XG51,A0A158QZT6,A0A165QYQ9,R7YY92,A0A3S1A0C3,A0A2K1J482,A0A1Q3ENA6,O04379,A0A371I3C8,M8AEW7,A8P0D4,A0A2K3NY65,F4NYW7,A0A409Y6G2,A0A0L0HAB7,D8PZT7,A0A1D1W4K0,A7RQ46,W4YU94,A7BJS5,D8SNM6,A0A1J8PPA3,X1WG39,Q69VD5,A0A2R6NSC2,A0A0D8XL16,A0A016WPN3,Q9QZ81,G5EES3,A0A0K0EFP6,Q8CJG0,A0A1D5NTU6,V2WTL2,A0A0V0YLH8,A0A139WDH0,A0A0R3W9Q7,H3DS31,A0A1Y1HWP2,G4T5G9,B7QCC4,A0A0B2UV00,M7BCJ9,E9GN30,Q7PZ41,A0A077Z361,A0A1X7V1N5,A0A0K0JDP1,A0A0N4UKJ1,A0A498N3A3,A0A3M0IQP5,A0A0L8GBV4,A0A1J1JBJ0,E0W4C3,A0A3P7EJD6,J9K2Z4,A0A2J7Q8V4,T1IBM6,V3ZRX0,A0A210QKF7,A0A423TSS1,K1PT78,A0A267E8R7,A0A1D2N447,A0A226D7A9,F6YK55,T1KTE4,A0A2C9JGZ6,A0A1V9X9F0,A0A3Q0KUG5,T1FY40,1YVU,5AWH,5G5T,5I4A,6QZK,7R8K,A0A1I7IXT4,A0A2W1JZ37,A0A2S7WBN3,A0A420DFE6,A0A4V1VDY2,A0A368P5I0,A0A4R1RMM2,A0A1Y2RDH8,A0A1M5ZSR3,A0A1W6MIP2,A0A2U2J9E0,A0A2Z6E1D5,A0A0F4NXW8,L8D0R3,A0A3D8L290,A0A1T4Y3A2,Q5P0R2,A0A2Z6E0R7,Q9L1X1,A0A1H3LE92,A0A062U2W9,A0A1I2ZGP1,A0A317EJY3,F8ERC7,S7VLM7,A0A1A5X8H4,A0A1R3T9N6,A0A0B7I4Z6,A0LL61,A0A1V4CHV0,A0A2T1EKT1,A0A0U3AL92,A0A1H3A054,E0UCX3,K9XZC6,B9LVW4,A0A0C5JKF3,R5NJJ8,A5D4D9,A0A432MEQ5,A0A4R3EV39,A0A1P8WP90,A0A222F7P0,A0A1C9VH88,A0A259TUP4,F6EYI8,A0A2S9Q9J0,A0A318LG42,A0A345E7N0,R7RTW6,M5RSF0,W0JW77,B7K585,F8D8G0,L0AJX6,A0A2A5QS34,A0A343JEE2,A0A329TBQ3,A0A285N2A8,A0A1V4C8L7,A0A1I0NI68,,",366,37
"409","C.S11.6","C.S8.7",196,144,52,2.23771367521368,"A0A163JTZ6,A0A196SDB4,J9D5G4,C4LVV2,R1FDF0,S4RWI0,D2VMG4,A0A0D1ZAJ4,Q1K660,F4PH46,A0A3M7S814,A0A164ZA52,A0A383WDW5,Q54G64,S7WCF7,I0YVB2,R7QGN7,C1DZY0,A0A2C5Z0M1,R9ACY5,D3BMP8,A0A1Z5TVE5,A0A1U7LLR0,A0A4S2MWZ7,K1VVQ6,A0A158P1R9,G7DVX0,V6R0U9,G4N9J3,E3KLI3,B7Q5I1,A0A1E3QC61,D5GGK8,S8ANP9,A0A139AUH8,L2GMR6,U4LBG4,A0A177URI1,O74957,A0A3N4IGK1,A6N7Y9,A0A250WXN5,A0A2G8JLH3,Q5KAT1,L2GUF2,W2T741,A0A1W0E4B5,A0A2J7QB22,A0A2K3CW87,A0A3S3PD82,A0A0L0TEV1,A0A1S3J512,A0A1J1HRI1,C4V9J2,Q9JMB7,A0A075AN09,U5HIG6,A0A401PRI6,Q96J94,A0A2B4RHN2,A0A2T7PFL8,K7ISV0,A0A024FT57,H3HCL6,A0A0G4IME3,A0A1S3CYL5,D7FQK3,A0A1Y1YHC8,T1GSU4,F4S231,A0A1D8PMK0,A0A2G5B1D8,A0A1C7M8P2,A0A4D8YSQ3,A0A158PJG6,A0A0C2XG51,A0A158QZT6,A0A165QYQ9,T0SAU8,A0A3S1A0C3,A0A2K1J482,A0A1Q3ENA6,O04379,A0A371I3C8,A8P0D4,A0A2K3NY65,F4NYW7,A0A0L0HAB7,D8PZT7,A0A1D1W4K0,A7RQ46,W4YU94,A7BJS5,D8SNM6,A0A1J8PPA3,X1WG39,M5FQK2,Q69VD5,A0A2R6NSC2,A0A016WPN3,Q9QZ81,A0A0K0EFP6,Q8CJG0,A0A1D5NTU6,V2WTL2,A0A0V0YLH8,A0A139WDH0,A0A0R3W9Q7,H3DS31,A0A1Y1HWP2,G4T5G9,B7QCC4,A0A0B2UV00,M7BCJ9,E9GN30,Q7PZ41,A0A077Z361,R7U9I3,A0A1X7V1N5,A0A0K0JDP1,A0A0N4UKJ1,A0A3M0IQP5,Q32KD4,A0A1J1JBJ0,E0W4C3,A0A482XDA9,A0A3P7EJD6,J9K2Z4,A0A2J7Q8V4,T1IBM6,V3ZRX0,A0A210QKF7,A0A423TSS1,K1PT78,A0A267E8R7,A0A1D2N447,A0A226D7A9,F6YK55,T1KTE4,A0A2C9JGZ6,A0A1V9X9F0,K5X5Z7,A0A3Q0KUG5,T1FY40,1YVU,E8N0K8,A0A328VKE4,E0ST67,C4L1M1,A0A0M2PXX3,A0A1C0UUC4,A0A0F4NXW8,A0A142XB92,L8D0R3,B1XJG0,A0A326U7G5,A0A1Q4R485,A0A097QRL6,B6YTQ5,A0A0B0H9B4,R6KUL9,K9UQR0,K9UEV4,A0A060HNJ0,R5XQK4,Q8DKB1,Q53W94,A0A2T1EKT1,K9XZC6,A0A0C1VHB4,Q31N05,R5NJJ8,Q2JI93,A0A329TD61,A0A1E3XF49,A0A1Q1FPH0,H1YCU5,A0A1Q5ZS75,A0A345E7N0,A0A1H3X247,A0A0C1XUA0,A0A346PK63,R7RTW6,A0A1H2RBI2,A0A1C3ZXN2,B9LVP8,W0JW77,A0A343TL88,L0AJX6,A0A343JEE2,A0A3P3RGE5,A0A329TBQ3,A0A0W1S8B8,A0A1V4C8L7,L9VRQ2,A0A1I6HGN0,,",366,37
"410","C.S15.4","C.S16.3",199,144,55,1.17373737373737,"4F1N,4KRE,5GUH,5VM9,6KR6,7KX7,7SWF,A0A163JTZ6,A0A0N4X8S8,A0A196SDB4,J9D5G4,Q389P5,C4LVV2,A0A2P6N8X7,A2DPV7,R1FDF0,D2VMG4,A0A074TLL7,F4PH46,A0A3M7S814,A0A383WDW5,Q54G64,I0YVB2,R7QGN7,A0A2C5Z0M1,A0CB11,R9ACY5,D3BMP8,W7XD45,A0A1U7LLR0,K1VVQ6,A0A158P1R9,G7DVX0,A0A1E3QC61,D5GGK8,A0A139AUH8,A0A177URI1,O74957,A6N7Y9,T1KZ60,A0A2G8JLH3,Q5KAT1,L2GUF2,W2T741,A0A2J7QB22,S4RYE2,A0A388KES6,A0A226EFL3,A0A3S3PD82,A0A1S3J512,G0QTT2,A0A1J1HRI1,A0A075AN09,Q5TW24,A0A2B4RHN2,G2QEV0,A0A397UU01,A0A2T7PFL8,E9FUN9,A0A1S3CYL5,D7FQK3,A0A1Y1YHC8,T1GSU4,Q5BD61,A0A1C7M8P2,A0A4D8YSQ3,A0A158PJG6,J9JZ66,A0A0C2XG51,A0A158QZT6,A0A165QYQ9,T0SAU8,R7YY92,A0A3S1A0C3,A0A2K1J482,A0A1Q3ENA6,O04379,A0A371I3C8,M8AEW7,A8P0D4,A0A2K3NY65,F4NYW7,A0A409Y6G2,A0A0L0HAB7,D8PZT7,A0A1D1W4K0,A7RQ46,W4YU94,A7BJS5,D8SNM6,A0A1J8PPA3,X1WG39,M5FQK2,Q69VD5,A0A2R6NSC2,A0A0D8XL16,A0A016WPN3,Q9QZ81,G5EES3,A0A0K0EFP6,Q8CJG0,A0A1D5NTU6,V2WTL2,A0A0V0YLH8,A0A139WDH0,A0A0R3W9Q7,H3DS31,A0A1Y1HWP2,G4T5G9,B7QCC4,A0A0B2UV00,M7BCJ9,E9GN30,Q7PZ41,A0A077Z361,R7U9I3,A0A1X7V1N5,A0A0K0JDP1,A0A0N4UKJ1,A0A498N3A3,A0A3M0IQP5,A0A0L8GBV4,Q32KD4,A0A1J1JBJ0,E0W4C3,A0A482XDA9,A0A3P7EJD6,J9K2Z4,A0A2J7Q8V4,T1IBM6,V3ZRX0,A0A210QKF7,A0A423TSS1,K1PT78,A0A267E8R7,A0A1D2N447,A0A226D7A9,F6YK55,T1KTE4,A0A2C9JGZ6,A0A1V9X9F0,K5X5Z7,A0A3Q0KUG5,T1FY40,5I4A,6QZK,E0ST67,A0A4R1RMM2,A0A1Y2RDH8,A0A0K8QX04,A0A1W6MIP2,A0A2U2J9E0,A0A142XB92,H1KXR6,A0A1T4Y3A2,A0A2T1EFY0,A0A0P6X5X2,S7VLM7,A0A1I2T6Q1,A0A1R3T9N6,H8KXJ0,A0A2D1U4H7,A0A139WY18,A0A1J1EK56,A0A2T1E1K4,A0A1Q8ZD62,A0A4Q6XKV6,A0A239JE83,A0A2N4XBY2,Q53W94,R5JEI2,A0A2T0XH18,A0A1K1RQP7,A0A0A2LKJ7,K1L112,A0A0U3AL92,E0UCX3,A0A432MEQ5,A0A4R3EV39,A0A222F7P0,A0A1C9VH88,A0A2T2YMB1,A0A329TD61,A0A1U9ND56,A0A4R7BQC4,E0TGY3,A0A4Q2UIU6,H1YCU5,A0A1Q5ZS75,A0A1W2A082,A0A2R5G167,A0A1H2RBI2,M5RSF0,B7K585,L0AJX6,A0A2A5QS34,A0A343JEE2,A0A3P3RGE5,A0A329TBQ3,,",366,37
"416","C.H7.2","C.L16.8",248,145,103,2.06682289923,"4F1N,4F3T,4KRE,5GUH,5VM9,6KR6,6OON,7KX7,A0A163JTZ6,A0A196SDB4,J9D5G4,A2DPV7,T1H8B3,R1FDF0,S4RWI0,A0A074TLL7,A0A3M7S814,A0A383WDW5,Q54G64,S7WCF7,R7QGN7,C1DZY0,R9ACY5,W7XD45,A0A1U7LLR0,K1VVQ6,G7DVX0,E3KLI3,B7Q5I1,A0A139AUH8,L2GMR6,A0A177URI1,O74957,A6N7Y9,T1KZ60,A0A250WXN5,Q5KAT1,L2GUF2,W2T741,A0A1W0E4B5,A0A2J7QB22,A0A2K3CW87,A0A226EFL3,A0A3S3PD82,A0A0L0TEV1,A0A1J1HRI1,C4V9J2,Q9JMB7,A0A075AN09,Q5TW24,U5HIG6,A0A401PRI6,Q96J94,A0A397UU01,A0A2T7PFL8,K7ISV0,A0A024FT57,H3HCL6,A0A0G4IME3,D7FQK3,A0A1Y1YHC8,T1GSU4,A0A1D8PMK0,Q5BD61,A0A1C7M8P2,A0A4D8YSQ3,A0A158PJG6,J9JZ66,A0A0C2XG51,A0A158QZT6,A0A165QYQ9,T0SAU8,R7YY92,A0A3S1A0C3,A0A074YJ47,A0A2K1J482,A0A1Q3ENA6,O04379,A0A371I3C8,M8AEW7,A8P0D4,A0A2K3NY65,F4NYW7,A0A409Y6G2,A0A0L0HAB7,D8PZT7,A0A1D1W4K0,A7RQ46,W4YU94,A7BJS5,D8SNM6,A0A1J8PPA3,X1WG39,M5FQK2,Q69VD5,A0A2R6NSC2,A0A0D8XL16,A0A016WPN3,Q9QZ81,G5EES3,A0A0K0EFP6,Q8CJG0,A0A1D5NTU6,V2WTL2,A0A0V0YLH8,A0A139WDH0,A0A0R3W9Q7,H3DS31,A0A1Y1HWP2,G4T5G9,B7QCC4,A0A0B2UV00,M7BCJ9,E9GN30,Q7PZ41,A0A077Z361,R7U9I3,A0A1X7V1N5,A0A0K0JDP1,A0A0N4UKJ1,A0A498N3A3,A0A3M0IQP5,A0A0L8GBV4,Q32KD4,A0A1J1JBJ0,E0W4C3,A0A482XDA9,A0A3P7EJD6,J9K2Z4,A0A2J7Q8V4,T1IBM6,V3ZRX0,A0A210QKF7,A0A423TSS1,K1PT78,A0A267E8R7,A0A1D2N447,A0A226D7A9,F6YK55,T1KTE4,A0A2C9JGZ6,A0A1V9X9F0,K5X5Z7,A0A3Q0KUG5,T1FY40,1Z26,5AWH,5I4A,6QZK,E8N0K8,A0A328VKE4,C4L1M1,A0A1M5ZSR3,A0A0K8QX04,A0A0M2PXX3,A0A1I3LMA1,K9TPA9,A0A2Z6E1D5,L8D0R3,B1XJG0,A0A1Q4R485,K9U8J6,A0A097QRL6,K9RC91,A0A0D8ZUC0,A0A139XGN8,A0A1T4Y3A2,Q5P0R2,B6YTQ5,A0A0B0H9B4,A0YYT3,A0A2T1EFY0,G6FTN0,A0A433NB65,A0A1Z4L0A1,K9UQR0,A0A2T1G8M7,K9VUN0,B7GJX9,A0A0P6X5X2,K9ZDE3,B0JXD6,A0A2T1LS63,A0A1Z4K1Y3,A0A2Z6E0R7,A0A1N6SSK9,A0A0P4UVI8,A0A0V7ZCG4,A0A1J0AGK2,K9PFF9,K9UEV4,R5XQK4,A0A1H3LE92,A0A496APJ8,A0A062U2W9,H0HWQ5,A0A1V9G9U4,A0A1I2ZGP1,A0A317EJY3,A0A1I2BD20,F8ERC7,A0A1A5X8H4,A0A0Q2M2Z1,A0A2D1U4H7,A0A0B7I4Z6,A0LL61,A0A139WY18,A0A2T1E1K4,A0A1Q8ZD62,A0A1Z3HNN4,A0A2T0XH18,A0A0A2LKJ7,K1L112,E0UCX3,R5NJJ8,A5D4D9,A0A3R7KLK4,C1F5Q7,A0A4R3EV39,A0A329TD61,A0A1E3XF49,A0A1H3DGN3,E0TGY3,F6EYI8,A0A2S9Q9J0,H1YCU5,A0A1Q5ZS75,A0A345E7N0,A0A1W2A082,A0A1H3X247,A0A0C1XUA0,A0A346PK63,R7RTW6,A0A1H2RBI2,A0A1C3ZXN2,B9LVP8,M5RSF0,W0JW77,A0A343TL88,L0AJX6,A0A343JEE2,A0A3P3RGE5,A0A329TBQ3,A0A285N2A8,A0A0W1S8B8,L9VRQ2,E4NRV1,A0A1I6HGN0,,",366,37
"426","C.L20.5","N.L2.1",217,146,71,1.6733551996913,"4F1N,4F3T,4KRE,5GUH,6OON,7KX7,7SWF,A0A2P6N8X7,A8BCK6,A2DPV7,R1FDF0,S4RWI0,D2VMG4,A0A0D1ZAJ4,Q1K660,F4PH46,A0A164ZA52,A0A383WDW5,Q54G64,S7WCF7,R7QGN7,C1DZY0,A0A2C5Z0M1,R9ACY5,D3BMP8,A0A1Z5TVE5,W7XD45,A0A1U7LLR0,A0A4S2MWZ7,A0A158P1R9,G7DVX0,V6R0U9,G4N9J3,E3KLI3,B7Q5I1,A0A1E3QC61,D5GGK8,S8ANP9,A0A139AUH8,L2GMR6,U4LBG4,A0A177URI1,A0A3N4IGK1,A6N7Y9,A0A0E9NDK5,T1KZ60,A0A250WXN5,A0A2G8JLH3,Q5KAT1,L2GUF2,A0A1W0E4B5,A0A2K3CW87,A0A388KES6,A0A0L0TEV1,C4V9J2,Q9JMB7,A0A075AN09,U5HIG6,G2QEV0,A0A397UU01,A0A2T7PFL8,K7ISV0,A0A024FT57,H3HCL6,A0A0G4IME3,D7FQK3,A0A1Y1YHC8,T1GSU4,F4S231,A0A1D8PMK0,A0A2G5B1D8,Q5BD61,A0A1C7M8P2,A0A4D8YSQ3,A0A158PJG6,A0A0C2XG51,A0A158QZT6,A0A165QYQ9,T0SAU8,R7YY92,A0A3S1A0C3,A0A074YJ47,A0A2K1J482,A0A1Q3ENA6,O04379,A0A371I3C8,M8AEW7,A8P0D4,A0A2K3NY65,A0A409Y6G2,A0A0L0HAB7,D8PZT7,A0A1D1W4K0,A7RQ46,W4YU94,A7BJS5,D8SNM6,X1WG39,M5FQK2,Q69VD5,A0A0D8XL16,A0A016WPN3,Q9QZ81,G5EES3,A0A0K0EFP6,Q8CJG0,A0A1D5NTU6,V2WTL2,A0A0V0YLH8,A0A139WDH0,A0A0R3W9Q7,H3DS31,A0A1Y1HWP2,B7QCC4,A0A0B2UV00,E9GN30,Q7PZ41,A0A077Z361,R7U9I3,A0A1X7V1N5,A0A0K0JDP1,A0A0N4UKJ1,A0A498N3A3,A0A0L8GBV4,Q32KD4,A0A1J1JBJ0,E0W4C3,A0A482XDA9,A0A3P7EJD6,J9K2Z4,A0A2J7Q8V4,T1IBM6,V3ZRX0,A0A210QKF7,A0A423TSS1,K1PT78,A0A267E8R7,A0A1D2N447,A0A226D7A9,F6YK55,T1KTE4,A0A2C9JGZ6,A0A1V9X9F0,K5X5Z7,A0A3Q0KUG5,T1FY40,1YVU,1Z26,3DLB,5AWH,5G5T,5I4A,A0A1I3LMA1,A0A3D8L290,H1KXR6,A0A0B0H9B4,R6KUL9,B7GJX9,K9ZDE3,A0A1N6SSK9,A0A060HNJ0,A0A235B542,R5XQK4,S7VLM7,A0A0Q2M2Z1,H8KXJ0,D3S0S6,A0A2D1U4H7,A0A0B7I4Z6,A0LL61,A0A1J1EK56,A0A239JE83,A0A2N4XBY2,Q53W94,R5JEI2,A0A0Q0ZC47,A0A2T0XH18,A0A1V4CHV0,A0A0P0NGR6,A0A1X7IML5,K1L112,A0A0U3AL92,A0A1H3A054,Q31N05,A0A0C5JKF3,R5NJJ8,A5D4D9,Q2JI93,A0A142Y7A9,A0A372DKU2,A0A3R7KLK4,A0A4R3EV39,A0A1P8WP90,A0A222F7P0,A0A1C9VH88,A0A2T2YMB1,A0A329TD61,A0A1U9ND56,A0A4R7BQC4,A0A1H3DGN3,A0A1Q1FPH0,E0TGY3,A0A259TUP4,A0A2S9Q9J0,A0A4Q2UIU6,L0JS08,A0A345E7N0,M0AF24,A0A1H3X247,M0D2X3,A0A2R5G167,B9LVP8,M5RSF0,W0JW77,B7K585,A0A285N2A8,A0A1V4C8L7,,",366,37
"433","N.H8.9","N.S12.5",245,147,98,1.70918367346939,"4F1N,4KRE,5GUH,6OON,7KX7,7SWF,J9D5G4,Q389P5,C4LVV2,A0A2P6N8X7,A8BCK6,A2DPV7,A0A0G4H2S4,T1H8B3,R1FDF0,S4RWI0,A0A0D1ZAJ4,Q1K660,F4PH46,Q54G64,R7QGN7,C1DZY0,A0CB11,R9ACY5,D3BMP8,W7XD45,A0A1U7LLR0,A0A4S2MWZ7,K1VVQ6,A0A158P1R9,G7DVX0,V6R0U9,G4N9J3,E3KLI3,B7Q5I1,A0A1E3QC61,D5GGK8,S8ANP9,A0A139AUH8,L2GMR6,A0A177URI1,A6N7Y9,A0A0E9NDK5,A0A2G8JLH3,Q5KAT1,A0A1W0E4B5,A0A2J7QB22,S4RYE2,A0A388KES6,A0A226EFL3,A0A3S3PD82,A0A0L0TEV1,A0A1S3J512,G0QTT2,A0A1J1HRI1,C4V9J2,Q9JMB7,A0A075AN09,Q5TW24,U5HIG6,A0A401PRI6,Q96J94,A0A2T7PFL8,K7ISV0,A0A024FT57,H3HCL6,A0A0G4IME3,E9FUN9,A0A1S3CYL5,D7FQK3,T1GSU4,F4S231,A0A1D8PMK0,A0A2G5B1D8,Q5BD61,A0A1C7M8P2,A0A158PJG6,J9JZ66,A0A0C2XG51,A0A158QZT6,T0SAU8,R7YY92,A0A3S1A0C3,A0A074YJ47,A0A1Q3ENA6,A8P0D4,F4NYW7,A0A409Y6G2,A0A0L0HAB7,D8PZT7,A0A1D1W4K0,A7RQ46,W4YU94,A7BJS5,A0A1J8PPA3,X1WG39,M5FQK2,A0A2R6NSC2,A0A0D8XL16,A0A016WPN3,Q9QZ81,G5EES3,A0A0K0EFP6,Q8CJG0,A0A1D5NTU6,V2WTL2,A0A0V0YLH8,A0A139WDH0,A0A0R3W9Q7,H3DS31,A0A1Y1HWP2,G4T5G9,B7QCC4,A0A0B2UV00,M7BCJ9,E9GN30,Q7PZ41,A0A077Z361,R7U9I3,A0A1X7V1N5,A0A0K0JDP1,A0A0N4UKJ1,A0A498N3A3,A0A3M0IQP5,A0A0L8GBV4,Q32KD4,A0A1J1JBJ0,E0W4C3,A0A482XDA9,A0A3P7EJD6,J9K2Z4,A0A2J7Q8V4,T1IBM6,V3ZRX0,A0A210QKF7,A0A423TSS1,K1PT78,A0A267E8R7,A0A1D2N447,A0A226D7A9,F6YK55,T1KTE4,A0A2C9JGZ6,A0A1V9X9F0,K5X5Z7,A0A3Q0KUG5,T1FY40,1YVU,1Z26,5G5T,6QZK,7R8K,C4L1M1,A0A1I3LMA1,B1XJG0,A0A3D8L290,A0A0B0H9B4,B7GJX9,A0A1N6SSK9,A0A235B542,A0A496APJ8,A0A062U2W9,H0HWQ5,A0A1V9G9U4,A0A1I2ZGP1,A0A317EJY3,A0A1I2BD20,F8ERC7,S7VLM7,A0A1I2T6Q1,A0A1R3T9N6,A0A0Q2M2Z1,A0A2D1U4H7,A0A0B7I4Z6,A0LL61,Q8DKB1,A0A139WY18,A0A1J1EK56,A0A2T1E1K4,A0A1Q8ZD62,A0A4Q6XKV6,A0A1Z3HNN4,A0A239JE83,A0A2N4XBY2,Q53W94,R5JEI2,A0A0Q0ZC47,A0A2T0XH18,A0A1V4CHV0,A0A1K1RQP7,A0A2T1EKT1,A0A1N6LUI7,A0A0P0NGR6,A0A1X7IML5,A0A0A2LKJ7,K1L112,A0A0U3AL92,A0A1H3A054,E0UCX3,K9XZC6,A0A0C1VHB4,Q31N05,A0A0C5JKF3,A5D4D9,Q2JI93,A0A142Y7A9,A0A432MEQ5,A0A372DKU2,A0A3R7KLK4,C1F5Q7,A0A4R3EV39,A0A1P8WP90,A0A222F7P0,A0A1C9VH88,A0A2T2YMB1,A0A329TD61,A0A4R7BQC4,A0A1H3DGN3,A0A1Q1FPH0,A0A259TUP4,A0A2S9Q9J0,A0A4Q2UIU6,H1YCU5,A0A1Q5ZS75,A0A345E7N0,A0A1H3X247,A0A0C1XUA0,M0D2X3,A0A2R5G167,R7RTW6,A0A1H2RBI2,A0A1C3ZXN2,B9LVP8,M5RSF0,B7K585,A0A343TL88,A0A343JEE2,A0A3P3RGE5,A0A329TBQ3,A0A0W1S8B8,A0A1V4C8L7,L9VRQ2,E4NRV1,A0A1I6HGN0,A0A1I0NI68,,",366,37
"434","C.H7.3","C.H7.6",277,148,129,2.09912528807878,"4F1N,4F3T,4KRE,5VM9,6KR6,6OON,7KX7,A0A163JTZ6,A0A196SDB4,J9D5G4,C4LVV2,A0A2P6N8X7,A8BCK6,A2DPV7,A0A0G4H2S4,T1H8B3,R1FDF0,S4RWI0,D2VMG4,A0A074TLL7,F4PH46,A0A3M7S814,A0A383WDW5,Q54G64,S7WCF7,R7QGN7,C1DZY0,A0CB11,R9ACY5,D3BMP8,W7XD45,A0A1U7LLR0,K1VVQ6,A0A158P1R9,G7DVX0,E3KLI3,B7Q5I1,A0A139AUH8,L2GMR6,A0A177URI1,O74957,A6N7Y9,T1KZ60,A0A250WXN5,A0A2G8JLH3,Q5KAT1,L2GUF2,W2T741,A0A1W0E4B5,A0A2J7QB22,A0A2K3CW87,A0A226EFL3,A0A3S3PD82,A0A0L0TEV1,A0A1S3J512,G0QTT2,A0A1J1HRI1,C4V9J2,Q9JMB7,A0A075AN09,Q5TW24,U5HIG6,A0A401PRI6,Q96J94,A0A2B4RHN2,A0A397UU01,A0A2T7PFL8,K7ISV0,A0A024FT57,H3HCL6,A0A0G4IME3,E9FUN9,A0A1S3CYL5,D7FQK3,A0A1Y1YHC8,T1GSU4,A0A1D8PMK0,A0A2G5B1D8,Q5BD61,A0A1C7M8P2,A0A158PJG6,J9JZ66,A0A0C2XG51,A0A158QZT6,A0A165QYQ9,T0SAU8,R7YY92,A0A3S1A0C3,A0A074YJ47,A0A1Q3ENA6,A8P0D4,F4NYW7,A0A409Y6G2,A0A0L0HAB7,D8PZT7,A0A1D1W4K0,A7RQ46,W4YU94,A7BJS5,A0A1J8PPA3,X1WG39,M5FQK2,A0A2R6NSC2,A0A0D8XL16,A0A016WPN3,Q9QZ81,G5EES3,A0A0K0EFP6,Q8CJG0,A0A1D5NTU6,V2WTL2,A0A0V0YLH8,A0A139WDH0,A0A0R3W9Q7,H3DS31,G4T5G9,B7QCC4,M7BCJ9,E9GN30,Q7PZ41,A0A077Z361,R7U9I3,A0A1X7V1N5,A0A498N3A3,A0A3M0IQP5,A0A0L8GBV4,Q32KD4,A0A1J1JBJ0,E0W4C3,A0A482XDA9,A0A3P7EJD6,J9K2Z4,A0A2J7Q8V4,T1IBM6,V3ZRX0,A0A210QKF7,A0A423TSS1,K1PT78,A0A267E8R7,A0A1D2N447,A0A226D7A9,F6YK55,T1KTE4,A0A2C9JGZ6,A0A1V9X9F0,K5X5Z7,A0A3Q0KUG5,T1FY40,1YVU,3DLB,5AWH,5G5T,5I4A,6QZK,E8N0K8,A0A2S7WBN3,A0A328VKE4,E0ST67,C4L1M1,A0A4R1RMM2,A0A1Y2RDH8,A0A1M5ZSR3,A0A0M2PXX3,A0A1I3LMA1,K9TPA9,A0A1W6MIP2,A0A1C0UUC4,A0A2U2J9E0,A0A2Z6E1D5,A0A0F4NXW8,L8D0R3,B1XJG0,A0A326U7G5,A0A3D8L290,A0A1Q4R485,K9U8J6,A0A097QRL6,K9RC91,A0A0D8ZUC0,A0A139XGN8,A0A1T4Y3A2,Q5P0R2,B6YTQ5,A0A0B0H9B4,A0YYT3,A0A2T1EFY0,G6FTN0,R6KUL9,A0A433NB65,A0A1Z4L0A1,K9UQR0,A0A2T1G8M7,K9VUN0,B7GJX9,A0A0P6X5X2,K9ZDE3,B0JXD6,A0A1Z4K1Y3,A0A2Z6E0R7,A0A1N6SSK9,A0A0P4UVI8,A0A0V7ZCG4,A0A1J0AGK2,K9PFF9,K9UEV4,A0A060HNJ0,A0A235B542,R5XQK4,A0A1H3LE92,A0A496APJ8,A0A062U2W9,H0HWQ5,A0A1V9G9U4,A0A1I2ZGP1,A0A317EJY3,A0A1I2BD20,F8ERC7,A0A1A5X8H4,A0A1I2T6Q1,H8KXJ0,D3S0S6,A0A2D1U4H7,I3TE64,A0A0B7I4Z6,A0LL61,Q8DKB1,A0A139WY18,A0A1J1EK56,A0A2T1E1K4,A0A1Q8ZD62,A0A1Z3HNN4,Q53W94,R5JEI2,A0A2T0XH18,A0A2T1EKT1,A0A1N6LUI7,A0A0P0NGR6,A0A0A2LKJ7,K1L112,E0UCX3,K9XZC6,A0A0C1VHB4,Q31N05,R5NJJ8,A5D4D9,Q2JI93,A0A3R7KLK4,C1F5Q7,A0A4R3EV39,A0A222F7P0,A0A329TD61,A0A1H3DGN3,A0A1Q1FPH0,E0TGY3,F6EYI8,A0A2S9Q9J0,A0A345E7N0,A0A1W2A082,A0A1H3X247,A0A0C1XUA0,A0A346PK63,R7RTW6,A0A1H2RBI2,B9LVP8,M5RSF0,W0JW77,A0A343TL88,L0AJX6,A0A2A5QS34,A0A343JEE2,A0A3P3RGE5,A0A329TBQ3,A0A285N2A8,A0A0W1S8B8,L9VRQ2,E4NRV1,A0A1I6HGN0,,",366,37
"436","N.H8.5","N.S12.6",206,148,58,5.78413327120224,"4F3T,4KRE,5VM9,6KR6,6OON,7KX7,7SWF,A0A163JTZ6,J9D5G4,Q389P5,C4LVV2,A0A2P6N8X7,A0A0G4H2S4,R1FDF0,S4RWI0,D2VMG4,A0A0D1ZAJ4,Q1K660,A0A3M7S814,A0A164ZA52,A0A383WDW5,Q54G64,S7WCF7,I0YVB2,A0A2C5Z0M1,A0CB11,R9ACY5,D3BMP8,A0A1Z5TVE5,W7XD45,A0A1U7LLR0,A0A4S2MWZ7,K1VVQ6,A0A158P1R9,V6R0U9,G4N9J3,B7Q5I1,A0A1E3QC61,D5GGK8,S8ANP9,L2GMR6,U4LBG4,A0A177URI1,O74957,A0A3N4IGK1,A6N7Y9,A0A0E9NDK5,A0A2G8JLH3,Q5KAT1,L2GUF2,W2T741,A0A1W0E4B5,S4RYE2,A0A388KES6,A0A226EFL3,A0A3S3PD82,A0A0L0TEV1,A0A1S3J512,G0QTT2,A0A1J1HRI1,C4V9J2,Q9JMB7,Q5TW24,U5HIG6,A0A401PRI6,A0A2B4RHN2,A0A397UU01,A0A2T7PFL8,K7ISV0,A0A024FT57,H3HCL6,A0A0G4IME3,E9FUN9,A0A1S3CYL5,D7FQK3,A0A1Y1YHC8,T1GSU4,F4S231,A0A4D8YSQ3,A0A158PJG6,J9JZ66,A0A158QZT6,A0A165QYQ9,T0SAU8,A0A3S1A0C3,A0A2K1J482,A0A1Q3ENA6,O04379,A0A371I3C8,M8AEW7,A0A2K3NY65,F4NYW7,A0A409Y6G2,A0A0L0HAB7,D8PZT7,A0A1D1W4K0,A7RQ46,W4YU94,A7BJS5,D8SNM6,A0A1J8PPA3,M5FQK2,Q69VD5,A0A0D8XL16,A0A016WPN3,Q9QZ81,G5EES3,A0A0K0EFP6,Q8CJG0,A0A1D5NTU6,A0A0V0YLH8,A0A139WDH0,A0A0R3W9Q7,H3DS31,A0A1Y1HWP2,G4T5G9,B7QCC4,A0A0B2UV00,E9GN30,Q7PZ41,A0A077Z361,R7U9I3,A0A1X7V1N5,A0A0K0JDP1,A0A0N4UKJ1,A0A498N3A3,A0A0L8GBV4,Q32KD4,A0A1J1JBJ0,E0W4C3,A0A482XDA9,A0A3P7EJD6,J9K2Z4,A0A2J7Q8V4,T1IBM6,V3ZRX0,A0A210QKF7,A0A423TSS1,K1PT78,A0A267E8R7,A0A1D2N447,A0A226D7A9,F6YK55,T1KTE4,A0A2C9JGZ6,A0A1V9X9F0,A0A3Q0KUG5,T1FY40,3DLB,6QZK,7R8K,A0A1I3LMA1,B1XJG0,A0A1T4Y3A2,A0A060HNJ0,A0A496APJ8,A0A062U2W9,H0HWQ5,A0A1V9G9U4,A0A1I2ZGP1,A0A317EJY3,A0A1I2BD20,F8ERC7,A0A1A5X8H4,A0A0Q2M2Z1,A0LL61,Q8DKB1,A0A139WY18,A0A1J1EK56,A0A2T1E1K4,A0A1Q8ZD62,A0A1Z3HNN4,Q53W94,A0A2T1EKT1,A0A0U3AL92,E0UCX3,K9XZC6,A0A0C1VHB4,Q31N05,A0A0C5JKF3,R5NJJ8,Q2JI93,A0A142Y7A9,A0A372DKU2,A0A3R7KLK4,A0A4R3EV39,A0A329TD61,A0A1U9ND56,A0A4R7BQC4,A0A1H3DGN3,F6EYI8,A0A2S9Q9J0,A0A4Q2UIU6,H1YCU5,L0JS08,A0A1Q5ZS75,A0A345E7N0,M0AF24,A0A1H3X247,A0A0C1XUA0,M0D2X3,R7RTW6,B9LVP8,F8D8G0,A0A343JEE2,A0A1I0NI68,,",366,37
"439","C.H10.7","C.S9.6",267,149,118,2.43055397565692,"5GUH,6KR6,6OON,7SWF,A0A163JTZ6,J9D5G4,C4LVV2,A8BCK6,A2DPV7,R1FDF0,D2VMG4,A0A074TLL7,A0A0D1ZAJ4,Q1K660,A0A3M7S814,A0A164ZA52,A0A383WDW5,Q54G64,I0YVB2,R7QGN7,C1DZY0,A0A2C5Z0M1,A0CB11,R9ACY5,A0A1Z5TVE5,W7XD45,A0A1U7LLR0,A0A4S2MWZ7,K1VVQ6,A0A158P1R9,V6R0U9,G4N9J3,B7Q5I1,A0A1E3QC61,D5GGK8,S8ANP9,A0A139AUH8,U4LBG4,A0A177URI1,O74957,A0A3N4IGK1,A6N7Y9,A0A0E9NDK5,T1KZ60,A0A2G8JLH3,Q5KAT1,W2T741,A0A2J7QB22,S4RYE2,A0A2K3CW87,A0A388KES6,A0A3S3PD82,A0A0L0TEV1,A0A1S3J512,G0QTT2,A0A1J1HRI1,C4V9J2,Q9JMB7,Q5TW24,A0A401PRI6,Q96J94,A0A2B4RHN2,A0A397UU01,A0A2T7PFL8,K7ISV0,A0A024FT57,H3HCL6,A0A0G4IME3,E9FUN9,A0A1S3CYL5,D7FQK3,T1GSU4,F4S231,A0A2G5B1D8,A0A1C7M8P2,A0A158PJG6,J9JZ66,A0A0C2XG51,A0A158QZT6,A0A165QYQ9,T0SAU8,A0A3S1A0C3,A0A074YJ47,A0A2K1J482,A0A1Q3ENA6,O04379,A0A371I3C8,M8AEW7,A8P0D4,F4NYW7,A0A409Y6G2,A0A0L0HAB7,D8PZT7,A0A1D1W4K0,A7RQ46,W4YU94,A7BJS5,D8SNM6,A0A1J8PPA3,X1WG39,A0A0D8XL16,A0A016WPN3,Q9QZ81,G5EES3,A0A0K0EFP6,Q8CJG0,A0A1D5NTU6,V2WTL2,A0A0V0YLH8,A0A139WDH0,A0A0R3W9Q7,H3DS31,A0A1Y1HWP2,G4T5G9,B7QCC4,A0A0B2UV00,M7BCJ9,E9GN30,Q7PZ41,A0A077Z361,R7U9I3,A0A1X7V1N5,A0A0K0JDP1,A0A0N4UKJ1,A0A498N3A3,A0A3M0IQP5,A0A0L8GBV4,Q32KD4,A0A1J1JBJ0,E0W4C3,A0A482XDA9,A0A3P7EJD6,J9K2Z4,A0A2J7Q8V4,T1IBM6,V3ZRX0,A0A210QKF7,A0A423TSS1,K1PT78,A0A267E8R7,A0A1D2N447,A0A226D7A9,F6YK55,T1KTE4,A0A2C9JGZ6,A0A1V9X9F0,K5X5Z7,A0A3Q0KUG5,T1FY40,1YVU,1Z26,5AWH,5G5T,7R8K,A0A1I7IXT4,A0A2W1JZ37,A0A2S7WBN3,A0A328VKE4,A0A420DFE6,A0A4V1VDY2,A0A368P5I0,A0A4R1RMM2,A0A1Y2RDH8,Q11QW7,K9TPA9,A0A1L3JHM3,A0A1W6MIP2,A0A2U2J9E0,A0A2Z6E1D5,A0A326U7G5,A0A3D8L290,K9U8J6,A0A097QRL6,K9RC91,A0A0D8ZUC0,A0A139XGN8,A0A1T4Y3A2,B6YTQ5,A0YYT3,A0A2T1EFY0,G6FTN0,A0A433NB65,K9UQR0,A0A2T1G8M7,K9VUN0,K9ZDE3,A0A2T1LS63,A0A1Z4K1Y3,A0A2Z6E0R7,A0A0V7ZCG4,A0A1J0AGK2,A0A2G9DT08,K9UEV4,Q9L1X1,A0A1H3LE92,A0A062U2W9,H0HWQ5,A0A1V9G9U4,A0A1I2ZGP1,A0A317EJY3,A0A1I2BD20,F8ERC7,A0A1I2T6Q1,A0A1R3T9N6,A0A0Q2M2Z1,H8KXJ0,D3S0S6,A0A2D1U4H7,I3TE64,A0LL61,Q8DKB1,A0A139WY18,A0A1J1EK56,A0A2T1E1K4,A0A1Q8ZD62,A0A4Q6XKV6,A0A1Z3HNN4,A0A239JE83,A0A2N4XBY2,Q53W94,R5JEI2,A0A2T0XH18,A0A1V4CHV0,A0A1K1RQP7,A0A1N6LUI7,A0A0U3AL92,A0A0C5JKF3,A0A142Y7A9,A0A372DKU2,A0A3R7KLK4,C1F5Q7,A0A1P8WP90,A0A1C9VH88,A0A2T2YMB1,A0A329TD61,A0A101R2A0,A0A1E3XF49,A0A1U9ND56,A0A4R7BQC4,A0A1Q1FPH0,A0A259TUP4,A0A4Q2UIU6,A0A1H0LH25,A0A318LG42,L0JS08,A0A345E7N0,M0AF24,A0A1W2A082,A0A1H3X247,A0A0C1XUA0,M0D2X3,A0A346PK63,A0A1H2RBI2,A0A1C3ZXN2,B9LVP8,W0JW77,A0A343TL88,L0AJX6,A0A2A5QS34,A0A3P3RGE5,A0A329TBQ3,A0A285N2A8,A0A0W1S8B8,A0A1V4C8L7,L9VRQ2,E4NRV1,A0A1I6HGN0,,",366,37
"443","N.H3.12","N.H3.16",297,149,148,2.79047251949937,"4F1N,5GUH,5VM9,6KR6,7KX7,7SWF,Q389P5,A0A0G4H2S4,T1H8B3,S4RWI0,D2VMG4,A0A074TLL7,A0A0D1ZAJ4,Q1K660,F4PH46,A0A3M7S814,A0A164ZA52,Q54G64,S7WCF7,R7QGN7,A0A2C5Z0M1,A0CB11,R9ACY5,D3BMP8,A0A1Z5TVE5,W7XD45,A0A1U7LLR0,A0A4S2MWZ7,K1VVQ6,A0A158P1R9,V6R0U9,G4N9J3,E3KLI3,B7Q5I1,A0A1E3QC61,D5GGK8,S8ANP9,A0A139AUH8,L2GMR6,U4LBG4,O74957,A0A3N4IGK1,A6N7Y9,A0A0E9NDK5,T1KZ60,A0A250WXN5,A0A2G8JLH3,L2GUF2,W2T741,A0A1W0E4B5,A0A2J7QB22,S4RYE2,A0A2K3CW87,A0A388KES6,A0A226EFL3,A0A3S3PD82,A0A0L0TEV1,A0A1S3J512,G0QTT2,A0A1J1HRI1,C4V9J2,Q9JMB7,Q5TW24,U5HIG6,A0A401PRI6,Q96J94,A0A2B4RHN2,A0A397UU01,A0A2T7PFL8,K7ISV0,A0A0G4IME3,E9FUN9,A0A1S3CYL5,D7FQK3,A0A1Y1YHC8,T1GSU4,A0A1D8PMK0,Q5BD61,A0A4D8YSQ3,A0A158PJG6,J9JZ66,A0A0C2XG51,A0A158QZT6,A0A165QYQ9,A0A3S1A0C3,A0A074YJ47,A0A2K1J482,A0A1Q3ENA6,O04379,A0A371I3C8,M8AEW7,A8P0D4,A0A2K3NY65,F4NYW7,A0A409Y6G2,A0A0L0HAB7,A0A1D1W4K0,A7RQ46,W4YU94,A7BJS5,D8SNM6,A0A1J8PPA3,M5FQK2,A0A2R6NSC2,A0A0D8XL16,A0A016WPN3,Q9QZ81,G5EES3,A0A0K0EFP6,Q8CJG0,A0A1D5NTU6,V2WTL2,A0A0V0YLH8,A0A139WDH0,A0A0R3W9Q7,H3DS31,G4T5G9,B7QCC4,A0A0B2UV00,E9GN30,Q7PZ41,A0A077Z361,R7U9I3,A0A1X7V1N5,A0A0K0JDP1,A0A0N4UKJ1,A0A498N3A3,A0A0L8GBV4,Q32KD4,A0A1J1JBJ0,E0W4C3,A0A482XDA9,A0A3P7EJD6,J9K2Z4,A0A2J7Q8V4,T1IBM6,V3ZRX0,A0A210QKF7,A0A423TSS1,K1PT78,A0A267E8R7,A0A1D2N447,A0A226D7A9,F6YK55,T1KTE4,A0A2C9JGZ6,A0A1V9X9F0,K5X5Z7,A0A3Q0KUG5,1YVU,1Z26,3DLB,5AWH,5G5T,5I4A,6QZK,A0A328VKE4,E0ST67,A0A1I3LMA1,K9TPA9,A0A2Z6E1D5,A0A0F4NXW8,L8D0R3,A0A326U7G5,A0A3D8L290,A0A1Q4R485,K9U8J6,K9RC91,A0A0D8ZUC0,A0A139XGN8,Q5P0R2,A0A0B0H9B4,A0YYT3,A0A2T1EFY0,G6FTN0,R6KUL9,A0A433NB65,K9UQR0,A0A2T1G8M7,K9VUN0,B7GJX9,K9ZDE3,B0JXD6,A0A2T1LS63,A0A1Z4K1Y3,A0A2Z6E0R7,A0A1N6SSK9,A0A0P4UVI8,A0A1J0AGK2,A0A2G9DT08,K9UEV4,Q9L1X1,A0A060HNJ0,A0A235B542,R5XQK4,A0A496APJ8,A0A062U2W9,A0A1V9G9U4,A0A1I2ZGP1,A0A317EJY3,A0A1I2BD20,F8ERC7,S7VLM7,A0A1A5X8H4,A0A1I2T6Q1,A0A1R3T9N6,A0A0Q2M2Z1,H8KXJ0,A0A2D1U4H7,A0A0B7I4Z6,A0LL61,Q8DKB1,A0A139WY18,A0A1J1EK56,A0A2T1E1K4,A0A1Q8ZD62,A0A4Q6XKV6,A0A1Z3HNN4,A0A239JE83,A0A2N4XBY2,Q53W94,R5JEI2,A0A0Q0ZC47,A0A2T0XH18,A0A1V4CHV0,A0A1K1RQP7,A0A2T1EKT1,A0A1N6LUI7,A0A0P0NGR6,A0A1X7IML5,A0A0A2LKJ7,K1L112,A0A0U3AL92,A0A1H3A054,E0UCX3,K9XZC6,B9LVW4,A0A0C1VHB4,Q31N05,A0A0C5JKF3,R5NJJ8,A5D4D9,Q2JI93,A0A142Y7A9,A0A432MEQ5,A0A372DKU2,A0A3R7KLK4,A0A4R3EV39,A0A1P8WP90,A0A222F7P0,A0A1C9VH88,A0A2T2YMB1,A0A329TD61,A0A101R2A0,A0A1E3XF49,A0A1U9ND56,A0A4R7BQC4,A0A1H3DGN3,A0A1Q1FPH0,E0TGY3,A0A259TUP4,F6EYI8,A0A2S9Q9J0,A0A4Q2UIU6,A0A1H0LH25,A0A318LG42,H1YCU5,L0JS08,A0A1Q5ZS75,A0A345E7N0,M0AF24,A0A1W2A082,A0A1H3X247,A0A0C1XUA0,M0D2X3,A0A2R5G167,A0A346PK63,R7RTW6,A0A1H2RBI2,A0A1C3ZXN2,B9LVP8,M5RSF0,W0JW77,B7K585,F8D8G0,A0A343TL88,L0AJX6,A0A2A5QS34,A0A343JEE2,A0A3P3RGE5,A0A329TBQ3,A0A0W1S8B8,A0A1V4C8L7,L9VRQ2,E4NRV1,A0A1I6HGN0,A0A1I0NI68,,",366,37
"451","C.H9.11","C.L1.4",213,150,63,3.11142857142857,"4F1N,4F3T,5GUH,5VM9,6KR6,7KX7,7SWF,A0A163JTZ6,A0A0N4X8S8,Q389P5,A2DPV7,D2VMG4,A0A0D1ZAJ4,Q1K660,F4PH46,A0A3M7S814,A0A383WDW5,I0YVB2,C1DZY0,A0A2C5Z0M1,A0CB11,D3BMP8,W7XD45,A0A1U7LLR0,A0A4S2MWZ7,K1VVQ6,A0A158P1R9,G7DVX0,V6R0U9,G4N9J3,E3KLI3,B7Q5I1,A0A1E3QC61,D5GGK8,S8ANP9,L2GMR6,U4LBG4,A0A177URI1,O74957,A0A3N4IGK1,A6N7Y9,A0A0E9NDK5,T1KZ60,A0A250WXN5,A0A2G8JLH3,Q5KAT1,L2GUF2,W2T741,A0A1W0E4B5,A0A2J7QB22,S4RYE2,A0A2K3CW87,A0A388KES6,A0A226EFL3,A0A3S3PD82,A0A0L0TEV1,A0A1S3J512,G0QTT2,A0A1J1HRI1,Q9JMB7,Q5TW24,U5HIG6,A0A401PRI6,Q96J94,A0A2B4RHN2,G2QEV0,A0A397UU01,A0A2T7PFL8,K7ISV0,A0A0G4IME3,A0A1S3CYL5,D7FQK3,A0A1Y1YHC8,T1GSU4,F4S231,A0A1D8PMK0,A0A2G5B1D8,Q5BD61,A0A1C7M8P2,A0A4D8YSQ3,A0A158PJG6,J9JZ66,A0A0C2XG51,A0A158QZT6,A0A165QYQ9,R7YY92,A0A3S1A0C3,A0A2K1J482,A0A1Q3ENA6,O04379,A0A371I3C8,M8AEW7,A8P0D4,A0A2K3NY65,D8PZT7,A0A1D1W4K0,A7RQ46,W4YU94,A7BJS5,D8SNM6,A0A1J8PPA3,M5FQK2,Q69VD5,A0A2R6NSC2,A0A0D8XL16,A0A016WPN3,Q9QZ81,G5EES3,A0A0K0EFP6,Q8CJG0,A0A1D5NTU6,V2WTL2,A0A0V0YLH8,A0A139WDH0,A0A0R3W9Q7,H3DS31,A0A1Y1HWP2,B7QCC4,A0A0B2UV00,M7BCJ9,E9GN30,Q7PZ41,A0A077Z361,R7U9I3,A0A1X7V1N5,A0A0K0JDP1,A0A0N4UKJ1,A0A498N3A3,A0A3M0IQP5,A0A0L8GBV4,Q32KD4,A0A1J1JBJ0,E0W4C3,A0A482XDA9,A0A3P7EJD6,J9K2Z4,A0A2J7Q8V4,T1IBM6,V3ZRX0,A0A210QKF7,A0A423TSS1,K1PT78,A0A267E8R7,A0A1D2N447,A0A226D7A9,F6YK55,T1KTE4,A0A2C9JGZ6,A0A1V9X9F0,T1FY40,3DLB,5G5T,7R8K,C4L1M1,Q11QW7,A0A1M5ZSR3,A0A3D8L290,A0A1Q4R485,A0A1T4Y3A2,B7GJX9,A0A1N6SSK9,A0A060HNJ0,A0A235B542,R5XQK4,A0A1I2ZGP1,A0A317EJY3,A0A1I2BD20,F8ERC7,A0A1A5X8H4,A0A1I2T6Q1,Q8DKB1,A0A1J1EK56,A0A2T1E1K4,A0A1Q8ZD62,A0A1Z3HNN4,Q53W94,R5JEI2,A0A1V4CHV0,A0A2T1EKT1,A0A1N6LUI7,A0A0U3AL92,A0A1H3A054,Q31N05,A0A0C5JKF3,R5NJJ8,A5D4D9,Q2JI93,A0A142Y7A9,C1F5Q7,A0A1C9VH88,A0A329TD61,A0A1E3XF49,E0TGY3,A0A259TUP4,A0A4Q2UIU6,H1YCU5,A0A1Q5ZS75,A0A345E7N0,M0AF24,A0A1H3X247,M0D2X3,A0A346PK63,R7RTW6,A0A1H2RBI2,A0A1C3ZXN2,A0A343TL88,A0A343JEE2,A0A3P3RGE5,A0A329TBQ3,A0A0W1S8B8,L9VRQ2,E4NRV1,A0A1I6HGN0,,",366,37
"456","N.S4.1","N.S5.2",265,150,115,2.6268115942029,"4F1N,4F3T,4KRE,5GUH,6KR6,6OON,7KX7,7SWF,A0A0N4X8S8,C4LVV2,A0A2P6N8X7,A2DPV7,T1H8B3,S4RWI0,D2VMG4,A0A0D1ZAJ4,Q54G64,S7WCF7,R7QGN7,C1DZY0,A0CB11,R9ACY5,W7XD45,A0A1U7LLR0,K1VVQ6,A0A158P1R9,V6R0U9,E3KLI3,B7Q5I1,L2GMR6,O74957,A6N7Y9,A0A250WXN5,A0A2G8JLH3,Q5KAT1,L2GUF2,W2T741,A0A1W0E4B5,A0A2J7QB22,S4RYE2,A0A2K3CW87,A0A388KES6,A0A226EFL3,A0A3S3PD82,A0A0L0TEV1,A0A1S3J512,G0QTT2,A0A1J1HRI1,C4V9J2,Q9JMB7,A0A075AN09,U5HIG6,A0A401PRI6,Q96J94,A0A2B4RHN2,G2QEV0,A0A397UU01,A0A2T7PFL8,K7ISV0,A0A024FT57,A0A0G4IME3,E9FUN9,A0A1S3CYL5,D7FQK3,A0A1Y1YHC8,T1GSU4,F4S231,A0A2G5B1D8,Q5BD61,A0A1C7M8P2,A0A4D8YSQ3,A0A158PJG6,J9JZ66,A0A0C2XG51,A0A158QZT6,A0A165QYQ9,T0SAU8,R7YY92,A0A3S1A0C3,A0A074YJ47,A0A2K1J482,A0A1Q3ENA6,O04379,A0A371I3C8,M8AEW7,A8P0D4,A0A2K3NY65,F4NYW7,A0A409Y6G2,A0A0L0HAB7,D8PZT7,A0A1D1W4K0,A7RQ46,W4YU94,A7BJS5,D8SNM6,A0A1J8PPA3,X1WG39,M5FQK2,Q69VD5,A0A2R6NSC2,A0A0D8XL16,A0A016WPN3,Q9QZ81,G5EES3,A0A0K0EFP6,Q8CJG0,A0A1D5NTU6,V2WTL2,A0A0V0YLH8,A0A139WDH0,A0A0R3W9Q7,H3DS31,A0A1Y1HWP2,G4T5G9,B7QCC4,A0A0B2UV00,M7BCJ9,E9GN30,Q7PZ41,A0A077Z361,R7U9I3,A0A1X7V1N5,A0A0K0JDP1,A0A0N4UKJ1,A0A498N3A3,A0A3M0IQP5,A0A0L8GBV4,Q32KD4,A0A1J1JBJ0,E0W4C3,A0A482XDA9,A0A3P7EJD6,J9K2Z4,A0A2J7Q8V4,T1IBM6,V3ZRX0,A0A210QKF7,A0A423TSS1,K1PT78,A0A267E8R7,A0A1D2N447,A0A226D7A9,F6YK55,T1KTE4,A0A2C9JGZ6,A0A1V9X9F0,K5X5Z7,A0A3Q0KUG5,T1FY40,1YVU,1Z26,3DLB,5AWH,5G5T,6QZK,7R8K,K9U8J6,K9RC91,A0A0D8ZUC0,A0A139XGN8,A0YYT3,A0A2T1EFY0,G6FTN0,A0A433NB65,A0A1Z4L0A1,A0A2T1G8M7,B0JXD6,A0A1Z4K1Y3,A0A0P4UVI8,A0A0V7ZCG4,A0A1J0AGK2,K9PFF9,K9UEV4,A0A062U2W9,H0HWQ5,A0A1I2ZGP1,A0A317EJY3,A0A1I2BD20,F8ERC7,S7VLM7,A0A1A5X8H4,A0A1R3T9N6,A0A0Q2M2Z1,H8KXJ0,A0A2D1U4H7,A0A0B7I4Z6,A0LL61,Q8DKB1,A0A1J1EK56,A0A4Q6XKV6,A0A239JE83,A0A2N4XBY2,Q53W94,R5JEI2,A0A0Q0ZC47,A0A2T0XH18,A0A1V4CHV0,A0A1K1RQP7,A0A2T1EKT1,A0A1N6LUI7,A0A0P0NGR6,A0A1X7IML5,A0A0A2LKJ7,K1L112,A0A0U3AL92,A0A1H3A054,E0UCX3,K9XZC6,A0A0C1VHB4,Q31N05,A0A0C5JKF3,R5NJJ8,A5D4D9,Q2JI93,A0A142Y7A9,A0A432MEQ5,A0A372DKU2,C1F5Q7,A0A4R3EV39,A0A1P8WP90,A0A222F7P0,A0A1C9VH88,A0A2T2YMB1,A0A329TD61,A0A101R2A0,A0A1E3XF49,A0A1U9ND56,A0A4R7BQC4,A0A1Q1FPH0,E0TGY3,A0A259TUP4,F6EYI8,A0A2S9Q9J0,A0A4Q2UIU6,A0A1H0LH25,A0A318LG42,H1YCU5,L0JS08,A0A1Q5ZS75,M0AF24,A0A1W2A082,A0A1H3X247,A0A0C1XUA0,M0D2X3,A0A2R5G167,A0A346PK63,R7RTW6,A0A1H2RBI2,A0A1C3ZXN2,B9LVP8,M5RSF0,B7K585,F8D8G0,A0A343TL88,A0A343JEE2,A0A3P3RGE5,A0A329TBQ3,A0A285N2A8,A0A0W1S8B8,A0A1V4C8L7,L9VRQ2,E4NRV1,A0A1I6HGN0,A0A1I0NI68,,",366,37
"458","C.H10.10","C.S10.3",196,151,45,1.60125091979397,"4F1N,4F3T,4KRE,5GUH,6KR6,6OON,A0A163JTZ6,J9D5G4,C4LVV2,A2DPV7,A0A0G4H2S4,D2VMG4,A0A0D1ZAJ4,Q1K660,F4PH46,A0A3M7S814,A0A164ZA52,Q54G64,S7WCF7,I0YVB2,R7QGN7,A0A2C5Z0M1,A0CB11,R9ACY5,D3BMP8,A0A1Z5TVE5,W7XD45,A0A4S2MWZ7,A0A158P1R9,G7DVX0,V6R0U9,G4N9J3,B7Q5I1,D5GGK8,S8ANP9,A0A139AUH8,L2GMR6,U4LBG4,A0A177URI1,O74957,A6N7Y9,A0A0E9NDK5,T1KZ60,A0A250WXN5,A0A2G8JLH3,Q5KAT1,L2GUF2,W2T741,A0A1W0E4B5,A0A2J7QB22,S4RYE2,A0A388KES6,A0A226EFL3,A0A3S3PD82,A0A0L0TEV1,A0A1S3J512,G0QTT2,A0A1J1HRI1,C4V9J2,Q9JMB7,A0A075AN09,Q5TW24,U5HIG6,A0A401PRI6,Q96J94,A0A2B4RHN2,G2QEV0,A0A397UU01,A0A2T7PFL8,K7ISV0,A0A0G4IME3,E9FUN9,A0A1S3CYL5,A0A1Y1YHC8,T1GSU4,F4S231,A0A1D8PMK0,A0A2G5B1D8,Q5BD61,A0A1C7M8P2,A0A158PJG6,J9JZ66,A0A0C2XG51,A0A158QZT6,A0A165QYQ9,T0SAU8,R7YY92,A0A3S1A0C3,A0A074YJ47,A0A1Q3ENA6,A8P0D4,F4NYW7,A0A409Y6G2,A0A0L0HAB7,D8PZT7,A0A1D1W4K0,A7RQ46,W4YU94,A7BJS5,A0A1J8PPA3,X1WG39,M5FQK2,A0A0D8XL16,A0A016WPN3,Q9QZ81,G5EES3,A0A0K0EFP6,Q8CJG0,A0A1D5NTU6,V2WTL2,A0A0V0YLH8,A0A139WDH0,A0A0R3W9Q7,H3DS31,A0A1Y1HWP2,G4T5G9,B7QCC4,A0A0B2UV00,M7BCJ9,E9GN30,Q7PZ41,A0A077Z361,R7U9I3,A0A1X7V1N5,A0A0K0JDP1,A0A0N4UKJ1,A0A498N3A3,A0A3M0IQP5,A0A0L8GBV4,Q32KD4,A0A1J1JBJ0,E0W4C3,A0A482XDA9,A0A3P7EJD6,J9K2Z4,A0A2J7Q8V4,T1IBM6,V3ZRX0,A0A210QKF7,A0A423TSS1,K1PT78,A0A267E8R7,A0A1D2N447,A0A226D7A9,F6YK55,T1KTE4,A0A2C9JGZ6,A0A1V9X9F0,K5X5Z7,A0A3Q0KUG5,T1FY40,1Z26,5AWH,5G5T,6QZK,C4L1M1,A0A0M2PXX3,A0A2Z6E1D5,B1XJG0,A0A097QRL6,K9RC91,A0A139XGN8,B6YTQ5,A0A0B0H9B4,B7GJX9,B0JXD6,A0A1Z4K1Y3,A0A1N6SSK9,K9UEV4,A0A060HNJ0,A0A496APJ8,A0A1V9G9U4,A0A1I2BD20,A0A0Q2M2Z1,A0A2D1U4H7,I3TE64,A0A139WY18,A0A1J1EK56,A0A2T1E1K4,A0A1Q8ZD62,A0A1Z3HNN4,Q53W94,E0UCX3,K9XZC6,A0A0C1VHB4,R5NJJ8,A5D4D9,A0A2T2YMB1,A0A1Q1FPH0,R7RTW6,M5RSF0,A0A343TL88,A0A329TBQ3,A0A0W1S8B8,E4NRV1,A0A1I6HGN0,,",366,37
"468","C.S3.3","C.S4.3",274,152,122,1.91706212251941,"4F1N,4F3T,4KRE,5GUH,5VM9,6KR6,6OON,7KX7,7SWF,C4LVV2,A8BCK6,T1H8B3,S4RWI0,D2VMG4,A0A0D1ZAJ4,Q1K660,F4PH46,A0A3M7S814,A0A164ZA52,Q54G64,S7WCF7,I0YVB2,C1DZY0,A0A2C5Z0M1,A0CB11,R9ACY5,D3BMP8,W7XD45,A0A1U7LLR0,A0A4S2MWZ7,A0A158P1R9,G7DVX0,V6R0U9,G4N9J3,E3KLI3,B7Q5I1,A0A1E3QC61,D5GGK8,S8ANP9,A0A139AUH8,L2GMR6,U4LBG4,A0A177URI1,A0A3N4IGK1,A6N7Y9,A0A0E9NDK5,T1KZ60,A0A2G8JLH3,L2GUF2,W2T741,A0A1W0E4B5,A0A2J7QB22,S4RYE2,A0A2K3CW87,A0A388KES6,A0A226EFL3,A0A3S3PD82,A0A0L0TEV1,A0A1S3J512,G0QTT2,A0A1J1HRI1,C4V9J2,Q9JMB7,Q5TW24,U5HIG6,A0A401PRI6,Q96J94,A0A2B4RHN2,A0A2T7PFL8,K7ISV0,E9FUN9,A0A1S3CYL5,T1GSU4,A0A1D8PMK0,A0A2G5B1D8,Q5BD61,A0A1C7M8P2,A0A4D8YSQ3,J9JZ66,A0A0C2XG51,A0A158QZT6,A0A165QYQ9,A0A3S1A0C3,A0A074YJ47,A0A2K1J482,A0A1Q3ENA6,O04379,A0A371I3C8,M8AEW7,A8P0D4,A0A2K3NY65,A0A409Y6G2,D8PZT7,A0A1D1W4K0,A7RQ46,W4YU94,A7BJS5,D8SNM6,A0A1J8PPA3,X1WG39,M5FQK2,Q69VD5,A0A2R6NSC2,A0A0D8XL16,A0A016WPN3,Q9QZ81,G5EES3,A0A0K0EFP6,Q8CJG0,A0A1D5NTU6,V2WTL2,A0A0V0YLH8,A0A139WDH0,A0A0R3W9Q7,H3DS31,A0A1Y1HWP2,G4T5G9,B7QCC4,A0A0B2UV00,M7BCJ9,E9GN30,Q7PZ41,A0A077Z361,R7U9I3,A0A1X7V1N5,A0A0K0JDP1,A0A0N4UKJ1,A0A498N3A3,A0A3M0IQP5,A0A0L8GBV4,Q32KD4,A0A1J1JBJ0,E0W4C3,A0A482XDA9,A0A3P7EJD6,J9K2Z4,A0A2J7Q8V4,T1IBM6,V3ZRX0,A0A210QKF7,A0A423TSS1,K1PT78,A0A267E8R7,A0A1D2N447,A0A226D7A9,F6YK55,T1KTE4,A0A2C9JGZ6,A0A1V9X9F0,K5X5Z7,A0A3Q0KUG5,T1FY40,1YVU,1Z26,3DLB,5AWH,5G5T,5I4A,7R8K,E8N0K8,A0A1I7IXT4,A0A2W1JZ37,A0A2S7WBN3,A0A420DFE6,A0A4V1VDY2,A0A368P5I0,A0A4R1RMM2,A0A1Y2RDH8,A0A1M5ZSR3,A0A1L3JHM3,A0A1W6MIP2,A0A2U2J9E0,B1XJG0,A0A1T4Y3A2,A0A1H3LE92,A0A496APJ8,A0A062U2W9,H0HWQ5,A0A1V9G9U4,A0A1I2ZGP1,A0A317EJY3,A0A1I2BD20,F8ERC7,S7VLM7,A0A1A5X8H4,A0A1I2T6Q1,A0A1R3T9N6,A0A0Q2M2Z1,H8KXJ0,A0A2D1U4H7,A0A0B7I4Z6,A0LL61,Q8DKB1,A0A139WY18,A0A1J1EK56,A0A2T1E1K4,A0A1Q8ZD62,A0A4Q6XKV6,A0A1Z3HNN4,A0A239JE83,A0A2N4XBY2,Q53W94,R5JEI2,A0A0Q0ZC47,A0A2T0XH18,A0A1V4CHV0,A0A1K1RQP7,A0A2T1EKT1,A0A1N6LUI7,A0A0P0NGR6,A0A1X7IML5,A0A0A2LKJ7,K1L112,A0A0U3AL92,A0A1H3A054,E0UCX3,K9XZC6,B9LVW4,A0A0C1VHB4,Q31N05,A0A0C5JKF3,R5NJJ8,A5D4D9,Q2JI93,A0A142Y7A9,A0A432MEQ5,A0A372DKU2,A0A3R7KLK4,A0A4R3EV39,A0A1P8WP90,A0A222F7P0,A0A1C9VH88,A0A2T2YMB1,A0A329TD61,A0A1E3XF49,A0A1U9ND56,A0A4R7BQC4,A0A1H3DGN3,A0A1Q1FPH0,E0TGY3,A0A259TUP4,F6EYI8,A0A2S9Q9J0,A0A4Q2UIU6,H1YCU5,L0JS08,A0A1Q5ZS75,M0AF24,A0A1W2A082,A0A1H3X247,A0A0C1XUA0,M0D2X3,A0A2R5G167,A0A346PK63,R7RTW6,A0A1H2RBI2,A0A1C3ZXN2,M5RSF0,W0JW77,B7K585,F8D8G0,A0A343TL88,L0AJX6,A0A2A5QS34,A0A343JEE2,A0A3P3RGE5,A0A329TBQ3,A0A285N2A8,A0A0W1S8B8,A0A1V4C8L7,L9VRQ2,E4NRV1,A0A1I6HGN0,A0A1I0NI68,,",366,37
"473","N.H8.13","N.S2.2",243,152,91,4.01623048004627,"4F3T,4KRE,5GUH,5VM9,6KR6,6OON,7KX7,7SWF,Q389P5,C4LVV2,A2DPV7,T1H8B3,R1FDF0,S4RWI0,A0A074TLL7,A0A0D1ZAJ4,Q1K660,F4PH46,A0A164ZA52,Q54G64,S7WCF7,R7QGN7,C1DZY0,A0A2C5Z0M1,A0CB11,R9ACY5,D3BMP8,A0A1Z5TVE5,W7XD45,A0A1U7LLR0,A0A4S2MWZ7,K1VVQ6,V6R0U9,G4N9J3,E3KLI3,B7Q5I1,A0A1E3QC61,D5GGK8,S8ANP9,A0A139AUH8,U4LBG4,O74957,A0A3N4IGK1,A6N7Y9,A0A0E9NDK5,T1KZ60,A0A2G8JLH3,Q5KAT1,L2GUF2,A0A2J7QB22,S4RYE2,A0A388KES6,A0A226EFL3,A0A3S3PD82,A0A0L0TEV1,A0A1S3J512,G0QTT2,A0A1J1HRI1,C4V9J2,Q9JMB7,A0A075AN09,Q5TW24,U5HIG6,A0A401PRI6,Q96J94,A0A2B4RHN2,A0A397UU01,A0A2T7PFL8,K7ISV0,A0A024FT57,H3HCL6,A0A0G4IME3,E9FUN9,A0A1S3CYL5,D7FQK3,A0A1Y1YHC8,T1GSU4,F4S231,A0A1D8PMK0,A0A2G5B1D8,A0A4D8YSQ3,A0A158PJG6,J9JZ66,A0A0C2XG51,A0A158QZT6,A0A165QYQ9,T0SAU8,A0A3S1A0C3,A0A2K1J482,A0A1Q3ENA6,O04379,A0A371I3C8,M8AEW7,A0A2K3NY65,F4NYW7,A0A409Y6G2,A0A1D1W4K0,A7RQ46,W4YU94,A7BJS5,D8SNM6,A0A1J8PPA3,X1WG39,M5FQK2,Q69VD5,A0A0D8XL16,A0A016WPN3,Q9QZ81,G5EES3,A0A0K0EFP6,Q8CJG0,A0A1D5NTU6,A0A0V0YLH8,A0A139WDH0,A0A0R3W9Q7,H3DS31,A0A1Y1HWP2,G4T5G9,B7QCC4,A0A0B2UV00,M7BCJ9,E9GN30,Q7PZ41,A0A077Z361,R7U9I3,A0A1X7V1N5,A0A0K0JDP1,A0A0N4UKJ1,A0A498N3A3,A0A3M0IQP5,A0A0L8GBV4,Q32KD4,A0A1J1JBJ0,E0W4C3,A0A482XDA9,A0A3P7EJD6,J9K2Z4,A0A2J7Q8V4,T1IBM6,V3ZRX0,A0A210QKF7,A0A423TSS1,K1PT78,A0A267E8R7,A0A1D2N447,A0A226D7A9,F6YK55,T1KTE4,A0A2C9JGZ6,A0A1V9X9F0,A0A3Q0KUG5,T1FY40,1YVU,3DLB,5AWH,5G5T,6QZK,7R8K,A0A1I3LMA1,A0A1N6SSK9,R5XQK4,H0HWQ5,A0A1I2BD20,F8ERC7,S7VLM7,H8KXJ0,A0A2D1U4H7,A0A0B7I4Z6,A0LL61,Q8DKB1,A0A1J1EK56,A0A4Q6XKV6,A0A239JE83,A0A2N4XBY2,Q53W94,R5JEI2,A0A0Q0ZC47,A0A2T0XH18,A0A1V4CHV0,A0A1K1RQP7,A0A2T1EKT1,A0A0P0NGR6,A0A1X7IML5,A0A0A2LKJ7,K1L112,A0A0U3AL92,A0A1H3A054,E0UCX3,K9XZC6,A0A0C1VHB4,Q31N05,A0A0C5JKF3,R5NJJ8,A5D4D9,Q2JI93,A0A142Y7A9,A0A372DKU2,A0A3R7KLK4,C1F5Q7,A0A1P8WP90,A0A1C9VH88,A0A2T2YMB1,A0A101R2A0,A0A1E3XF49,A0A1U9ND56,A0A4R7BQC4,A0A1H3DGN3,A0A1Q1FPH0,E0TGY3,A0A259TUP4,F6EYI8,A0A2S9Q9J0,A0A4Q2UIU6,A0A1H0LH25,A0A318LG42,H1YCU5,L0JS08,A0A1Q5ZS75,A0A345E7N0,M0AF24,A0A1H3X247,A0A0C1XUA0,M0D2X3,A0A2R5G167,A0A346PK63,R7RTW6,A0A1C3ZXN2,B9LVP8,M5RSF0,W0JW77,B7K585,F8D8G0,A0A343TL88,L0AJX6,A0A2A5QS34,A0A343JEE2,A0A3P3RGE5,A0A329TBQ3,A0A0W1S8B8,L9VRQ2,E4NRV1,A0A1I6HGN0,A0A1I0NI68,,",366,37
"474","N.L26.4","N.S2.2",237,152,85,2.80990712074303,"4F3T,4KRE,5GUH,6KR6,6OON,Q389P5,T1H8B3,R1FDF0,S4RWI0,D2VMG4,A0A0D1ZAJ4,Q1K660,A0A164ZA52,A0A383WDW5,S7WCF7,R7QGN7,C1DZY0,A0A2C5Z0M1,A0CB11,R9ACY5,A0A1Z5TVE5,W7XD45,A0A1U7LLR0,A0A4S2MWZ7,K1VVQ6,G7DVX0,V6R0U9,G4N9J3,E3KLI3,B7Q5I1,A0A1E3QC61,D5GGK8,S8ANP9,A0A139AUH8,L2GMR6,U4LBG4,A0A177URI1,O74957,A0A3N4IGK1,A6N7Y9,A0A0E9NDK5,T1KZ60,A0A250WXN5,Q5KAT1,L2GUF2,A0A1W0E4B5,A0A2J7QB22,S4RYE2,A0A2K3CW87,A0A388KES6,A0A226EFL3,A0A3S3PD82,A0A0L0TEV1,A0A1S3J512,A0A1J1HRI1,C4V9J2,Q9JMB7,A0A075AN09,Q5TW24,U5HIG6,Q96J94,G2QEV0,A0A397UU01,A0A2T7PFL8,K7ISV0,A0A024FT57,H3HCL6,A0A0G4IME3,E9FUN9,D7FQK3,A0A1Y1YHC8,T1GSU4,F4S231,A0A2G5B1D8,A0A1C7M8P2,A0A4D8YSQ3,J9JZ66,A0A0C2XG51,A0A158QZT6,A0A165QYQ9,T0SAU8,R7YY92,A0A3S1A0C3,A0A2K1J482,A0A1Q3ENA6,O04379,A0A371I3C8,M8AEW7,A8P0D4,A0A2K3NY65,F4NYW7,A0A409Y6G2,A0A0L0HAB7,D8PZT7,A0A1D1W4K0,A7RQ46,W4YU94,A7BJS5,D8SNM6,A0A1J8PPA3,X1WG39,M5FQK2,Q69VD5,A0A2R6NSC2,A0A0D8XL16,A0A016WPN3,Q9QZ81,G5EES3,Q8CJG0,A0A1D5NTU6,V2WTL2,A0A0V0YLH8,A0A139WDH0,A0A0R3W9Q7,H3DS31,A0A1Y1HWP2,G4T5G9,B7QCC4,A0A0B2UV00,M7BCJ9,E9GN30,Q7PZ41,A0A077Z361,R7U9I3,A0A1X7V1N5,A0A0K0JDP1,A0A0N4UKJ1,A0A498N3A3,A0A3M0IQP5,A0A0L8GBV4,Q32KD4,A0A1J1JBJ0,E0W4C3,A0A482XDA9,A0A3P7EJD6,J9K2Z4,A0A2J7Q8V4,T1IBM6,V3ZRX0,A0A210QKF7,A0A423TSS1,K1PT78,A0A267E8R7,A0A1D2N447,A0A226D7A9,F6YK55,T1KTE4,A0A2C9JGZ6,A0A1V9X9F0,K5X5Z7,A0A3Q0KUG5,T1FY40,1YVU,3DLB,5AWH,5G5T,5I4A,6QZK,7R8K,A0A1I7IXT4,A0A2W1JZ37,A0A2S7WBN3,A0A420DFE6,A0A4V1VDY2,A0A368P5I0,A0A326U7G5,K9U8J6,K9RC91,A0A139XGN8,A0YYT3,A0A2T1EFY0,G6FTN0,A0A433NB65,A0A1Z4L0A1,A0A2T1G8M7,K9VUN0,K9ZDE3,B0JXD6,A0A1Z4K1Y3,A0A0P4UVI8,A0A0V7ZCG4,A0A1J0AGK2,K9PFF9,K9UEV4,H0HWQ5,A0A317EJY3,A0A1I2BD20,F8ERC7,S7VLM7,H8KXJ0,A0A2D1U4H7,A0A0B7I4Z6,A0A1J1EK56,A0A4Q6XKV6,A0A239JE83,A0A2N4XBY2,Q53W94,R5JEI2,A0A0Q0ZC47,A0A2T0XH18,A0A1V4CHV0,A0A1K1RQP7,A0A2T1EKT1,A0A1N6LUI7,A0A0P0NGR6,A0A1X7IML5,A0A0A2LKJ7,K1L112,A0A0U3AL92,A0A1H3A054,E0UCX3,K9XZC6,A0A0C1VHB4,Q31N05,A5D4D9,Q2JI93,C1F5Q7,A0A329TD61,A0A101R2A0,E0TGY3,H1YCU5,A0A1Q5ZS75,A0A345E7N0,M0AF24,M0D2X3,A0A2R5G167,A0A346PK63,A0A1C3ZXN2,B7K585,A0A343TL88,L0AJX6,A0A2A5QS34,A0A343JEE2,A0A3P3RGE5,A0A329TBQ3,A0A0W1S8B8,L9VRQ2,,",366,37
"475","N.S11.7","N.S9.1",240,152,88,2.28947368421053,"4F3T,4KRE,5GUH,5VM9,6KR6,6OON,7KX7,7SWF,C4LVV2,A2DPV7,A0A0G4H2S4,T1H8B3,R1FDF0,S4RWI0,A0A0D1ZAJ4,Q1K660,F4PH46,A0A3M7S814,A0A164ZA52,Q54G64,S7WCF7,I0YVB2,R7QGN7,C1DZY0,A0A2C5Z0M1,A0A1Z5TVE5,A0A1U7LLR0,A0A4S2MWZ7,G7DVX0,V6R0U9,G4N9J3,E3KLI3,A0A1E3QC61,D5GGK8,S8ANP9,A0A139AUH8,L2GMR6,U4LBG4,A0A177URI1,O74957,A0A3N4IGK1,A6N7Y9,A0A0E9NDK5,A0A250WXN5,Q5KAT1,L2GUF2,W2T741,A0A1W0E4B5,S4RYE2,A0A2K3CW87,A0A388KES6,A0A0L0TEV1,A0A1S3J512,A0A1J1HRI1,Q9JMB7,A0A075AN09,U5HIG6,A0A401PRI6,Q96J94,G2QEV0,A0A397UU01,A0A2T7PFL8,A0A024FT57,H3HCL6,A0A0G4IME3,A0A1S3CYL5,D7FQK3,A0A1Y1YHC8,T1GSU4,F4S231,A0A1D8PMK0,A0A2G5B1D8,Q5BD61,A0A1C7M8P2,A0A4D8YSQ3,A0A158PJG6,A0A0C2XG51,A0A158QZT6,A0A165QYQ9,T0SAU8,R7YY92,A0A3S1A0C3,A0A074YJ47,A0A2K1J482,A0A1Q3ENA6,O04379,A0A371I3C8,M8AEW7,A8P0D4,A0A2K3NY65,F4NYW7,A0A409Y6G2,A0A0L0HAB7,D8PZT7,A0A1D1W4K0,A7RQ46,W4YU94,A7BJS5,D8SNM6,A0A1J8PPA3,X1WG39,M5FQK2,Q69VD5,A0A2R6NSC2,A0A0D8XL16,A0A016WPN3,Q9QZ81,G5EES3,A0A0K0EFP6,Q8CJG0,A0A1D5NTU6,V2WTL2,A0A0V0YLH8,A0A139WDH0,A0A0R3W9Q7,H3DS31,A0A1Y1HWP2,G4T5G9,B7QCC4,A0A0B2UV00,M7BCJ9,E9GN30,Q7PZ41,A0A077Z361,R7U9I3,A0A1X7V1N5,A0A0K0JDP1,A0A0N4UKJ1,A0A498N3A3,A0A3M0IQP5,A0A0L8GBV4,Q32KD4,A0A1J1JBJ0,E0W4C3,A0A482XDA9,A0A3P7EJD6,J9K2Z4,A0A2J7Q8V4,T1IBM6,V3ZRX0,A0A210QKF7,A0A423TSS1,K1PT78,A0A267E8R7,A0A1D2N447,A0A226D7A9,F6YK55,T1KTE4,A0A2C9JGZ6,A0A1V9X9F0,K5X5Z7,A0A3Q0KUG5,3DLB,5AWH,5I4A,6QZK,7R8K,A0A1T4Y3A2,A0A2G9DT08,Q9L1X1,A0A1H3LE92,A0A496APJ8,A0A062U2W9,H0HWQ5,A0A1V9G9U4,A0A1I2ZGP1,A0A317EJY3,A0A1I2BD20,F8ERC7,S7VLM7,A0A1A5X8H4,A0A1I2T6Q1,A0A1R3T9N6,H8KXJ0,A0A2D1U4H7,A0A0B7I4Z6,A0LL61,A0A139WY18,A0A1J1EK56,A0A2T1E1K4,A0A1Q8ZD62,A0A4Q6XKV6,A0A1Z3HNN4,A0A239JE83,A0A2N4XBY2,Q53W94,R5JEI2,A0A0Q0ZC47,A0A2T0XH18,A0A1V4CHV0,A0A1K1RQP7,A0A1N6LUI7,A0A0P0NGR6,A0A1X7IML5,A0A0A2LKJ7,K1L112,A0A0U3AL92,A0A1H3A054,A0A0C5JKF3,A5D4D9,A0A142Y7A9,A0A432MEQ5,A0A372DKU2,A0A4R3EV39,A0A1P8WP90,A0A222F7P0,A0A1C9VH88,A0A2T2YMB1,A0A329TD61,A0A101R2A0,A0A1E3XF49,A0A1U9ND56,A0A4R7BQC4,A0A1Q1FPH0,E0TGY3,A0A259TUP4,F6EYI8,A0A2S9Q9J0,A0A4Q2UIU6,A0A1H0LH25,A0A318LG42,H1YCU5,A0A1Q5ZS75,A0A345E7N0,M0AF24,A0A1W2A082,A0A1H3X247,A0A0C1XUA0,M0D2X3,A0A2R5G167,A0A346PK63,A0A1H2RBI2,A0A1C3ZXN2,B9LVP8,M5RSF0,B7K585,A0A343JEE2,A0A329TBQ3,A0A1V4C8L7,A0A1I0NI68,,",366,37
"480","C.S12.7","C.S16.3",208,153,55,1.69988116458705,"4F1N,4F3T,4KRE,5GUH,5VM9,6KR6,6OON,7KX7,7SWF,A0A163JTZ6,A0A0N4X8S8,A0A196SDB4,J9D5G4,C4LVV2,A0A2P6N8X7,A8BCK6,A2DPV7,A0A0G4H2S4,R1FDF0,D2VMG4,A0A074TLL7,A0A0D1ZAJ4,Q1K660,F4PH46,A0A164ZA52,Q54G64,S7WCF7,I0YVB2,R7QGN7,C1DZY0,A0A2C5Z0M1,A0CB11,D3BMP8,W7XD45,A0A1U7LLR0,A0A4S2MWZ7,K1VVQ6,A0A158P1R9,G7DVX0,V6R0U9,G4N9J3,E3KLI3,A0A1E3QC61,D5GGK8,S8ANP9,L2GMR6,U4LBG4,A0A177URI1,O74957,A0A3N4IGK1,A6N7Y9,A0A0E9NDK5,A0A250WXN5,A0A2G8JLH3,Q5KAT1,L2GUF2,A0A1W0E4B5,A0A2J7QB22,S4RYE2,A0A2K3CW87,A0A388KES6,A0A226EFL3,A0A3S3PD82,A0A0L0TEV1,A0A1S3J512,G0QTT2,A0A1J1HRI1,C4V9J2,Q9JMB7,A0A075AN09,Q5TW24,U5HIG6,A0A401PRI6,Q96J94,G2QEV0,A0A397UU01,A0A2T7PFL8,K7ISV0,A0A024FT57,H3HCL6,A0A0G4IME3,E9FUN9,A0A1S3CYL5,D7FQK3,A0A1Y1YHC8,F4S231,A0A1D8PMK0,A0A2G5B1D8,A0A1C7M8P2,A0A4D8YSQ3,J9JZ66,A0A0C2XG51,A0A165QYQ9,T0SAU8,R7YY92,A0A3S1A0C3,A0A074YJ47,A0A2K1J482,A0A1Q3ENA6,O04379,A0A371I3C8,M8AEW7,A8P0D4,A0A2K3NY65,F4NYW7,A0A409Y6G2,A0A0L0HAB7,D8PZT7,A0A1D1W4K0,A7RQ46,W4YU94,A7BJS5,D8SNM6,A0A1J8PPA3,X1WG39,Q69VD5,A0A2R6NSC2,Q9QZ81,Q8CJG0,A0A1D5NTU6,V2WTL2,A0A139WDH0,A0A0R3W9Q7,A0A1Y1HWP2,G4T5G9,B7QCC4,M7BCJ9,E9GN30,Q7PZ41,R7U9I3,A0A1X7V1N5,A0A498N3A3,A0A3M0IQP5,A0A0L8GBV4,Q32KD4,A0A1J1JBJ0,E0W4C3,A0A482XDA9,A0A3P7EJD6,J9K2Z4,A0A2J7Q8V4,T1IBM6,V3ZRX0,A0A210QKF7,A0A267E8R7,A0A1D2N447,A0A226D7A9,F6YK55,A0A2C9JGZ6,A0A1V9X9F0,K5X5Z7,A0A3Q0KUG5,T1FY40,5G5T,A0A4R1RMM2,A0A1L3JHM3,A0A1W6MIP2,A0A2Z6E1D5,K9U8J6,K9RC91,A0A0D8ZUC0,A0A139XGN8,B6YTQ5,A0A0B0H9B4,A0A2T1EFY0,A0A1Z4L0A1,K9VUN0,B7GJX9,A0A0P6X5X2,K9ZDE3,B0JXD6,A0A0V7ZCG4,A0A1J0AGK2,K9PFF9,A0A2G9DT08,Q9L1X1,A0A1V9G9U4,A0A1I2ZGP1,A0A1I2BD20,F8ERC7,A0A1R3T9N6,I3TE64,A0LL61,A0A1N6LUI7,A0A0U3AL92,A0A1H3A054,A5D4D9,A0A1P8WP90,A0A222F7P0,A0A101R2A0,A0A1U9ND56,A0A4R7BQC4,A0A259TUP4,F6EYI8,A0A2S9Q9J0,A0A1H0LH25,A0A318LG42,H1YCU5,A0A1Q5ZS75,A0A1W2A082,A0A0C1XUA0,R7RTW6,A0A343TL88,A0A0W1S8B8,A0A1V4C8L7,L9VRQ2,E4NRV1,A0A1I6HGN0,,",366,37
"481","C.S13.2","N.H8.2",228,153,75,1.76261437908497,"4F3T,4KRE,5GUH,5VM9,6OON,7SWF,A0A163JTZ6,A0A196SDB4,R1FDF0,S4RWI0,D2VMG4,A0A074TLL7,A0A0D1ZAJ4,Q1K660,F4PH46,A0A3M7S814,A0A383WDW5,Q54G64,S7WCF7,I0YVB2,R7QGN7,C1DZY0,A0A2C5Z0M1,A0CB11,R9ACY5,D3BMP8,A0A1Z5TVE5,W7XD45,A0A1U7LLR0,A0A158P1R9,V6R0U9,G4N9J3,B7Q5I1,D5GGK8,S8ANP9,A0A139AUH8,L2GMR6,U4LBG4,A0A177URI1,A0A3N4IGK1,A6N7Y9,A0A0E9NDK5,T1KZ60,A0A2G8JLH3,Q5KAT1,W2T741,A0A2J7QB22,S4RYE2,A0A2K3CW87,A0A388KES6,A0A226EFL3,A0A3S3PD82,A0A0L0TEV1,A0A1S3J512,G0QTT2,Q9JMB7,Q5TW24,U5HIG6,A0A401PRI6,Q96J94,A0A2B4RHN2,G2QEV0,A0A397UU01,A0A2T7PFL8,K7ISV0,A0A024FT57,H3HCL6,A0A1S3CYL5,D7FQK3,A0A1Y1YHC8,T1GSU4,A0A2G5B1D8,Q5BD61,A0A1C7M8P2,A0A4D8YSQ3,A0A158PJG6,J9JZ66,A0A158QZT6,A0A165QYQ9,T0SAU8,R7YY92,A0A3S1A0C3,A0A074YJ47,A0A2K1J482,A0A1Q3ENA6,O04379,A0A371I3C8,M8AEW7,A8P0D4,A0A2K3NY65,F4NYW7,A0A409Y6G2,A0A0L0HAB7,D8PZT7,A0A1D1W4K0,A7RQ46,W4YU94,A7BJS5,D8SNM6,A0A1J8PPA3,X1WG39,M5FQK2,Q69VD5,A0A2R6NSC2,A0A0D8XL16,A0A016WPN3,Q9QZ81,G5EES3,A0A0K0EFP6,Q8CJG0,A0A1D5NTU6,V2WTL2,A0A0V0YLH8,A0A139WDH0,A0A0R3W9Q7,H3DS31,A0A1Y1HWP2,G4T5G9,B7QCC4,A0A0B2UV00,M7BCJ9,E9GN30,Q7PZ41,A0A077Z361,R7U9I3,A0A1X7V1N5,A0A0K0JDP1,A0A0N4UKJ1,A0A498N3A3,A0A3M0IQP5,A0A0L8GBV4,Q32KD4,A0A1J1JBJ0,E0W4C3,A0A482XDA9,A0A3P7EJD6,J9K2Z4,A0A2J7Q8V4,T1IBM6,V3ZRX0,A0A210QKF7,A0A423TSS1,K1PT78,A0A267E8R7,A0A1D2N447,A0A226D7A9,F6YK55,T1KTE4,A0A2C9JGZ6,A0A1V9X9F0,K5X5Z7,A0A3Q0KUG5,T1FY40,1YVU,1Z26,3DLB,6QZK,7R8K,E0ST67,A0A142XB92,A0A3D8L290,A0A0P6X5X2,A0A2G9DT08,Q9L1X1,A0A496APJ8,A0A062U2W9,H0HWQ5,A0A1V9G9U4,A0A1I2ZGP1,A0A317EJY3,A0A1I2BD20,F8ERC7,S7VLM7,A0A1A5X8H4,H8KXJ0,A0A2D1U4H7,A0A139WY18,A0A1J1EK56,A0A2T1E1K4,A0A1Q8ZD62,A0A4Q6XKV6,A0A1Z3HNN4,A0A239JE83,A0A2N4XBY2,R5JEI2,A0A2T0XH18,A0A1K1RQP7,A0A1N6LUI7,A0A0P0NGR6,A0A1X7IML5,A0A0A2LKJ7,A0A0U3AL92,A0A1H3A054,A0A0C5JKF3,R5NJJ8,A0A372DKU2,A0A4R3EV39,A0A1C9VH88,A0A2T2YMB1,A0A329TD61,A0A101R2A0,A0A1E3XF49,A0A1H3DGN3,A0A1Q1FPH0,A0A259TUP4,F6EYI8,A0A2S9Q9J0,A0A1H0LH25,A0A318LG42,L0JS08,A0A345E7N0,M0AF24,A0A1H3X247,A0A0C1XUA0,M0D2X3,A0A346PK63,B9LVP8,F8D8G0,A0A343TL88,A0A343JEE2,A0A3P3RGE5,A0A329TBQ3,A0A0W1S8B8,A0A1V4C8L7,L9VRQ2,E4NRV1,A0A1I6HGN0,A0A1I0NI68,,",366,37
"486","N.L7.3","N.S3.5",195,153,42,2.10434173669468,"4F1N,4F3T,4KRE,5GUH,5VM9,6OON,A0A196SDB4,Q389P5,C4LVV2,A2DPV7,T1H8B3,S4RWI0,D2VMG4,A0A0D1ZAJ4,Q1K660,A0A164ZA52,S7WCF7,I0YVB2,R7QGN7,A0A2C5Z0M1,A0CB11,R9ACY5,A0A1U7LLR0,A0A4S2MWZ7,K1VVQ6,A0A158P1R9,G7DVX0,V6R0U9,G4N9J3,E3KLI3,B7Q5I1,A0A1E3QC61,S8ANP9,A0A139AUH8,L2GMR6,U4LBG4,A0A177URI1,O74957,A0A3N4IGK1,A6N7Y9,A0A0E9NDK5,A0A250WXN5,A0A2G8JLH3,Q5KAT1,L2GUF2,A0A2J7QB22,S4RYE2,A0A226EFL3,A0A0L0TEV1,A0A1S3J512,C4V9J2,Q9JMB7,A0A075AN09,Q5TW24,U5HIG6,A0A401PRI6,Q96J94,A0A2B4RHN2,G2QEV0,A0A397UU01,A0A2T7PFL8,K7ISV0,A0A024FT57,A0A0G4IME3,E9FUN9,A0A1S3CYL5,D7FQK3,A0A1Y1YHC8,T1GSU4,F4S231,A0A1D8PMK0,A0A2G5B1D8,Q5BD61,A0A1C7M8P2,A0A4D8YSQ3,A0A158PJG6,J9JZ66,A0A0C2XG51,A0A158QZT6,A0A165QYQ9,T0SAU8,R7YY92,A0A3S1A0C3,A0A074YJ47,A0A2K1J482,A0A1Q3ENA6,O04379,A0A371I3C8,M8AEW7,A8P0D4,A0A2K3NY65,F4NYW7,A0A409Y6G2,A0A0L0HAB7,D8PZT7,A0A1D1W4K0,A7RQ46,W4YU94,A7BJS5,D8SNM6,A0A1J8PPA3,X1WG39,M5FQK2,Q69VD5,A0A2R6NSC2,A0A0D8XL16,A0A016WPN3,Q9QZ81,G5EES3,A0A0K0EFP6,Q8CJG0,A0A1D5NTU6,V2WTL2,A0A0V0YLH8,A0A139WDH0,A0A0R3W9Q7,H3DS31,A0A1Y1HWP2,B7QCC4,A0A0B2UV00,M7BCJ9,E9GN30,Q7PZ41,A0A077Z361,R7U9I3,A0A1X7V1N5,A0A0K0JDP1,A0A0N4UKJ1,A0A498N3A3,A0A3M0IQP5,A0A0L8GBV4,Q32KD4,A0A1J1JBJ0,E0W4C3,A0A482XDA9,A0A3P7EJD6,J9K2Z4,A0A2J7Q8V4,T1IBM6,V3ZRX0,A0A210QKF7,A0A423TSS1,K1PT78,A0A267E8R7,A0A1D2N447,A0A226D7A9,F6YK55,T1KTE4,A0A2C9JGZ6,A0A1V9X9F0,K5X5Z7,A0A3Q0KUG5,T1FY40,5G5T,A0A1I3LMA1,A0A0B0H9B4,R6KUL9,B7GJX9,A0A1N6SSK9,A0A235B542,R5XQK4,A0A0Q2M2Z1,D3S0S6,I3TE64,Q8DKB1,A0A2T1EKT1,E0UCX3,K9XZC6,B9LVW4,A0A0C1VHB4,Q31N05,R5NJJ8,Q2JI93,A0A1E3XF49,L0JS08,M0AF24,A0A1W2A082,M0D2X3,A0A346PK63,R7RTW6,W0JW77,F8D8G0,A0A343TL88,L0AJX6,A0A2A5QS34,A0A343JEE2,A0A3P3RGE5,A0A329TBQ3,A0A285N2A8,A0A0W1S8B8,A0A1V4C8L7,L9VRQ2,E4NRV1,A0A1I6HGN0,A0A1I0NI68,,",366,37
"489","C.H4.4","C.H4.6",269,154,115,1.71019198193111,"4F1N,4F3T,4KRE,5GUH,6KR6,6OON,7KX7,7SWF,A0A163JTZ6,A0A0N4X8S8,J9D5G4,C4LVV2,A0A2P6N8X7,S4RWI0,A0A0D1ZAJ4,Q1K660,A0A3M7S814,A0A164ZA52,S7WCF7,A0A2C5Z0M1,A0CB11,R9ACY5,A0A1Z5TVE5,A0A1U7LLR0,A0A4S2MWZ7,K1VVQ6,A0A158P1R9,V6R0U9,G4N9J3,E3KLI3,B7Q5I1,A0A1E3QC61,D5GGK8,S8ANP9,L2GMR6,U4LBG4,A0A177URI1,O74957,A6N7Y9,A0A0E9NDK5,T1KZ60,A0A250WXN5,A0A2G8JLH3,Q5KAT1,L2GUF2,W2T741,A0A1W0E4B5,A0A2J7QB22,S4RYE2,A0A388KES6,A0A226EFL3,A0A3S3PD82,A0A0L0TEV1,A0A1S3J512,C4V9J2,Q9JMB7,A0A075AN09,U5HIG6,A0A401PRI6,Q96J94,A0A2B4RHN2,G2QEV0,A0A397UU01,A0A2T7PFL8,K7ISV0,A0A024FT57,H3HCL6,A0A0G4IME3,A0A1S3CYL5,D7FQK3,A0A1Y1YHC8,T1GSU4,A0A1D8PMK0,A0A2G5B1D8,Q5BD61,A0A4D8YSQ3,A0A158PJG6,J9JZ66,A0A0C2XG51,A0A158QZT6,T0SAU8,R7YY92,A0A3S1A0C3,A0A074YJ47,A0A2K1J482,A0A1Q3ENA6,O04379,A0A371I3C8,M8AEW7,A8P0D4,A0A2K3NY65,F4NYW7,A0A409Y6G2,A0A0L0HAB7,D8PZT7,A0A1D1W4K0,A7RQ46,W4YU94,A7BJS5,D8SNM6,A0A1J8PPA3,X1WG39,M5FQK2,Q69VD5,A0A2R6NSC2,A0A0D8XL16,A0A016WPN3,Q9QZ81,G5EES3,A0A0K0EFP6,Q8CJG0,A0A1D5NTU6,V2WTL2,A0A0V0YLH8,A0A139WDH0,A0A0R3W9Q7,H3DS31,A0A1Y1HWP2,G4T5G9,B7QCC4,A0A0B2UV00,M7BCJ9,E9GN30,Q7PZ41,A0A077Z361,R7U9I3,A0A1X7V1N5,A0A0K0JDP1,A0A0N4UKJ1,A0A498N3A3,A0A3M0IQP5,A0A0L8GBV4,Q32KD4,A0A1J1JBJ0,E0W4C3,A0A482XDA9,A0A3P7EJD6,J9K2Z4,A0A2J7Q8V4,T1IBM6,V3ZRX0,A0A210QKF7,A0A423TSS1,K1PT78,A0A267E8R7,A0A1D2N447,A0A226D7A9,F6YK55,T1KTE4,A0A2C9JGZ6,A0A1V9X9F0,K5X5Z7,A0A3Q0KUG5,T1FY40,1YVU,1Z26,5AWH,5G5T,5I4A,6QZK,A0A1Y2RDH8,A0A1M5ZSR3,A0A0K8QX04,A0A0M2PXX3,K9TPA9,A0A1C0UUC4,A0A2Z6E1D5,A0A0F4NXW8,A0A3D8L290,H1KXR6,K9U8J6,K9RC91,A0A0D8ZUC0,A0A139XGN8,A0A1T4Y3A2,Q5P0R2,A0YYT3,A0A2T1EFY0,G6FTN0,A0A433NB65,A0A1Z4L0A1,K9UQR0,A0A2T1G8M7,K9VUN0,A0A0P6X5X2,K9ZDE3,B0JXD6,A0A2T1LS63,A0A2Z6E0R7,A0A0P4UVI8,A0A0V7ZCG4,A0A1J0AGK2,A0A2G9DT08,K9UEV4,Q9L1X1,A0A496APJ8,H0HWQ5,A0A1V9G9U4,S7VLM7,A0A1A5X8H4,A0A1I2T6Q1,A0A1R3T9N6,H8KXJ0,A0A2D1U4H7,A0A0B7I4Z6,A0LL61,A0A139WY18,A0A2T1E1K4,A0A1Q8ZD62,A0A4Q6XKV6,A0A1Z3HNN4,A0A239JE83,A0A2N4XBY2,R5JEI2,A0A0Q0ZC47,A0A2T0XH18,A0A1V4CHV0,A0A1K1RQP7,A0A1N6LUI7,A0A0P0NGR6,A0A1X7IML5,A0A0A2LKJ7,K1L112,A0A0U3AL92,A0A1H3A054,A0A0C5JKF3,R5NJJ8,A5D4D9,A0A142Y7A9,A0A432MEQ5,A0A372DKU2,A0A3R7KLK4,C1F5Q7,A0A4R3EV39,A0A1P8WP90,A0A222F7P0,A0A1C9VH88,A0A2T2YMB1,A0A329TD61,A0A101R2A0,A0A1E3XF49,A0A1U9ND56,A0A4R7BQC4,A0A1H3DGN3,E0TGY3,A0A259TUP4,F6EYI8,A0A2S9Q9J0,A0A4Q2UIU6,A0A1H0LH25,A0A318LG42,H1YCU5,A0A1Q5ZS75,A0A345E7N0,A0A1W2A082,A0A1H3X247,A0A0C1XUA0,A0A2R5G167,A0A346PK63,R7RTW6,A0A1H2RBI2,A0A1C3ZXN2,B9LVP8,M5RSF0,B7K585,F8D8G0,A0A343JEE2,A0A1V4C8L7,A0A1I0NI68,,",366,37
"493","C.L3.11","C.L3.9",293,154,139,1.78695225637672,"4F1N,4F3T,4KRE,5GUH,5VM9,6KR6,6OON,7KX7,7SWF,A0A163JTZ6,J9D5G4,T1H8B3,S4RWI0,A0A0D1ZAJ4,Q1K660,A0A3M7S814,A0A164ZA52,I0YVB2,A0A2C5Z0M1,A0A1Z5TVE5,A0A1U7LLR0,A0A4S2MWZ7,K1VVQ6,A0A158P1R9,G7DVX0,V6R0U9,G4N9J3,E3KLI3,B7Q5I1,A0A1E3QC61,D5GGK8,S8ANP9,A0A139AUH8,L2GMR6,U4LBG4,A0A177URI1,O74957,A0A3N4IGK1,A0A0E9NDK5,T1KZ60,A0A250WXN5,A0A2G8JLH3,Q5KAT1,L2GUF2,W2T741,A0A1W0E4B5,A0A2J7QB22,A0A2K3CW87,A0A388KES6,A0A226EFL3,A0A3S3PD82,A0A0L0TEV1,A0A1S3J512,A0A1J1HRI1,C4V9J2,Q9JMB7,A0A075AN09,Q5TW24,U5HIG6,A0A401PRI6,Q96J94,A0A2B4RHN2,A0A397UU01,A0A2T7PFL8,K7ISV0,A0A024FT57,H3HCL6,A0A0G4IME3,A0A1S3CYL5,D7FQK3,A0A1Y1YHC8,T1GSU4,F4S231,A0A1D8PMK0,A0A2G5B1D8,Q5BD61,A0A1C7M8P2,A0A4D8YSQ3,A0A158PJG6,A0A0C2XG51,A0A158QZT6,T0SAU8,R7YY92,A0A3S1A0C3,A0A074YJ47,A0A2K1J482,A0A1Q3ENA6,O04379,A0A371I3C8,M8AEW7,A8P0D4,A0A2K3NY65,F4NYW7,A0A409Y6G2,A0A0L0HAB7,D8PZT7,A0A1D1W4K0,W4YU94,A7BJS5,D8SNM6,A0A1J8PPA3,X1WG39,M5FQK2,Q69VD5,A0A2R6NSC2,A0A0D8XL16,A0A016WPN3,Q9QZ81,G5EES3,A0A0K0EFP6,Q8CJG0,A0A1D5NTU6,V2WTL2,A0A0V0YLH8,A0A139WDH0,A0A0R3W9Q7,H3DS31,A0A1Y1HWP2,G4T5G9,B7QCC4,A0A0B2UV00,M7BCJ9,E9GN30,Q7PZ41,A0A077Z361,R7U9I3,A0A1X7V1N5,A0A0K0JDP1,A0A0N4UKJ1,A0A498N3A3,A0A3M0IQP5,A0A0L8GBV4,Q32KD4,A0A1J1JBJ0,E0W4C3,A0A482XDA9,A0A3P7EJD6,J9K2Z4,A0A2J7Q8V4,T1IBM6,V3ZRX0,A0A210QKF7,A0A423TSS1,K1PT78,A0A267E8R7,A0A1D2N447,A0A226D7A9,F6YK55,T1KTE4,A0A2C9JGZ6,A0A1V9X9F0,K5X5Z7,A0A3Q0KUG5,T1FY40,1YVU,3DLB,5AWH,5I4A,E8N0K8,A0A1I7IXT4,A0A2W1JZ37,A0A2S7WBN3,A0A328VKE4,A0A420DFE6,A0A4V1VDY2,A0A368P5I0,C4L1M1,A0A4R1RMM2,A0A1Y2RDH8,Q11QW7,A0A1M5ZSR3,A0A0K8QX04,A0A1I3LMA1,K9TPA9,A0A1L3JHM3,A0A1W6MIP2,A0A2U2J9E0,A0A142XB92,B1XJG0,A0A3D8L290,A0A1Q4R485,K9U8J6,K9RC91,A0A0D8ZUC0,A0A139XGN8,A0A1T4Y3A2,A0A0B0H9B4,A0YYT3,A0A2T1EFY0,G6FTN0,R6KUL9,A0A433NB65,A0A1Z4L0A1,K9UQR0,A0A2T1G8M7,K9VUN0,B7GJX9,K9ZDE3,B0JXD6,A0A2T1LS63,A0A1Z4K1Y3,A0A1N6SSK9,A0A0P4UVI8,A0A0V7ZCG4,A0A1J0AGK2,K9PFF9,A0A2G9DT08,K9UEV4,Q9L1X1,A0A060HNJ0,A0A235B542,R5XQK4,A0A496APJ8,A0A1V9G9U4,S7VLM7,A0A1A5X8H4,A0A1I2T6Q1,A0A1R3T9N6,H8KXJ0,A0A2D1U4H7,A0A0B7I4Z6,A0LL61,Q8DKB1,A0A139WY18,A0A1J1EK56,A0A2T1E1K4,A0A1Q8ZD62,A0A4Q6XKV6,A0A1Z3HNN4,A0A239JE83,A0A2N4XBY2,Q53W94,R5JEI2,A0A0Q0ZC47,A0A2T0XH18,A0A1V4CHV0,A0A1K1RQP7,A0A2T1EKT1,A0A1N6LUI7,A0A0P0NGR6,A0A1X7IML5,A0A0A2LKJ7,K1L112,A0A0U3AL92,A0A1H3A054,E0UCX3,K9XZC6,A0A0C1VHB4,Q31N05,A0A0C5JKF3,A5D4D9,Q2JI93,A0A142Y7A9,A0A432MEQ5,A0A372DKU2,A0A3R7KLK4,C1F5Q7,A0A4R3EV39,A0A1P8WP90,A0A222F7P0,A0A1C9VH88,A0A2T2YMB1,A0A329TD61,A0A101R2A0,A0A1E3XF49,A0A1U9ND56,A0A4R7BQC4,A0A1H3DGN3,A0A1Q1FPH0,E0TGY3,A0A259TUP4,F6EYI8,A0A2S9Q9J0,A0A4Q2UIU6,A0A1H0LH25,A0A318LG42,H1YCU5,A0A1Q5ZS75,A0A345E7N0,A0A1W2A082,A0A1H3X247,A0A0C1XUA0,A0A2R5G167,A0A346PK63,A0A1H2RBI2,A0A1C3ZXN2,B9LVP8,M5RSF0,B7K585,F8D8G0,A0A329TBQ3,A0A1V4C8L7,A0A1I0NI68,,",366,37
"499","C.H5.11","C.S6.3",255,155,100,1.87145161290323,"4F3T,4KRE,5GUH,5VM9,6KR6,6OON,7KX7,7SWF,A0A163JTZ6,A0A196SDB4,C4LVV2,A8BCK6,A2DPV7,A0A0G4H2S4,T1H8B3,S4RWI0,D2VMG4,A0A074TLL7,Q1K660,F4PH46,A0A3M7S814,A0A164ZA52,A0A383WDW5,S7WCF7,I0YVB2,R7QGN7,C1DZY0,A0CB11,R9ACY5,D3BMP8,A0A1Z5TVE5,W7XD45,A0A4S2MWZ7,K1VVQ6,A0A158P1R9,G7DVX0,G4N9J3,E3KLI3,B7Q5I1,A0A1E3QC61,D5GGK8,S8ANP9,A0A139AUH8,L2GMR6,A0A177URI1,O74957,A0A3N4IGK1,A6N7Y9,T1KZ60,A0A250WXN5,Q5KAT1,L2GUF2,W2T741,A0A1W0E4B5,A0A2J7QB22,S4RYE2,A0A2K3CW87,A0A388KES6,A0A3S3PD82,A0A0L0TEV1,A0A1S3J512,G0QTT2,A0A1J1HRI1,C4V9J2,Q9JMB7,A0A075AN09,Q5TW24,U5HIG6,A0A401PRI6,Q96J94,A0A2B4RHN2,A0A397UU01,A0A2T7PFL8,K7ISV0,A0A024FT57,A0A0G4IME3,E9FUN9,A0A1S3CYL5,D7FQK3,A0A1Y1YHC8,T1GSU4,F4S231,A0A2G5B1D8,A0A4D8YSQ3,A0A158PJG6,J9JZ66,A0A0C2XG51,A0A158QZT6,T0SAU8,A0A3S1A0C3,A0A2K1J482,A0A1Q3ENA6,O04379,A0A371I3C8,M8AEW7,A0A2K3NY65,F4NYW7,A0A409Y6G2,A0A0L0HAB7,A0A1D1W4K0,A7RQ46,W4YU94,A7BJS5,D8SNM6,A0A1J8PPA3,X1WG39,M5FQK2,Q69VD5,A0A0D8XL16,A0A016WPN3,Q9QZ81,G5EES3,A0A0K0EFP6,Q8CJG0,A0A1D5NTU6,A0A0V0YLH8,A0A139WDH0,A0A0R3W9Q7,H3DS31,A0A1Y1HWP2,G4T5G9,B7QCC4,A0A0B2UV00,M7BCJ9,E9GN30,Q7PZ41,A0A077Z361,R7U9I3,A0A1X7V1N5,A0A0K0JDP1,A0A0N4UKJ1,A0A498N3A3,A0A3M0IQP5,A0A0L8GBV4,Q32KD4,A0A1J1JBJ0,E0W4C3,A0A482XDA9,A0A3P7EJD6,J9K2Z4,A0A2J7Q8V4,T1IBM6,V3ZRX0,A0A210QKF7,A0A423TSS1,K1PT78,A0A267E8R7,A0A1D2N447,A0A226D7A9,F6YK55,T1KTE4,A0A2C9JGZ6,A0A1V9X9F0,A0A3Q0KUG5,T1FY40,1YVU,1Z26,3DLB,5AWH,5G5T,5I4A,6QZK,7R8K,E0ST67,C4L1M1,Q11QW7,A0A0K8QX04,A0A1I3LMA1,A0A1L3JHM3,A0A2U2J9E0,A0A2Z6E1D5,A0A0F4NXW8,B1XJG0,A0A326U7G5,A0A3D8L290,H1KXR6,A0A097QRL6,A0A1T4Y3A2,Q5P0R2,B6YTQ5,A0A0B0H9B4,R6KUL9,B7GJX9,A0A2Z6E0R7,A0A1N6SSK9,A0A1J0AGK2,A0A2G9DT08,Q9L1X1,A0A060HNJ0,A0A235B542,R5XQK4,A0A1H3LE92,A0A496APJ8,A0A062U2W9,H0HWQ5,A0A1V9G9U4,A0A1I2ZGP1,A0A317EJY3,A0A1I2BD20,F8ERC7,S7VLM7,A0A0Q2M2Z1,H8KXJ0,A0A2D1U4H7,A0A0B7I4Z6,A0LL61,A0A139WY18,A0A2T1E1K4,A0A1Q8ZD62,A0A4Q6XKV6,A0A1Z3HNN4,A0A239JE83,A0A2N4XBY2,R5JEI2,A0A0Q0ZC47,A0A0P0NGR6,A0A1X7IML5,A0A0U3AL92,A0A1H3A054,K9XZC6,A0A0C1VHB4,A0A0C5JKF3,R5NJJ8,A0A372DKU2,A0A3R7KLK4,A0A1C9VH88,A0A2T2YMB1,A0A101R2A0,A0A1U9ND56,A0A4R7BQC4,A0A1H3DGN3,E0TGY3,A0A259TUP4,A0A1H0LH25,A0A318LG42,H1YCU5,A0A1Q5ZS75,A0A1W2A082,R7RTW6,A0A1C3ZXN2,M5RSF0,W0JW77,B7K585,F8D8G0,A0A343TL88,A0A2A5QS34,A0A343JEE2,A0A3P3RGE5,A0A329TBQ3,A0A285N2A8,A0A0W1S8B8,A0A1V4C8L7,E4NRV1,A0A1I6HGN0,A0A1I0NI68,,",366,37
"503","C.L3.12","C.L3.9",209,155,54,2.28936678614098,"4F1N,4F3T,4KRE,5GUH,5VM9,6KR6,6OON,A0A163JTZ6,J9D5G4,T1H8B3,R1FDF0,S4RWI0,D2VMG4,A0A074TLL7,A0A0D1ZAJ4,Q1K660,A0A3M7S814,A0A164ZA52,I0YVB2,R7QGN7,A0A2C5Z0M1,A0A1Z5TVE5,A0A1U7LLR0,A0A4S2MWZ7,K1VVQ6,G7DVX0,V6R0U9,G4N9J3,E3KLI3,B7Q5I1,A0A1E3QC61,D5GGK8,S8ANP9,A0A139AUH8,L2GMR6,U4LBG4,A0A177URI1,O74957,A0A3N4IGK1,A6N7Y9,A0A0E9NDK5,T1KZ60,A0A250WXN5,A0A2G8JLH3,Q5KAT1,L2GUF2,W2T741,A0A1W0E4B5,A0A2J7QB22,S4RYE2,A0A2K3CW87,A0A388KES6,A0A226EFL3,A0A3S3PD82,A0A0L0TEV1,A0A1J1HRI1,C4V9J2,Q9JMB7,A0A075AN09,Q5TW24,U5HIG6,A0A401PRI6,Q96J94,A0A397UU01,A0A2T7PFL8,A0A024FT57,H3HCL6,A0A0G4IME3,A0A1S3CYL5,D7FQK3,A0A1Y1YHC8,T1GSU4,F4S231,A0A1D8PMK0,A0A2G5B1D8,Q5BD61,A0A1C7M8P2,A0A4D8YSQ3,A0A158PJG6,A0A0C2XG51,A0A158QZT6,T0SAU8,R7YY92,A0A3S1A0C3,A0A074YJ47,A0A2K1J482,A0A1Q3ENA6,O04379,A0A371I3C8,M8AEW7,A8P0D4,A0A2K3NY65,F4NYW7,A0A409Y6G2,A0A0L0HAB7,D8PZT7,A0A1D1W4K0,A7RQ46,W4YU94,A7BJS5,D8SNM6,A0A1J8PPA3,X1WG39,M5FQK2,Q69VD5,A0A2R6NSC2,A0A0D8XL16,A0A016WPN3,Q9QZ81,G5EES3,A0A0K0EFP6,Q8CJG0,A0A1D5NTU6,V2WTL2,A0A0V0YLH8,A0A139WDH0,A0A0R3W9Q7,H3DS31,A0A1Y1HWP2,G4T5G9,B7QCC4,A0A0B2UV00,M7BCJ9,E9GN30,Q7PZ41,A0A077Z361,R7U9I3,A0A1X7V1N5,A0A0K0JDP1,A0A0N4UKJ1,A0A498N3A3,A0A3M0IQP5,A0A0L8GBV4,Q32KD4,A0A1J1JBJ0,E0W4C3,A0A482XDA9,A0A3P7EJD6,J9K2Z4,A0A2J7Q8V4,T1IBM6,V3ZRX0,A0A210QKF7,A0A423TSS1,K1PT78,A0A267E8R7,A0A1D2N447,A0A226D7A9,F6YK55,T1KTE4,A0A2C9JGZ6,A0A1V9X9F0,K5X5Z7,A0A3Q0KUG5,T1FY40,1YVU,3DLB,5AWH,5I4A,7R8K,E8N0K8,A0A1Y2RDH8,A0A0K8QX04,A0A2U2J9E0,B1XJG0,A0A1Q4R485,A0A062U2W9,H0HWQ5,A0A1I2ZGP1,A0A317EJY3,F8ERC7,A0A1A5X8H4,H8KXJ0,A0LL61,Q8DKB1,A0A1J1EK56,A0A4Q6XKV6,A0A239JE83,A0A2N4XBY2,Q53W94,A0A0Q0ZC47,A0A2T0XH18,A0A1K1RQP7,A0A2T1EKT1,A0A0P0NGR6,A0A1X7IML5,A0A0A2LKJ7,K1L112,K9XZC6,A0A0C1VHB4,Q31N05,Q2JI93,A0A372DKU2,A0A3R7KLK4,C1F5Q7,A0A222F7P0,A0A1H3DGN3,E0TGY3,A0A2S9Q9J0,H1YCU5,A0A1Q5ZS75,A0A1W2A082,A0A1H2RBI2,A0A1C3ZXN2,M5RSF0,W0JW77,L0AJX6,A0A2A5QS34,A0A285N2A8,,",366,37
"505","C.S11.3","C.S11.5",278,155,123,1.60076055599266,"4F1N,4F3T,4KRE,5VM9,6KR6,6OON,7KX7,7SWF,A0A163JTZ6,A0A0N4X8S8,A0A196SDB4,J9D5G4,C4LVV2,A0A2P6N8X7,A2DPV7,A0A0G4H2S4,T1H8B3,R1FDF0,S4RWI0,D2VMG4,Q1K660,F4PH46,A0A3M7S814,A0A164ZA52,A0A383WDW5,Q54G64,S7WCF7,I0YVB2,R7QGN7,C1DZY0,A0A2C5Z0M1,A0A1Z5TVE5,W7XD45,A0A4S2MWZ7,K1VVQ6,G7DVX0,E3KLI3,A0A1E3QC61,S8ANP9,L2GMR6,U4LBG4,A0A177URI1,O74957,A0A3N4IGK1,A6N7Y9,T1KZ60,A0A250WXN5,A0A2G8JLH3,Q5KAT1,L2GUF2,W2T741,A0A1W0E4B5,A0A2J7QB22,A0A2K3CW87,A0A226EFL3,A0A3S3PD82,A0A0L0TEV1,A0A1S3J512,G0QTT2,C4V9J2,Q9JMB7,A0A075AN09,U5HIG6,A0A401PRI6,Q96J94,A0A2B4RHN2,G2QEV0,A0A397UU01,A0A2T7PFL8,K7ISV0,A0A024FT57,H3HCL6,A0A0G4IME3,E9FUN9,D7FQK3,A0A1Y1YHC8,T1GSU4,F4S231,A0A2G5B1D8,Q5BD61,A0A4D8YSQ3,A0A158PJG6,J9JZ66,A0A0C2XG51,A0A158QZT6,A0A165QYQ9,T0SAU8,R7YY92,A0A3S1A0C3,A0A074YJ47,A0A2K1J482,A0A1Q3ENA6,O04379,A0A371I3C8,M8AEW7,A8P0D4,A0A2K3NY65,F4NYW7,A0A409Y6G2,A0A0L0HAB7,D8PZT7,A0A1D1W4K0,A7RQ46,W4YU94,A7BJS5,D8SNM6,A0A1J8PPA3,X1WG39,M5FQK2,Q69VD5,A0A0D8XL16,A0A016WPN3,Q9QZ81,G5EES3,A0A0K0EFP6,Q8CJG0,A0A1D5NTU6,V2WTL2,A0A139WDH0,A0A0R3W9Q7,A0A1Y1HWP2,G4T5G9,B7QCC4,A0A0B2UV00,M7BCJ9,E9GN30,Q7PZ41,A0A077Z361,R7U9I3,A0A1X7V1N5,A0A498N3A3,A0A3M0IQP5,A0A0L8GBV4,Q32KD4,A0A1J1JBJ0,E0W4C3,A0A482XDA9,A0A3P7EJD6,J9K2Z4,A0A2J7Q8V4,T1IBM6,V3ZRX0,A0A210QKF7,A0A423TSS1,K1PT78,A0A267E8R7,A0A1D2N447,A0A226D7A9,F6YK55,T1KTE4,A0A2C9JGZ6,A0A1V9X9F0,K5X5Z7,A0A3Q0KUG5,T1FY40,1YVU,3DLB,5G5T,7R8K,E8N0K8,A0A2W1JZ37,A0A2S7WBN3,A0A420DFE6,A0A4V1VDY2,A0A368P5I0,C4L1M1,A0A1Y2RDH8,A0A0K8QX04,A0A0M2PXX3,K9TPA9,A0A1L3JHM3,A0A1W6MIP2,A0A1C0UUC4,A0A2U2J9E0,A0A2Z6E1D5,A0A0F4NXW8,A0A142XB92,L8D0R3,A0A326U7G5,A0A1Q4R485,K9U8J6,A0A097QRL6,K9RC91,A0A0D8ZUC0,A0A139XGN8,A0A1T4Y3A2,B6YTQ5,A0A0B0H9B4,A0YYT3,A0A2T1EFY0,G6FTN0,R6KUL9,A0A433NB65,A0A1Z4L0A1,A0A2T1G8M7,K9VUN0,B7GJX9,A0A0P6X5X2,K9ZDE3,B0JXD6,A0A2T1LS63,A0A1Z4K1Y3,A0A1N6SSK9,A0A0P4UVI8,A0A0V7ZCG4,A0A1J0AGK2,K9PFF9,A0A060HNJ0,A0A235B542,R5XQK4,A0A1H3LE92,H0HWQ5,A0A1I2ZGP1,A0A317EJY3,A0A1I2BD20,F8ERC7,S7VLM7,A0A1R3T9N6,A0A0Q2M2Z1,H8KXJ0,A0A0B7I4Z6,A0LL61,A0A4Q6XKV6,A0A1Z3HNN4,A0A239JE83,R5JEI2,A0A0Q0ZC47,A0A2T0XH18,A0A1K1RQP7,A0A0P0NGR6,A0A1X7IML5,A0A0A2LKJ7,A0A0U3AL92,A0A1H3A054,E0UCX3,K9XZC6,B9LVW4,A0A0C1VHB4,A0A0C5JKF3,R5NJJ8,A0A142Y7A9,A0A432MEQ5,A0A372DKU2,C1F5Q7,A0A1P8WP90,A0A1C9VH88,A0A2T2YMB1,A0A329TD61,A0A1H3DGN3,A0A259TUP4,F6EYI8,A0A2S9Q9J0,A0A4Q2UIU6,L0JS08,A0A345E7N0,M0AF24,A0A1H3X247,M0D2X3,A0A2R5G167,A0A346PK63,R7RTW6,A0A1H2RBI2,B9LVP8,M5RSF0,W0JW77,B7K585,F8D8G0,A0A343TL88,L0AJX6,A0A2A5QS34,A0A343JEE2,A0A3P3RGE5,A0A329TBQ3,A0A0W1S8B8,A0A1V4C8L7,L9VRQ2,E4NRV1,A0A1I6HGN0,,",366,37
"515","C.H5.15","C.L28.5",238,156,82,3.71286741713571,"4F1N,4F3T,4KRE,5GUH,5VM9,6KR6,6OON,7KX7,7SWF,A0A163JTZ6,A0A196SDB4,J9D5G4,Q389P5,A2DPV7,A0A0G4H2S4,D2VMG4,A0A0D1ZAJ4,Q1K660,F4PH46,A0A3M7S814,A0A383WDW5,Q54G64,S7WCF7,I0YVB2,R7QGN7,C1DZY0,A0A2C5Z0M1,R9ACY5,W7XD45,A0A1U7LLR0,A0A4S2MWZ7,K1VVQ6,A0A158P1R9,V6R0U9,G4N9J3,B7Q5I1,A0A1E3QC61,D5GGK8,S8ANP9,A0A139AUH8,L2GMR6,U4LBG4,A0A177URI1,O74957,A0A3N4IGK1,A6N7Y9,A0A0E9NDK5,T1KZ60,A0A2G8JLH3,L2GUF2,W2T741,A0A1W0E4B5,A0A2J7QB22,S4RYE2,A0A2K3CW87,A0A388KES6,A0A226EFL3,A0A3S3PD82,A0A0L0TEV1,A0A1S3J512,G0QTT2,A0A1J1HRI1,C4V9J2,Q9JMB7,A0A075AN09,Q5TW24,U5HIG6,A0A401PRI6,Q96J94,A0A2B4RHN2,G2QEV0,A0A397UU01,A0A2T7PFL8,K7ISV0,A0A024FT57,H3HCL6,A0A0G4IME3,E9FUN9,A0A1S3CYL5,D7FQK3,A0A1Y1YHC8,A0A1D8PMK0,Q5BD61,A0A4D8YSQ3,A0A158PJG6,J9JZ66,A0A0C2XG51,T0SAU8,R7YY92,A0A074YJ47,A0A2K1J482,A0A1Q3ENA6,O04379,M8AEW7,A8P0D4,A0A2K3NY65,F4NYW7,A0A0L0HAB7,D8PZT7,A0A1D1W4K0,A7RQ46,W4YU94,A7BJS5,D8SNM6,X1WG39,M5FQK2,Q69VD5,A0A2R6NSC2,A0A0D8XL16,A0A016WPN3,Q9QZ81,G5EES3,A0A0K0EFP6,Q8CJG0,A0A1D5NTU6,V2WTL2,A0A0V0YLH8,A0A139WDH0,A0A0R3W9Q7,H3DS31,A0A1Y1HWP2,G4T5G9,B7QCC4,A0A0B2UV00,M7BCJ9,E9GN30,Q7PZ41,A0A077Z361,R7U9I3,A0A1X7V1N5,A0A0K0JDP1,A0A0N4UKJ1,A0A498N3A3,A0A3M0IQP5,A0A0L8GBV4,Q32KD4,A0A1J1JBJ0,E0W4C3,A0A482XDA9,A0A3P7EJD6,J9K2Z4,A0A2J7Q8V4,T1IBM6,V3ZRX0,A0A210QKF7,A0A423TSS1,A0A267E8R7,A0A1D2N447,A0A226D7A9,F6YK55,T1KTE4,A0A2C9JGZ6,A0A1V9X9F0,K5X5Z7,A0A3Q0KUG5,T1FY40,1YVU,5AWH,6QZK,A0A1I7IXT4,A0A2W1JZ37,A0A2S7WBN3,A0A420DFE6,A0A4V1VDY2,A0A368P5I0,A0A4R1RMM2,A0A1Y2RDH8,Q11QW7,A0A1M5ZSR3,A0A0K8QX04,A0A0M2PXX3,A0A1L3JHM3,A0A1W6MIP2,A0A1C0UUC4,A0A2U2J9E0,B1XJG0,A0A3D8L290,A0A1T4Y3A2,R6KUL9,A0A2G9DT08,Q9L1X1,A0A060HNJ0,A0A235B542,A0A496APJ8,A0A1V9G9U4,A0A1A5X8H4,A0A1I2T6Q1,A0A1R3T9N6,H8KXJ0,A0A2D1U4H7,A0A0B7I4Z6,A0LL61,A0A139WY18,A0A1J1EK56,A0A2T1E1K4,A0A1Q8ZD62,A0A4Q6XKV6,A0A1Z3HNN4,A0A239JE83,A0A2N4XBY2,Q53W94,R5JEI2,A0A0Q0ZC47,A0A2T0XH18,A0A1V4CHV0,A0A1K1RQP7,A0A1N6LUI7,A0A0P0NGR6,A0A1X7IML5,A0A0A2LKJ7,K1L112,A0A0U3AL92,A0A1H3A054,A0A0C5JKF3,A5D4D9,A0A142Y7A9,A0A432MEQ5,A0A372DKU2,C1F5Q7,A0A4R3EV39,A0A1P8WP90,A0A222F7P0,A0A1C9VH88,A0A2T2YMB1,A0A101R2A0,A0A1U9ND56,A0A4R7BQC4,E0TGY3,A0A259TUP4,F6EYI8,A0A2S9Q9J0,A0A4Q2UIU6,A0A1H0LH25,A0A318LG42,A0A2R5G167,A0A346PK63,M5RSF0,B7K585,,",366,37
"519","C.L22.9","C.S15.1",253,156,97,2.4008062384351,"4F1N,4KRE,5VM9,6OON,7KX7,7SWF,A0A163JTZ6,A0A0N4X8S8,A0A196SDB4,J9D5G4,R1FDF0,A0A0D1ZAJ4,Q1K660,F4PH46,A0A3M7S814,A0A164ZA52,A0A383WDW5,Q54G64,I0YVB2,R7QGN7,A0A2C5Z0M1,R9ACY5,D3BMP8,A0A1Z5TVE5,A0A1U7LLR0,A0A4S2MWZ7,K1VVQ6,A0A158P1R9,G7DVX0,V6R0U9,G4N9J3,E3KLI3,A0A1E3QC61,D5GGK8,S8ANP9,A0A139AUH8,L2GMR6,U4LBG4,A0A177URI1,O74957,A0A3N4IGK1,A6N7Y9,A0A0E9NDK5,T1KZ60,A0A250WXN5,Q5KAT1,L2GUF2,W2T741,S4RYE2,A0A2K3CW87,A0A388KES6,A0A226EFL3,A0A3S3PD82,A0A0L0TEV1,A0A1S3J512,C4V9J2,Q9JMB7,A0A075AN09,U5HIG6,A0A401PRI6,Q96J94,G2QEV0,A0A397UU01,A0A2T7PFL8,A0A024FT57,H3HCL6,A0A0G4IME3,A0A1S3CYL5,D7FQK3,A0A1Y1YHC8,T1GSU4,F4S231,A0A1D8PMK0,A0A2G5B1D8,Q5BD61,A0A1C7M8P2,A0A4D8YSQ3,A0A158PJG6,J9JZ66,A0A0C2XG51,A0A158QZT6,A0A165QYQ9,T0SAU8,R7YY92,A0A3S1A0C3,A0A074YJ47,A0A2K1J482,A0A1Q3ENA6,O04379,A0A371I3C8,M8AEW7,A8P0D4,A0A2K3NY65,F4NYW7,A0A409Y6G2,A0A0L0HAB7,D8PZT7,A0A1D1W4K0,A7RQ46,W4YU94,A7BJS5,D8SNM6,A0A1J8PPA3,X1WG39,M5FQK2,Q69VD5,A0A2R6NSC2,A0A0D8XL16,A0A016WPN3,Q9QZ81,G5EES3,A0A0K0EFP6,Q8CJG0,A0A1D5NTU6,V2WTL2,A0A0V0YLH8,A0A139WDH0,A0A0R3W9Q7,H3DS31,A0A1Y1HWP2,G4T5G9,B7QCC4,A0A0B2UV00,M7BCJ9,E9GN30,Q7PZ41,A0A077Z361,R7U9I3,A0A1X7V1N5,A0A0K0JDP1,A0A0N4UKJ1,A0A498N3A3,A0A3M0IQP5,A0A0L8GBV4,Q32KD4,A0A1J1JBJ0,E0W4C3,A0A482XDA9,A0A3P7EJD6,J9K2Z4,A0A2J7Q8V4,T1IBM6,V3ZRX0,A0A210QKF7,A0A423TSS1,K1PT78,A0A267E8R7,A0A1D2N447,A0A226D7A9,F6YK55,T1KTE4,A0A2C9JGZ6,A0A1V9X9F0,K5X5Z7,A0A3Q0KUG5,T1FY40,1YVU,5AWH,5I4A,6QZK,E8N0K8,K9TPA9,A0A0F4NXW8,L8D0R3,A0A326U7G5,A0A1Q4R485,K9U8J6,K9RC91,A0A0D8ZUC0,A0A139XGN8,A0A1T4Y3A2,Q5P0R2,A0YYT3,A0A2T1EFY0,G6FTN0,A0A1Z4L0A1,A0A2T1G8M7,K9VUN0,K9ZDE3,B0JXD6,A0A2T1LS63,A0A1Z4K1Y3,A0A2Z6E0R7,A0A0P4UVI8,A0A0V7ZCG4,A0A1J0AGK2,K9PFF9,A0A2G9DT08,Q9L1X1,A0A1H3LE92,A0A496APJ8,A0A1V9G9U4,A0A1A5X8H4,A0A1I2T6Q1,H8KXJ0,A0A2D1U4H7,Q8DKB1,A0A139WY18,A0A1J1EK56,A0A2T1E1K4,A0A1Q8ZD62,A0A4Q6XKV6,A0A1Z3HNN4,Q53W94,A0A2T0XH18,A0A1V4CHV0,A0A1K1RQP7,A0A2T1EKT1,A0A1N6LUI7,A0A0P0NGR6,A0A0A2LKJ7,K1L112,A0A0U3AL92,A0A1H3A054,B9LVW4,A0A0C1VHB4,Q31N05,A0A0C5JKF3,A5D4D9,Q2JI93,A0A432MEQ5,A0A372DKU2,C1F5Q7,A0A4R3EV39,A0A1P8WP90,A0A222F7P0,A0A1C9VH88,A0A101R2A0,A0A1U9ND56,A0A4R7BQC4,A0A1Q1FPH0,E0TGY3,A0A259TUP4,A0A2S9Q9J0,A0A4Q2UIU6,A0A1H0LH25,A0A318LG42,L0JS08,M0AF24,A0A1H3X247,M0D2X3,A0A2R5G167,R7RTW6,M5RSF0,W0JW77,B7K585,F8D8G0,L0AJX6,A0A2A5QS34,A0A343JEE2,A0A285N2A8,A0A1V4C8L7,A0A1I0NI68,,",366,37
"522","N.H5.12","N.H5.8",239,156,83,3.26799505715168,"4F1N,4F3T,4KRE,5GUH,5VM9,6KR6,6OON,7SWF,A0A163JTZ6,A0A0N4X8S8,J9D5G4,C4LVV2,A0A2P6N8X7,A0A0G4H2S4,T1H8B3,S4RWI0,D2VMG4,A0A074TLL7,F4PH46,A0A3M7S814,A0A383WDW5,Q54G64,S7WCF7,I0YVB2,R7QGN7,C1DZY0,R9ACY5,D3BMP8,A0A1U7LLR0,K1VVQ6,A0A158P1R9,G7DVX0,E3KLI3,B7Q5I1,A0A139AUH8,L2GMR6,A0A177URI1,A6N7Y9,A0A0E9NDK5,T1KZ60,A0A250WXN5,A0A2G8JLH3,Q5KAT1,L2GUF2,W2T741,A0A1W0E4B5,A0A2J7QB22,S4RYE2,A0A2K3CW87,A0A388KES6,A0A226EFL3,A0A3S3PD82,A0A0L0TEV1,A0A1S3J512,G0QTT2,A0A1J1HRI1,C4V9J2,Q9JMB7,A0A075AN09,Q5TW24,U5HIG6,A0A401PRI6,Q96J94,A0A2B4RHN2,G2QEV0,A0A397UU01,A0A2T7PFL8,K7ISV0,A0A024FT57,H3HCL6,A0A0G4IME3,E9FUN9,A0A1S3CYL5,D7FQK3,A0A1Y1YHC8,T1GSU4,F4S231,A0A1D8PMK0,A0A2G5B1D8,Q5BD61,A0A4D8YSQ3,A0A158PJG6,J9JZ66,A0A0C2XG51,A0A158QZT6,A0A165QYQ9,T0SAU8,R7YY92,A0A3S1A0C3,A0A074YJ47,A0A2K1J482,A0A1Q3ENA6,O04379,A0A371I3C8,M8AEW7,A0A2K3NY65,F4NYW7,A0A409Y6G2,A0A0L0HAB7,A0A1D1W4K0,A7RQ46,W4YU94,A7BJS5,D8SNM6,A0A1J8PPA3,X1WG39,M5FQK2,Q69VD5,A0A0D8XL16,A0A016WPN3,Q9QZ81,G5EES3,A0A0K0EFP6,Q8CJG0,A0A1D5NTU6,A0A0V0YLH8,A0A139WDH0,A0A0R3W9Q7,H3DS31,A0A1Y1HWP2,G4T5G9,B7QCC4,A0A0B2UV00,M7BCJ9,E9GN30,Q7PZ41,A0A077Z361,R7U9I3,A0A1X7V1N5,A0A0K0JDP1,A0A0N4UKJ1,A0A498N3A3,A0A3M0IQP5,A0A0L8GBV4,Q32KD4,A0A1J1JBJ0,E0W4C3,A0A482XDA9,A0A3P7EJD6,J9K2Z4,A0A2J7Q8V4,T1IBM6,V3ZRX0,A0A210QKF7,A0A423TSS1,K1PT78,A0A267E8R7,A0A1D2N447,A0A226D7A9,F6YK55,T1KTE4,A0A2C9JGZ6,A0A1V9X9F0,K5X5Z7,A0A3Q0KUG5,T1FY40,1YVU,1Z26,5AWH,5G5T,6QZK,7R8K,A0A0K8QX04,A0A0M2PXX3,A0A1C0UUC4,A0A142XB92,A0A1T4Y3A2,A0A2G9DT08,Q9L1X1,A0A062U2W9,H0HWQ5,A0A1V9G9U4,A0A1I2BD20,F8ERC7,S7VLM7,A0A1A5X8H4,A0A1I2T6Q1,A0A1R3T9N6,A0A0Q2M2Z1,H8KXJ0,A0A2D1U4H7,A0A0B7I4Z6,A0LL61,A0A2T1E1K4,A0A1Q8ZD62,A0A4Q6XKV6,A0A239JE83,A0A2N4XBY2,R5JEI2,A0A0Q0ZC47,A0A2T0XH18,A0A1K1RQP7,A0A1N6LUI7,A0A0P0NGR6,A0A1X7IML5,A0A0A2LKJ7,K1L112,A0A0U3AL92,A0A1H3A054,A0A0C5JKF3,R5NJJ8,A5D4D9,A0A142Y7A9,A0A432MEQ5,A0A372DKU2,A0A4R3EV39,A0A1P8WP90,A0A1C9VH88,A0A2T2YMB1,A0A1U9ND56,A0A4R7BQC4,E0TGY3,A0A259TUP4,F6EYI8,A0A2S9Q9J0,A0A4Q2UIU6,A0A1H0LH25,A0A318LG42,H1YCU5,A0A1Q5ZS75,A0A1W2A082,A0A1H3X247,A0A2R5G167,A0A346PK63,R7RTW6,A0A1H2RBI2,A0A1C3ZXN2,B9LVP8,M5RSF0,B7K585,A0A343TL88,A0A343JEE2,A0A3P3RGE5,A0A329TBQ3,A0A0W1S8B8,A0A1V4C8L7,L9VRQ2,A0A1I6HGN0,A0A1I0NI68,,",366,37
"524","C.H10.11","C.S9.4",199,157,42,2.59463148316652,"4F1N,5GUH,6KR6,7SWF,A0A163JTZ6,J9D5G4,C4LVV2,A8BCK6,A2DPV7,A0A0G4H2S4,R1FDF0,D2VMG4,A0A074TLL7,A0A0D1ZAJ4,Q1K660,A0A3M7S814,A0A164ZA52,A0A383WDW5,S7WCF7,I0YVB2,R7QGN7,C1DZY0,A0A2C5Z0M1,A0CB11,A0A1Z5TVE5,A0A1U7LLR0,A0A4S2MWZ7,K1VVQ6,A0A158P1R9,G7DVX0,V6R0U9,G4N9J3,E3KLI3,B7Q5I1,A0A1E3QC61,D5GGK8,S8ANP9,L2GMR6,U4LBG4,A0A177URI1,O74957,A0A3N4IGK1,A0A0E9NDK5,T1KZ60,A0A250WXN5,A0A2G8JLH3,Q5KAT1,L2GUF2,W2T741,A0A1W0E4B5,A0A2J7QB22,A0A2K3CW87,A0A388KES6,A0A226EFL3,A0A0L0TEV1,A0A1S3J512,G0QTT2,A0A1J1HRI1,C4V9J2,A0A075AN09,Q5TW24,U5HIG6,A0A2B4RHN2,A0A397UU01,A0A2T7PFL8,K7ISV0,A0A024FT57,H3HCL6,A0A0G4IME3,E9FUN9,D7FQK3,A0A1Y1YHC8,T1GSU4,F4S231,A0A1D8PMK0,Q5BD61,A0A1C7M8P2,A0A4D8YSQ3,A0A158PJG6,J9JZ66,A0A0C2XG51,A0A158QZT6,A0A165QYQ9,T0SAU8,R7YY92,A0A3S1A0C3,A0A074YJ47,A0A2K1J482,A0A1Q3ENA6,O04379,A0A371I3C8,M8AEW7,A8P0D4,A0A2K3NY65,F4NYW7,A0A409Y6G2,A0A0L0HAB7,D8PZT7,A0A1D1W4K0,A7RQ46,W4YU94,A7BJS5,D8SNM6,A0A1J8PPA3,X1WG39,M5FQK2,Q69VD5,A0A2R6NSC2,A0A0D8XL16,A0A016WPN3,Q9QZ81,G5EES3,A0A0K0EFP6,Q8CJG0,A0A1D5NTU6,V2WTL2,A0A0V0YLH8,A0A139WDH0,A0A0R3W9Q7,H3DS31,A0A1Y1HWP2,G4T5G9,B7QCC4,A0A0B2UV00,M7BCJ9,E9GN30,Q7PZ41,A0A077Z361,R7U9I3,A0A1X7V1N5,A0A0K0JDP1,A0A0N4UKJ1,A0A498N3A3,A0A3M0IQP5,A0A0L8GBV4,Q32KD4,A0A1J1JBJ0,E0W4C3,A0A482XDA9,A0A3P7EJD6,J9K2Z4,A0A2J7Q8V4,T1IBM6,V3ZRX0,A0A210QKF7,A0A423TSS1,K1PT78,A0A267E8R7,A0A1D2N447,A0A226D7A9,F6YK55,T1KTE4,A0A2C9JGZ6,A0A1V9X9F0,K5X5Z7,A0A3Q0KUG5,T1FY40,1YVU,1Z26,5AWH,5I4A,6QZK,A0A1M5ZSR3,A0A0K8QX04,B1XJG0,A0A3D8L290,A0A097QRL6,A0A1T4Y3A2,B6YTQ5,A0A060HNJ0,A0A496APJ8,A0A1V9G9U4,A0A1I2ZGP1,A0A317EJY3,F8ERC7,A0A0Q2M2Z1,I3TE64,A0A139WY18,A0A2T1E1K4,A0A1Q8ZD62,A0A1Z3HNN4,Q53W94,E0UCX3,A0A329TD61,A0A1Q1FPH0,A0A4Q2UIU6,L0JS08,M0AF24,A0A346PK63,B9LVP8,A0A343TL88,A0A3P3RGE5,A0A329TBQ3,A0A285N2A8,A0A0W1S8B8,A0A1V4C8L7,L9VRQ2,E4NRV1,A0A1I6HGN0,,",366,37
"526","C.H5.11","C.H5.7",321,157,164,2.09559965822588,"4KRE,5GUH,5VM9,6KR6,6OON,7KX7,A0A196SDB4,J9D5G4,Q389P5,C4LVV2,A0A2P6N8X7,A8BCK6,A2DPV7,A0A0G4H2S4,T1H8B3,R1FDF0,S4RWI0,D2VMG4,A0A074TLL7,F4PH46,A0A3M7S814,A0A164ZA52,A0A383WDW5,Q54G64,S7WCF7,I0YVB2,R7QGN7,C1DZY0,A0A2C5Z0M1,A0CB11,R9ACY5,D3BMP8,W7XD45,A0A1U7LLR0,A0A4S2MWZ7,K1VVQ6,A0A158P1R9,G7DVX0,V6R0U9,G4N9J3,E3KLI3,B7Q5I1,S8ANP9,U4LBG4,A0A177URI1,O74957,A0A3N4IGK1,A6N7Y9,A0A0E9NDK5,T1KZ60,A0A250WXN5,A0A2G8JLH3,Q5KAT1,L2GUF2,W2T741,A0A2J7QB22,S4RYE2,A0A2K3CW87,A0A388KES6,A0A226EFL3,A0A3S3PD82,A0A0L0TEV1,A0A1S3J512,G0QTT2,A0A1J1HRI1,C4V9J2,Q9JMB7,A0A075AN09,Q5TW24,A0A401PRI6,Q96J94,A0A2B4RHN2,G2QEV0,A0A397UU01,A0A2T7PFL8,K7ISV0,E9FUN9,A0A1S3CYL5,D7FQK3,A0A1Y1YHC8,T1GSU4,F4S231,A0A1D8PMK0,A0A2G5B1D8,A0A1C7M8P2,A0A4D8YSQ3,A0A158PJG6,J9JZ66,A0A158QZT6,T0SAU8,R7YY92,A0A3S1A0C3,A0A2K1J482,A0A1Q3ENA6,O04379,A0A371I3C8,M8AEW7,A0A2K3NY65,F4NYW7,A0A409Y6G2,A0A0L0HAB7,D8PZT7,A0A1D1W4K0,A7RQ46,W4YU94,A7BJS5,D8SNM6,X1WG39,Q69VD5,A0A2R6NSC2,A0A0D8XL16,A0A016WPN3,Q9QZ81,G5EES3,A0A0K0EFP6,Q8CJG0,A0A1D5NTU6,A0A0V0YLH8,A0A139WDH0,A0A0R3W9Q7,H3DS31,A0A1Y1HWP2,G4T5G9,B7QCC4,A0A0B2UV00,M7BCJ9,E9GN30,Q7PZ41,A0A077Z361,R7U9I3,A0A1X7V1N5,A0A0K0JDP1,A0A0N4UKJ1,A0A498N3A3,A0A3M0IQP5,A0A0L8GBV4,Q32KD4,A0A1J1JBJ0,E0W4C3,A0A482XDA9,A0A3P7EJD6,J9K2Z4,A0A2J7Q8V4,T1IBM6,V3ZRX0,A0A210QKF7,A0A423TSS1,K1PT78,A0A267E8R7,A0A1D2N447,A0A226D7A9,F6YK55,T1KTE4,A0A2C9JGZ6,A0A1V9X9F0,A0A3Q0KUG5,T1FY40,1YVU,1Z26,3DLB,5AWH,5G5T,5I4A,6QZK,E8N0K8,A0A1I7IXT4,A0A2W1JZ37,A0A2S7WBN3,A0A328VKE4,A0A420DFE6,E0ST67,A0A4V1VDY2,A0A368P5I0,C4L1M1,A0A4R1RMM2,A0A1Y2RDH8,Q11QW7,A0A1M5ZSR3,A0A0K8QX04,A0A0M2PXX3,A0A1I3LMA1,K9TPA9,A0A1L3JHM3,A0A1W6MIP2,A0A1C0UUC4,A0A2U2J9E0,A0A2Z6E1D5,A0A0F4NXW8,B1XJG0,A0A326U7G5,A0A3D8L290,H1KXR6,A0A1Q4R485,A0A097QRL6,K9RC91,A0A0D8ZUC0,A0A139XGN8,A0A1T4Y3A2,Q5P0R2,B6YTQ5,A0A0B0H9B4,A0A2T1EFY0,G6FTN0,R6KUL9,A0A1Z4L0A1,K9VUN0,B7GJX9,K9ZDE3,B0JXD6,A0A1Z4K1Y3,A0A2Z6E0R7,A0A1N6SSK9,A0A0P4UVI8,A0A1J0AGK2,K9PFF9,A0A2G9DT08,K9UEV4,Q9L1X1,A0A060HNJ0,A0A235B542,R5XQK4,A0A1H3LE92,A0A496APJ8,A0A1V9G9U4,S7VLM7,A0A1A5X8H4,A0A1I2T6Q1,A0A1R3T9N6,A0A0Q2M2Z1,H8KXJ0,D3S0S6,A0A2D1U4H7,A0A0B7I4Z6,A0LL61,Q8DKB1,A0A139WY18,A0A1J1EK56,A0A2T1E1K4,A0A1Q8ZD62,A0A4Q6XKV6,A0A1Z3HNN4,A0A239JE83,A0A2N4XBY2,Q53W94,R5JEI2,A0A0Q0ZC47,A0A2T0XH18,A0A1V4CHV0,A0A1K1RQP7,A0A2T1EKT1,A0A1N6LUI7,A0A0P0NGR6,A0A1X7IML5,A0A0A2LKJ7,K1L112,A0A0U3AL92,A0A1H3A054,E0UCX3,K9XZC6,A0A0C1VHB4,Q31N05,A0A0C5JKF3,R5NJJ8,A5D4D9,Q2JI93,A0A142Y7A9,A0A432MEQ5,A0A372DKU2,A0A3R7KLK4,C1F5Q7,A0A4R3EV39,A0A1P8WP90,A0A222F7P0,A0A1C9VH88,A0A2T2YMB1,A0A329TD61,A0A101R2A0,A0A1E3XF49,A0A1U9ND56,A0A4R7BQC4,A0A1H3DGN3,A0A1Q1FPH0,E0TGY3,A0A259TUP4,F6EYI8,A0A2S9Q9J0,A0A4Q2UIU6,A0A1H0LH25,A0A318LG42,H1YCU5,L0JS08,A0A1Q5ZS75,A0A345E7N0,M0AF24,A0A1W2A082,A0A1H3X247,A0A0C1XUA0,M0D2X3,A0A2R5G167,A0A346PK63,R7RTW6,A0A1H2RBI2,A0A1C3ZXN2,B9LVP8,M5RSF0,W0JW77,B7K585,F8D8G0,A0A343TL88,L0AJX6,A0A2A5QS34,A0A343JEE2,A0A3P3RGE5,A0A329TBQ3,A0A285N2A8,A0A0W1S8B8,A0A1V4C8L7,L9VRQ2,E4NRV1,A0A1I6HGN0,A0A1I0NI68,,",366,37
"531","N.S2.3","N.S20.2",242,157,85,2.02866242038217,"4F3T,4KRE,6KR6,6OON,7SWF,Q389P5,C4LVV2,A2DPV7,A0A0G4H2S4,T1H8B3,S4RWI0,F4PH46,A0A164ZA52,A0A383WDW5,Q54G64,S7WCF7,R7QGN7,C1DZY0,A0A2C5Z0M1,A0CB11,A0A1Z5TVE5,W7XD45,A0A1U7LLR0,A0A4S2MWZ7,K1VVQ6,A0A158P1R9,G7DVX0,V6R0U9,G4N9J3,E3KLI3,B7Q5I1,A0A1E3QC61,D5GGK8,S8ANP9,A0A139AUH8,L2GMR6,U4LBG4,O74957,A0A3N4IGK1,A6N7Y9,A0A0E9NDK5,T1KZ60,Q5KAT1,L2GUF2,A0A1W0E4B5,A0A2J7QB22,S4RYE2,A0A2K3CW87,A0A388KES6,A0A226EFL3,A0A3S3PD82,A0A0L0TEV1,A0A1S3J512,A0A1J1HRI1,C4V9J2,Q9JMB7,A0A075AN09,Q5TW24,U5HIG6,A0A401PRI6,Q96J94,G2QEV0,A0A397UU01,A0A2T7PFL8,K7ISV0,A0A024FT57,H3HCL6,A0A0G4IME3,E9FUN9,D7FQK3,A0A1Y1YHC8,T1GSU4,F4S231,A0A1D8PMK0,A0A2G5B1D8,Q5BD61,A0A1C7M8P2,A0A4D8YSQ3,A0A158PJG6,J9JZ66,A0A0C2XG51,A0A158QZT6,A0A165QYQ9,T0SAU8,R7YY92,A0A3S1A0C3,A0A074YJ47,A0A2K1J482,A0A1Q3ENA6,O04379,A0A371I3C8,M8AEW7,A8P0D4,A0A2K3NY65,F4NYW7,A0A409Y6G2,A0A0L0HAB7,D8PZT7,A0A1D1W4K0,A7RQ46,W4YU94,A7BJS5,D8SNM6,A0A1J8PPA3,X1WG39,M5FQK2,Q69VD5,A0A2R6NSC2,A0A0D8XL16,A0A016WPN3,Q9QZ81,G5EES3,A0A0K0EFP6,Q8CJG0,A0A1D5NTU6,V2WTL2,A0A0V0YLH8,A0A139WDH0,A0A0R3W9Q7,H3DS31,A0A1Y1HWP2,G4T5G9,B7QCC4,A0A0B2UV00,M7BCJ9,E9GN30,Q7PZ41,A0A077Z361,R7U9I3,A0A1X7V1N5,A0A0K0JDP1,A0A0N4UKJ1,A0A498N3A3,A0A3M0IQP5,A0A0L8GBV4,Q32KD4,A0A1J1JBJ0,E0W4C3,A0A482XDA9,A0A3P7EJD6,J9K2Z4,A0A2J7Q8V4,T1IBM6,V3ZRX0,A0A210QKF7,A0A423TSS1,K1PT78,A0A267E8R7,A0A1D2N447,A0A226D7A9,F6YK55,T1KTE4,A0A2C9JGZ6,A0A1V9X9F0,K5X5Z7,A0A3Q0KUG5,T1FY40,1YVU,1Z26,5G5T,5I4A,6QZK,7R8K,A0A1Q4R485,K9RC91,A0YYT3,A0A1Z4L0A1,K9VUN0,K9ZDE3,B0JXD6,A0A2T1LS63,A0A1Z4K1Y3,K9PFF9,K9UEV4,H0HWQ5,A0A317EJY3,A0A1I2BD20,F8ERC7,S7VLM7,H8KXJ0,A0A2D1U4H7,A0A0B7I4Z6,A0A4Q6XKV6,A0A239JE83,A0A2N4XBY2,R5JEI2,A0A0Q0ZC47,A0A2T0XH18,A0A1V4CHV0,A0A1K1RQP7,A0A0P0NGR6,A0A1X7IML5,A0A0A2LKJ7,K1L112,A0A0U3AL92,A0A1H3A054,A0A0C5JKF3,R5NJJ8,A5D4D9,A0A142Y7A9,A0A372DKU2,A0A3R7KLK4,C1F5Q7,A0A4R3EV39,A0A1P8WP90,A0A222F7P0,A0A1C9VH88,A0A2T2YMB1,A0A329TD61,A0A1E3XF49,A0A1U9ND56,A0A4R7BQC4,A0A1Q1FPH0,E0TGY3,F6EYI8,A0A2S9Q9J0,A0A4Q2UIU6,A0A318LG42,H1YCU5,L0JS08,A0A1Q5ZS75,A0A345E7N0,M0AF24,A0A1H3X247,M0D2X3,A0A346PK63,A0A1C3ZXN2,B9LVP8,W0JW77,F8D8G0,A0A343TL88,L0AJX6,A0A2A5QS34,A0A343JEE2,A0A3P3RGE5,A0A329TBQ3,A0A0W1S8B8,A0A1V4C8L7,L9VRQ2,E4NRV1,A0A1I6HGN0,A0A1I0NI68,,",366,37
"537","C.L11.4","C.L2.1",257,158,99,1.46835443037975,"4F3T,4KRE,5GUH,5VM9,6KR6,6OON,7SWF,A0A163JTZ6,J9D5G4,R1FDF0,S4RWI0,D2VMG4,A0A074TLL7,A0A0D1ZAJ4,Q1K660,F4PH46,A0A3M7S814,A0A164ZA52,A0A383WDW5,Q54G64,S7WCF7,I0YVB2,R7QGN7,C1DZY0,A0A2C5Z0M1,R9ACY5,D3BMP8,A0A1Z5TVE5,A0A1U7LLR0,A0A4S2MWZ7,K1VVQ6,A0A158P1R9,V6R0U9,G4N9J3,E3KLI3,A0A1E3QC61,D5GGK8,S8ANP9,A0A139AUH8,L2GMR6,U4LBG4,A0A177URI1,O74957,A0A3N4IGK1,A6N7Y9,A0A0E9NDK5,T1KZ60,A0A250WXN5,Q5KAT1,L2GUF2,W2T741,A0A1W0E4B5,A0A2J7QB22,S4RYE2,A0A2K3CW87,A0A1S3J512,G0QTT2,A0A1J1HRI1,C4V9J2,Q9JMB7,Q5TW24,A0A401PRI6,Q96J94,A0A2B4RHN2,G2QEV0,A0A397UU01,A0A2T7PFL8,A0A024FT57,H3HCL6,A0A0G4IME3,E9FUN9,D7FQK3,A0A1Y1YHC8,T1GSU4,F4S231,A0A1D8PMK0,A0A2G5B1D8,Q5BD61,A0A1C7M8P2,A0A4D8YSQ3,A0A158PJG6,A0A0C2XG51,A0A158QZT6,A0A165QYQ9,T0SAU8,R7YY92,A0A3S1A0C3,A0A074YJ47,A0A2K1J482,A0A1Q3ENA6,O04379,A0A371I3C8,M8AEW7,A8P0D4,A0A2K3NY65,F4NYW7,A0A409Y6G2,A0A0L0HAB7,D8PZT7,A0A1D1W4K0,A7RQ46,W4YU94,A7BJS5,D8SNM6,A0A1J8PPA3,X1WG39,M5FQK2,Q69VD5,A0A2R6NSC2,A0A0D8XL16,A0A016WPN3,Q9QZ81,G5EES3,A0A0K0EFP6,Q8CJG0,A0A1D5NTU6,V2WTL2,A0A0V0YLH8,A0A139WDH0,A0A0R3W9Q7,H3DS31,A0A1Y1HWP2,G4T5G9,B7QCC4,A0A0B2UV00,M7BCJ9,E9GN30,Q7PZ41,A0A077Z361,R7U9I3,A0A1X7V1N5,A0A0K0JDP1,A0A0N4UKJ1,A0A498N3A3,A0A3M0IQP5,A0A0L8GBV4,Q32KD4,A0A1J1JBJ0,E0W4C3,A0A482XDA9,A0A3P7EJD6,J9K2Z4,A0A2J7Q8V4,T1IBM6,V3ZRX0,A0A210QKF7,A0A423TSS1,K1PT78,A0A267E8R7,A0A1D2N447,A0A226D7A9,F6YK55,T1KTE4,A0A2C9JGZ6,A0A1V9X9F0,K5X5Z7,A0A3Q0KUG5,T1FY40,1YVU,5AWH,5G5T,5I4A,7R8K,A0A4R1RMM2,Q11QW7,K9TPA9,A0A1L3JHM3,A0A1W6MIP2,A0A2U2J9E0,A0A2Z6E1D5,A0A1Q4R485,K9U8J6,K9RC91,A0A0D8ZUC0,A0A139XGN8,A0A1T4Y3A2,Q5P0R2,A0A0B0H9B4,A0YYT3,A0A2T1EFY0,G6FTN0,A0A433NB65,A0A1Z4L0A1,A0A2T1G8M7,K9VUN0,B7GJX9,K9ZDE3,B0JXD6,A0A2T1LS63,A0A1Z4K1Y3,A0A2Z6E0R7,A0A0P4UVI8,A0A0V7ZCG4,A0A1J0AGK2,K9PFF9,K9UEV4,A0A235B542,H0HWQ5,S7VLM7,A0A1A5X8H4,A0A1R3T9N6,H8KXJ0,A0A2D1U4H7,A0A0B7I4Z6,A0LL61,A0A4Q6XKV6,A0A239JE83,A0A2N4XBY2,Q53W94,R5JEI2,A0A0Q0ZC47,A0A2T0XH18,A0A1V4CHV0,A0A1K1RQP7,A0A1N6LUI7,A0A0P0NGR6,A0A1X7IML5,A0A0A2LKJ7,K1L112,A0A0U3AL92,A0A1H3A054,A0A0C5JKF3,R5NJJ8,A5D4D9,A0A432MEQ5,A0A372DKU2,A0A3R7KLK4,C1F5Q7,A0A4R3EV39,A0A1P8WP90,A0A222F7P0,A0A1C9VH88,A0A2T2YMB1,A0A329TD61,A0A1U9ND56,A0A4R7BQC4,E0TGY3,A0A4Q2UIU6,L0JS08,A0A345E7N0,M0AF24,A0A0C1XUA0,M0D2X3,A0A2R5G167,A0A346PK63,B9LVP8,M5RSF0,B7K585,F8D8G0,A0A343TL88,A0A3P3RGE5,A0A329TBQ3,A0A0W1S8B8,L9VRQ2,E4NRV1,A0A1I6HGN0,A0A1I0NI68,,",366,37
"544","N.L26.3","N.S2.2",225,158,67,2.48852257698848,"4F3T,4KRE,5GUH,5VM9,6KR6,6OON,7KX7,7SWF,Q389P5,C4LVV2,T1H8B3,S4RWI0,D2VMG4,A0A0D1ZAJ4,Q1K660,F4PH46,A0A164ZA52,A0A383WDW5,Q54G64,R7QGN7,C1DZY0,A0A2C5Z0M1,R9ACY5,D3BMP8,A0A1Z5TVE5,A0A1U7LLR0,A0A4S2MWZ7,K1VVQ6,G7DVX0,V6R0U9,G4N9J3,E3KLI3,B7Q5I1,A0A1E3QC61,D5GGK8,S8ANP9,A0A139AUH8,L2GMR6,U4LBG4,A0A177URI1,O74957,A0A3N4IGK1,A6N7Y9,A0A0E9NDK5,T1KZ60,A0A250WXN5,Q5KAT1,L2GUF2,A0A1W0E4B5,A0A2J7QB22,S4RYE2,A0A2K3CW87,A0A388KES6,A0A226EFL3,A0A3S3PD82,A0A0L0TEV1,G0QTT2,A0A1J1HRI1,C4V9J2,Q9JMB7,A0A075AN09,Q5TW24,U5HIG6,Q96J94,G2QEV0,A0A397UU01,A0A2T7PFL8,K7ISV0,A0A024FT57,H3HCL6,A0A0G4IME3,E9FUN9,D7FQK3,A0A1Y1YHC8,T1GSU4,F4S231,A0A1D8PMK0,A0A1C7M8P2,A0A4D8YSQ3,A0A158PJG6,J9JZ66,A0A0C2XG51,A0A158QZT6,A0A165QYQ9,T0SAU8,R7YY92,A0A3S1A0C3,A0A074YJ47,A0A2K1J482,A0A1Q3ENA6,O04379,A0A371I3C8,M8AEW7,A8P0D4,A0A2K3NY65,F4NYW7,A0A409Y6G2,A0A0L0HAB7,D8PZT7,A0A1D1W4K0,A7RQ46,W4YU94,A7BJS5,D8SNM6,A0A1J8PPA3,X1WG39,M5FQK2,Q69VD5,A0A2R6NSC2,A0A0D8XL16,A0A016WPN3,Q9QZ81,G5EES3,A0A0K0EFP6,Q8CJG0,A0A1D5NTU6,V2WTL2,A0A0V0YLH8,A0A139WDH0,A0A0R3W9Q7,H3DS31,A0A1Y1HWP2,G4T5G9,B7QCC4,A0A0B2UV00,M7BCJ9,E9GN30,Q7PZ41,A0A077Z361,R7U9I3,A0A1X7V1N5,A0A0K0JDP1,A0A0N4UKJ1,A0A498N3A3,A0A3M0IQP5,A0A0L8GBV4,Q32KD4,A0A1J1JBJ0,E0W4C3,A0A482XDA9,A0A3P7EJD6,J9K2Z4,A0A2J7Q8V4,T1IBM6,V3ZRX0,A0A210QKF7,A0A423TSS1,K1PT78,A0A267E8R7,A0A1D2N447,A0A226D7A9,F6YK55,T1KTE4,A0A2C9JGZ6,A0A1V9X9F0,K5X5Z7,A0A3Q0KUG5,T1FY40,1YVU,1Z26,3DLB,5AWH,5G5T,6QZK,7R8K,K9ZDE3,H0HWQ5,A0A317EJY3,F8ERC7,S7VLM7,A0A0Q2M2Z1,H8KXJ0,A0A2D1U4H7,A0A0B7I4Z6,Q8DKB1,A0A1J1EK56,A0A4Q6XKV6,A0A239JE83,A0A2N4XBY2,Q53W94,R5JEI2,A0A0Q0ZC47,A0A2T0XH18,A0A1V4CHV0,A0A1K1RQP7,A0A2T1EKT1,A0A0P0NGR6,A0A1X7IML5,A0A0A2LKJ7,K1L112,E0UCX3,K9XZC6,A0A0C1VHB4,Q31N05,Q2JI93,A0A142Y7A9,A0A2T2YMB1,A0A329TD61,A0A1Q1FPH0,A0A259TUP4,A0A4Q2UIU6,H1YCU5,L0JS08,A0A1Q5ZS75,A0A345E7N0,M0AF24,A0A1H3X247,M0D2X3,A0A2R5G167,A0A346PK63,A0A1C3ZXN2,B9LVP8,M5RSF0,W0JW77,F8D8G0,A0A343TL88,L0AJX6,A0A2A5QS34,A0A343JEE2,A0A3P3RGE5,A0A329TBQ3,A0A0W1S8B8,L9VRQ2,E4NRV1,A0A1I6HGN0,,",366,37
"545","N.S18.3","N.S19.1",229,158,71,1.53953467641291,"4F1N,4F3T,4KRE,5GUH,6KR6,6OON,7KX7,A0A163JTZ6,A0A196SDB4,J9D5G4,C4LVV2,A0A2P6N8X7,A8BCK6,A2DPV7,T1H8B3,R1FDF0,S4RWI0,D2VMG4,A0A074TLL7,A0A0D1ZAJ4,Q1K660,F4PH46,A0A3M7S814,A0A164ZA52,A0A383WDW5,S7WCF7,I0YVB2,C1DZY0,A0CB11,R9ACY5,A0A1Z5TVE5,W7XD45,A0A1U7LLR0,A0A4S2MWZ7,K1VVQ6,G7DVX0,G4N9J3,E3KLI3,D5GGK8,S8ANP9,A0A139AUH8,L2GMR6,U4LBG4,A0A177URI1,O74957,A6N7Y9,A0A0E9NDK5,T1KZ60,A0A250WXN5,A0A2G8JLH3,Q5KAT1,L2GUF2,W2T741,A0A1W0E4B5,A0A2J7QB22,A0A2K3CW87,A0A388KES6,A0A3S3PD82,A0A0L0TEV1,A0A1S3J512,G0QTT2,A0A1J1HRI1,C4V9J2,Q9JMB7,A0A075AN09,Q5TW24,A0A401PRI6,Q96J94,A0A2B4RHN2,G2QEV0,A0A397UU01,A0A2T7PFL8,K7ISV0,A0A024FT57,H3HCL6,A0A0G4IME3,E9FUN9,D7FQK3,A0A1Y1YHC8,T1GSU4,A0A1D8PMK0,Q5BD61,A0A1C7M8P2,A0A4D8YSQ3,A0A158PJG6,J9JZ66,A0A158QZT6,A0A165QYQ9,T0SAU8,R7YY92,A0A3S1A0C3,A0A074YJ47,A0A2K1J482,A0A1Q3ENA6,O04379,A0A371I3C8,M8AEW7,A0A2K3NY65,F4NYW7,A0A409Y6G2,A0A0L0HAB7,A0A1D1W4K0,A7RQ46,W4YU94,A7BJS5,D8SNM6,A0A1J8PPA3,X1WG39,M5FQK2,Q69VD5,A0A0D8XL16,A0A016WPN3,Q9QZ81,G5EES3,A0A0K0EFP6,Q8CJG0,A0A1D5NTU6,A0A0V0YLH8,A0A139WDH0,A0A0R3W9Q7,H3DS31,A0A1Y1HWP2,G4T5G9,B7QCC4,A0A0B2UV00,M7BCJ9,E9GN30,Q7PZ41,A0A077Z361,R7U9I3,A0A1X7V1N5,A0A0K0JDP1,A0A0N4UKJ1,A0A498N3A3,A0A3M0IQP5,A0A0L8GBV4,Q32KD4,A0A1J1JBJ0,E0W4C3,A0A482XDA9,A0A3P7EJD6,J9K2Z4,A0A2J7Q8V4,T1IBM6,V3ZRX0,A0A210QKF7,A0A423TSS1,K1PT78,A0A267E8R7,A0A1D2N447,A0A226D7A9,F6YK55,T1KTE4,A0A2C9JGZ6,A0A1V9X9F0,K5X5Z7,A0A3Q0KUG5,T1FY40,3DLB,5G5T,5I4A,6QZK,A0A0M2PXX3,A0A1C0UUC4,A0A1T4Y3A2,A0A060HNJ0,A0A1H3LE92,A0A496APJ8,A0A062U2W9,A0A1I2ZGP1,A0A317EJY3,A0A1I2BD20,F8ERC7,S7VLM7,A0A1A5X8H4,A0A1I2T6Q1,A0A1R3T9N6,H8KXJ0,D3S0S6,A0A2D1U4H7,A0A0B7I4Z6,A0LL61,Q8DKB1,A0A139WY18,A0A2T1E1K4,A0A1Q8ZD62,A0A4Q6XKV6,A0A1Z3HNN4,A0A239JE83,A0A2N4XBY2,R5JEI2,A0A0Q0ZC47,A0A2T0XH18,A0A1V4CHV0,A0A1K1RQP7,A0A2T1EKT1,A0A1N6LUI7,A0A0P0NGR6,A0A1X7IML5,A0A0A2LKJ7,K1L112,A0A0U3AL92,A0A1H3A054,R5NJJ8,A0A142Y7A9,A0A432MEQ5,A0A372DKU2,A0A1P8WP90,A0A1C9VH88,A0A2T2YMB1,A0A1U9ND56,A0A4R7BQC4,L0JS08,M0D2X3,A0A2R5G167,A0A346PK63,R7RTW6,B9LVP8,M5RSF0,W0JW77,B7K585,F8D8G0,L0AJX6,A0A2A5QS34,A0A343JEE2,A0A329TBQ3,A0A285N2A8,A0A1V4C8L7,A0A1I0NI68,,",366,37
"549","C.H10.6","C.L28.4",247,159,88,4.20833333333333,"4F1N,4F3T,4KRE,5GUH,5VM9,6KR6,6OON,7KX7,7SWF,A0A163JTZ6,A0A196SDB4,J9D5G4,Q389P5,A2DPV7,A0A0G4H2S4,D2VMG4,A0A0D1ZAJ4,Q1K660,F4PH46,A0A3M7S814,A0A383WDW5,Q54G64,S7WCF7,I0YVB2,R7QGN7,C1DZY0,A0A2C5Z0M1,R9ACY5,W7XD45,A0A1U7LLR0,A0A4S2MWZ7,K1VVQ6,A0A158P1R9,V6R0U9,G4N9J3,B7Q5I1,A0A1E3QC61,D5GGK8,S8ANP9,A0A139AUH8,L2GMR6,U4LBG4,A0A177URI1,O74957,A0A3N4IGK1,A6N7Y9,A0A0E9NDK5,T1KZ60,A0A2G8JLH3,L2GUF2,W2T741,A0A1W0E4B5,A0A2J7QB22,S4RYE2,A0A2K3CW87,A0A388KES6,A0A226EFL3,A0A3S3PD82,A0A0L0TEV1,A0A1S3J512,G0QTT2,A0A1J1HRI1,C4V9J2,Q9JMB7,A0A075AN09,Q5TW24,U5HIG6,A0A401PRI6,Q96J94,A0A2B4RHN2,G2QEV0,A0A397UU01,A0A2T7PFL8,K7ISV0,A0A024FT57,H3HCL6,A0A0G4IME3,E9FUN9,A0A1S3CYL5,D7FQK3,A0A1Y1YHC8,A0A1D8PMK0,Q5BD61,A0A4D8YSQ3,A0A158PJG6,J9JZ66,A0A0C2XG51,A0A165QYQ9,T0SAU8,R7YY92,A0A074YJ47,A0A2K1J482,A0A1Q3ENA6,O04379,M8AEW7,A8P0D4,A0A2K3NY65,F4NYW7,A0A409Y6G2,A0A0L0HAB7,D8PZT7,A0A1D1W4K0,A7RQ46,W4YU94,A7BJS5,D8SNM6,A0A1J8PPA3,X1WG39,M5FQK2,Q69VD5,A0A2R6NSC2,A0A0D8XL16,A0A016WPN3,Q9QZ81,G5EES3,A0A0K0EFP6,Q8CJG0,A0A1D5NTU6,V2WTL2,A0A0V0YLH8,A0A139WDH0,A0A0R3W9Q7,H3DS31,A0A1Y1HWP2,G4T5G9,B7QCC4,A0A0B2UV00,M7BCJ9,E9GN30,Q7PZ41,A0A077Z361,R7U9I3,A0A1X7V1N5,A0A0K0JDP1,A0A0N4UKJ1,A0A498N3A3,A0A3M0IQP5,A0A0L8GBV4,Q32KD4,A0A1J1JBJ0,E0W4C3,A0A482XDA9,A0A3P7EJD6,J9K2Z4,A0A2J7Q8V4,T1IBM6,V3ZRX0,A0A210QKF7,A0A423TSS1,A0A267E8R7,A0A1D2N447,A0A226D7A9,F6YK55,T1KTE4,A0A2C9JGZ6,A0A1V9X9F0,K5X5Z7,A0A3Q0KUG5,T1FY40,1YVU,1Z26,5AWH,5G5T,6QZK,A0A1I7IXT4,A0A2W1JZ37,A0A2S7WBN3,A0A328VKE4,A0A420DFE6,A0A4V1VDY2,A0A368P5I0,A0A4R1RMM2,A0A1Y2RDH8,Q11QW7,A0A0K8QX04,A0A0M2PXX3,A0A1L3JHM3,A0A1W6MIP2,A0A1C0UUC4,A0A2U2J9E0,A0A3D8L290,A0A1T4Y3A2,R6KUL9,A0A2G9DT08,Q9L1X1,A0A060HNJ0,A0A235B542,A0A1H3LE92,A0A496APJ8,A0A1V9G9U4,A0A1A5X8H4,A0A1I2T6Q1,A0A1R3T9N6,A0A0Q2M2Z1,H8KXJ0,A0A2D1U4H7,A0A0B7I4Z6,A0LL61,A0A139WY18,A0A1J1EK56,A0A2T1E1K4,A0A1Q8ZD62,A0A4Q6XKV6,A0A1Z3HNN4,A0A239JE83,A0A2N4XBY2,Q53W94,R5JEI2,A0A0Q0ZC47,A0A2T0XH18,A0A1V4CHV0,A0A1K1RQP7,A0A1N6LUI7,A0A0P0NGR6,A0A1X7IML5,A0A0A2LKJ7,K1L112,A0A0U3AL92,A0A1H3A054,E0UCX3,A0A0C1VHB4,A0A0C5JKF3,A5D4D9,A0A142Y7A9,A0A432MEQ5,A0A372DKU2,C1F5Q7,A0A4R3EV39,A0A1P8WP90,A0A222F7P0,A0A1C9VH88,A0A2T2YMB1,A0A101R2A0,A0A1U9ND56,A0A4R7BQC4,E0TGY3,A0A259TUP4,F6EYI8,A0A2S9Q9J0,A0A4Q2UIU6,A0A1H0LH25,A0A318LG42,A0A2R5G167,A0A346PK63,M5RSF0,B7K585,A0A343JEE2,,",366,37
"553","C.L13.1","C.S11.1",235,159,76,1.52399867593512,"5GUH,5VM9,6KR6,6OON,7SWF,A0A163JTZ6,J9D5G4,C4LVV2,A8BCK6,A2DPV7,T1H8B3,R1FDF0,S4RWI0,D2VMG4,A0A074TLL7,Q1K660,F4PH46,A0A3M7S814,A0A164ZA52,A0A383WDW5,Q54G64,S7WCF7,R7QGN7,A0A2C5Z0M1,A0CB11,D3BMP8,A0A1Z5TVE5,W7XD45,A0A4S2MWZ7,K1VVQ6,A0A158P1R9,V6R0U9,G4N9J3,E3KLI3,B7Q5I1,A0A1E3QC61,D5GGK8,S8ANP9,L2GMR6,U4LBG4,O74957,A0A3N4IGK1,A6N7Y9,A0A0E9NDK5,T1KZ60,A0A2G8JLH3,Q5KAT1,L2GUF2,W2T741,A0A1W0E4B5,A0A2J7QB22,A0A2K3CW87,A0A226EFL3,A0A3S3PD82,A0A0L0TEV1,A0A1S3J512,G0QTT2,A0A1J1HRI1,C4V9J2,Q9JMB7,A0A075AN09,Q5TW24,U5HIG6,A0A401PRI6,Q96J94,A0A2B4RHN2,G2QEV0,A0A397UU01,A0A2T7PFL8,K7ISV0,A0A024FT57,H3HCL6,A0A0G4IME3,D7FQK3,A0A1Y1YHC8,T1GSU4,F4S231,A0A2G5B1D8,Q5BD61,A0A1C7M8P2,A0A4D8YSQ3,A0A158PJG6,J9JZ66,A0A0C2XG51,A0A158QZT6,A0A165QYQ9,T0SAU8,R7YY92,A0A3S1A0C3,A0A2K1J482,A0A1Q3ENA6,O04379,A0A371I3C8,M8AEW7,A8P0D4,A0A2K3NY65,F4NYW7,A0A409Y6G2,A0A0L0HAB7,D8PZT7,A0A1D1W4K0,A7RQ46,W4YU94,A7BJS5,D8SNM6,A0A1J8PPA3,X1WG39,M5FQK2,Q69VD5,A0A2R6NSC2,A0A0D8XL16,A0A016WPN3,Q9QZ81,G5EES3,A0A0K0EFP6,Q8CJG0,A0A1D5NTU6,V2WTL2,A0A0V0YLH8,A0A139WDH0,A0A0R3W9Q7,H3DS31,A0A1Y1HWP2,G4T5G9,B7QCC4,A0A0B2UV00,M7BCJ9,E9GN30,Q7PZ41,A0A077Z361,R7U9I3,A0A1X7V1N5,A0A0K0JDP1,A0A0N4UKJ1,A0A498N3A3,A0A3M0IQP5,A0A0L8GBV4,Q32KD4,A0A1J1JBJ0,E0W4C3,A0A482XDA9,A0A3P7EJD6,J9K2Z4,A0A2J7Q8V4,T1IBM6,V3ZRX0,A0A210QKF7,A0A423TSS1,K1PT78,A0A267E8R7,A0A1D2N447,A0A226D7A9,F6YK55,T1KTE4,A0A2C9JGZ6,A0A1V9X9F0,K5X5Z7,A0A3Q0KUG5,T1FY40,1Z26,3DLB,5AWH,5G5T,5I4A,Q11QW7,B1XJG0,A0A097QRL6,A0A1T4Y3A2,B6YTQ5,A0A0P6X5X2,A0A2G9DT08,Q9L1X1,S7VLM7,A0A1A5X8H4,A0A1I2T6Q1,A0A1R3T9N6,A0A0Q2M2Z1,H8KXJ0,D3S0S6,A0A2D1U4H7,I3TE64,A0A0B7I4Z6,A0LL61,Q8DKB1,A0A4Q6XKV6,A0A239JE83,A0A2N4XBY2,Q53W94,R5JEI2,A0A0Q0ZC47,A0A2T0XH18,A0A1V4CHV0,A0A1K1RQP7,A0A2T1EKT1,A0A1N6LUI7,A0A0P0NGR6,A0A1X7IML5,A0A0A2LKJ7,K1L112,A0A0U3AL92,A0A1H3A054,E0UCX3,K9XZC6,Q31N05,A0A0C5JKF3,A5D4D9,Q2JI93,A0A142Y7A9,A0A432MEQ5,A0A372DKU2,C1F5Q7,A0A4R3EV39,A0A1P8WP90,A0A222F7P0,A0A1C9VH88,A0A2T2YMB1,A0A101R2A0,A0A1E3XF49,A0A1U9ND56,A0A4R7BQC4,E0TGY3,A0A259TUP4,F6EYI8,A0A2S9Q9J0,A0A4Q2UIU6,A0A1H0LH25,A0A318LG42,H1YCU5,A0A1Q5ZS75,A0A1W2A082,A0A0C1XUA0,A0A2R5G167,A0A1H2RBI2,M5RSF0,B7K585,,",366,37
"555","C.L28.2","C.L28.4",267,159,108,2.8151642208246,"4F1N,4F3T,4KRE,5GUH,5VM9,6KR6,6OON,7KX7,7SWF,A0A163JTZ6,A0A196SDB4,J9D5G4,Q389P5,A2DPV7,A0A0G4H2S4,D2VMG4,A0A0D1ZAJ4,Q1K660,F4PH46,A0A3M7S814,A0A383WDW5,Q54G64,S7WCF7,I0YVB2,R7QGN7,C1DZY0,A0A2C5Z0M1,R9ACY5,W7XD45,A0A1U7LLR0,A0A4S2MWZ7,K1VVQ6,A0A158P1R9,V6R0U9,G4N9J3,B7Q5I1,A0A1E3QC61,D5GGK8,S8ANP9,A0A139AUH8,L2GMR6,U4LBG4,A0A177URI1,O74957,A0A3N4IGK1,A6N7Y9,A0A0E9NDK5,T1KZ60,A0A2G8JLH3,L2GUF2,W2T741,A0A1W0E4B5,A0A2J7QB22,S4RYE2,A0A2K3CW87,A0A388KES6,A0A226EFL3,A0A3S3PD82,A0A0L0TEV1,A0A1S3J512,G0QTT2,A0A1J1HRI1,C4V9J2,Q9JMB7,A0A075AN09,Q5TW24,U5HIG6,A0A401PRI6,Q96J94,A0A2B4RHN2,G2QEV0,A0A397UU01,A0A2T7PFL8,K7ISV0,A0A024FT57,H3HCL6,A0A0G4IME3,E9FUN9,A0A1S3CYL5,D7FQK3,A0A1Y1YHC8,A0A1D8PMK0,Q5BD61,A0A4D8YSQ3,A0A158PJG6,J9JZ66,A0A0C2XG51,A0A165QYQ9,T0SAU8,R7YY92,A0A074YJ47,A0A2K1J482,A0A1Q3ENA6,O04379,M8AEW7,A8P0D4,A0A2K3NY65,F4NYW7,A0A409Y6G2,A0A0L0HAB7,D8PZT7,A0A1D1W4K0,A7RQ46,W4YU94,A7BJS5,D8SNM6,A0A1J8PPA3,X1WG39,M5FQK2,Q69VD5,A0A2R6NSC2,A0A0D8XL16,A0A016WPN3,Q9QZ81,G5EES3,A0A0K0EFP6,Q8CJG0,A0A1D5NTU6,V2WTL2,A0A0V0YLH8,A0A139WDH0,A0A0R3W9Q7,H3DS31,A0A1Y1HWP2,G4T5G9,B7QCC4,A0A0B2UV00,M7BCJ9,E9GN30,Q7PZ41,A0A077Z361,R7U9I3,A0A1X7V1N5,A0A0K0JDP1,A0A0N4UKJ1,A0A498N3A3,A0A3M0IQP5,A0A0L8GBV4,Q32KD4,A0A1J1JBJ0,E0W4C3,A0A482XDA9,A0A3P7EJD6,J9K2Z4,A0A2J7Q8V4,T1IBM6,V3ZRX0,A0A210QKF7,A0A423TSS1,A0A267E8R7,A0A1D2N447,A0A226D7A9,F6YK55,T1KTE4,A0A2C9JGZ6,A0A1V9X9F0,K5X5Z7,A0A3Q0KUG5,T1FY40,1YVU,1Z26,5AWH,5G5T,6QZK,A0A1I7IXT4,A0A2W1JZ37,A0A2S7WBN3,A0A328VKE4,A0A420DFE6,A0A4V1VDY2,A0A368P5I0,A0A4R1RMM2,A0A1Y2RDH8,Q11QW7,A0A1M5ZSR3,A0A0K8QX04,A0A0M2PXX3,K9TPA9,A0A1L3JHM3,A0A1W6MIP2,A0A1C0UUC4,A0A2U2J9E0,B1XJG0,A0A3D8L290,A0A1Q4R485,K9U8J6,K9RC91,A0A0D8ZUC0,A0A139XGN8,A0A1T4Y3A2,A0YYT3,A0A2T1EFY0,G6FTN0,R6KUL9,A0A433NB65,A0A1Z4L0A1,A0A2T1G8M7,K9VUN0,K9ZDE3,B0JXD6,A0A2T1LS63,A0A0P4UVI8,A0A0V7ZCG4,A0A2G9DT08,Q9L1X1,A0A060HNJ0,A0A235B542,A0A1H3LE92,A0A496APJ8,A0A1V9G9U4,A0A1A5X8H4,A0A1I2T6Q1,A0A1R3T9N6,A0A0Q2M2Z1,H8KXJ0,A0A2D1U4H7,A0A0B7I4Z6,A0LL61,A0A139WY18,A0A1J1EK56,A0A2T1E1K4,A0A1Q8ZD62,A0A4Q6XKV6,A0A1Z3HNN4,A0A239JE83,A0A2N4XBY2,Q53W94,R5JEI2,A0A0Q0ZC47,A0A2T0XH18,A0A1V4CHV0,A0A1K1RQP7,A0A1N6LUI7,A0A0P0NGR6,A0A1X7IML5,A0A0A2LKJ7,K1L112,A0A0U3AL92,A0A1H3A054,E0UCX3,A0A0C1VHB4,A0A0C5JKF3,A5D4D9,A0A142Y7A9,A0A432MEQ5,A0A372DKU2,C1F5Q7,A0A4R3EV39,A0A1P8WP90,A0A222F7P0,A0A1C9VH88,A0A2T2YMB1,A0A101R2A0,A0A1U9ND56,A0A4R7BQC4,E0TGY3,A0A259TUP4,F6EYI8,A0A2S9Q9J0,A0A4Q2UIU6,A0A1H0LH25,A0A318LG42,A0A2R5G167,A0A346PK63,M5RSF0,B7K585,A0A343JEE2,,",366,37
"561","N.H8.12","N.S11.7",258,159,99,3.60529826567562,"4F3T,4KRE,5GUH,5VM9,6KR6,6OON,7KX7,7SWF,J9D5G4,C4LVV2,A2DPV7,A0A0G4H2S4,T1H8B3,R1FDF0,S4RWI0,A0A0D1ZAJ4,Q1K660,F4PH46,A0A3M7S814,A0A164ZA52,Q54G64,S7WCF7,I0YVB2,R7QGN7,C1DZY0,A0A2C5Z0M1,A0CB11,R9ACY5,D3BMP8,A0A1Z5TVE5,W7XD45,A0A1U7LLR0,A0A4S2MWZ7,K1VVQ6,A0A158P1R9,V6R0U9,G4N9J3,E3KLI3,B7Q5I1,A0A1E3QC61,D5GGK8,S8ANP9,A0A139AUH8,L2GMR6,U4LBG4,A0A177URI1,O74957,A0A3N4IGK1,A6N7Y9,A0A0E9NDK5,T1KZ60,A0A2G8JLH3,Q5KAT1,L2GUF2,W2T741,A0A1W0E4B5,A0A2J7QB22,S4RYE2,A0A226EFL3,A0A3S3PD82,A0A1S3J512,G0QTT2,A0A1J1HRI1,C4V9J2,Q9JMB7,A0A075AN09,Q5TW24,U5HIG6,A0A401PRI6,Q96J94,A0A2B4RHN2,G2QEV0,A0A397UU01,A0A2T7PFL8,K7ISV0,A0A0G4IME3,E9FUN9,A0A1S3CYL5,D7FQK3,A0A1Y1YHC8,T1GSU4,F4S231,A0A1D8PMK0,A0A2G5B1D8,Q5BD61,A0A1C7M8P2,A0A4D8YSQ3,J9JZ66,A0A0C2XG51,A0A158QZT6,A0A165QYQ9,T0SAU8,R7YY92,A0A3S1A0C3,A0A074YJ47,A0A2K1J482,A0A1Q3ENA6,O04379,A0A371I3C8,M8AEW7,A8P0D4,A0A2K3NY65,F4NYW7,A0A409Y6G2,A0A0L0HAB7,A0A1D1W4K0,A7RQ46,W4YU94,A7BJS5,D8SNM6,A0A1J8PPA3,X1WG39,M5FQK2,Q69VD5,A0A2R6NSC2,A0A0D8XL16,A0A016WPN3,Q9QZ81,G5EES3,A0A0K0EFP6,Q8CJG0,A0A1D5NTU6,V2WTL2,A0A139WDH0,A0A0R3W9Q7,H3DS31,A0A1Y1HWP2,G4T5G9,B7QCC4,A0A0B2UV00,M7BCJ9,E9GN30,Q7PZ41,A0A077Z361,R7U9I3,A0A1X7V1N5,A0A0K0JDP1,A0A0N4UKJ1,A0A3M0IQP5,A0A0L8GBV4,Q32KD4,A0A1J1JBJ0,A0A482XDA9,A0A3P7EJD6,J9K2Z4,A0A2J7Q8V4,T1IBM6,A0A423TSS1,K1PT78,A0A267E8R7,A0A1D2N447,A0A226D7A9,F6YK55,T1KTE4,A0A2C9JGZ6,A0A1V9X9F0,K5X5Z7,A0A3Q0KUG5,T1FY40,1YVU,5AWH,5I4A,6QZK,7R8K,B1XJG0,A0A1T4Y3A2,R6KUL9,A0A060HNJ0,R5XQK4,A0A1H3LE92,A0A496APJ8,A0A062U2W9,H0HWQ5,A0A1V9G9U4,A0A1I2ZGP1,A0A317EJY3,S7VLM7,A0A1R3T9N6,A0A0Q2M2Z1,H8KXJ0,A0A2D1U4H7,A0A0B7I4Z6,Q8DKB1,A0A139WY18,A0A1J1EK56,A0A2T1E1K4,A0A1Q8ZD62,A0A4Q6XKV6,A0A1Z3HNN4,A0A239JE83,A0A2N4XBY2,Q53W94,R5JEI2,A0A0Q0ZC47,A0A2T0XH18,A0A1K1RQP7,A0A2T1EKT1,A0A0P0NGR6,A0A1X7IML5,A0A0A2LKJ7,K1L112,A0A0U3AL92,A0A1H3A054,E0UCX3,B9LVW4,A0A0C1VHB4,Q31N05,A0A0C5JKF3,R5NJJ8,A5D4D9,Q2JI93,A0A142Y7A9,A0A372DKU2,A0A1P8WP90,A0A222F7P0,A0A1C9VH88,A0A2T2YMB1,A0A329TD61,A0A1E3XF49,A0A1U9ND56,A0A4R7BQC4,A0A1H3DGN3,A0A1Q1FPH0,E0TGY3,A0A259TUP4,F6EYI8,A0A2S9Q9J0,A0A4Q2UIU6,H1YCU5,L0JS08,A0A1Q5ZS75,A0A345E7N0,M0AF24,A0A1W2A082,A0A1H3X247,A0A0C1XUA0,M0D2X3,A0A346PK63,R7RTW6,A0A1H2RBI2,A0A1C3ZXN2,B9LVP8,W0JW77,B7K585,F8D8G0,A0A343TL88,L0AJX6,A0A2A5QS34,A0A343JEE2,A0A3P3RGE5,A0A329TBQ3,A0A285N2A8,A0A0W1S8B8,A0A1V4C8L7,L9VRQ2,E4NRV1,A0A1I6HGN0,A0A1I0NI68,,",366,37
"565","N.S2.2","N.S2.4",223,159,64,1.39190251572327,"4F1N,4F3T,4KRE,5GUH,5VM9,6OON,7KX7,7SWF,A0A0N4X8S8,Q389P5,C4LVV2,A0A2P6N8X7,A0A0G4H2S4,T1H8B3,R1FDF0,S4RWI0,D2VMG4,A0A074TLL7,A0A0D1ZAJ4,Q1K660,F4PH46,A0A164ZA52,A0A383WDW5,Q54G64,S7WCF7,R7QGN7,C1DZY0,A0A2C5Z0M1,A0CB11,R9ACY5,D3BMP8,W7XD45,A0A1U7LLR0,K1VVQ6,A0A158P1R9,G7DVX0,V6R0U9,E3KLI3,A0A1E3QC61,D5GGK8,S8ANP9,A0A139AUH8,L2GMR6,U4LBG4,O74957,A6N7Y9,A0A0E9NDK5,T1KZ60,A0A250WXN5,A0A2G8JLH3,Q5KAT1,L2GUF2,A0A1W0E4B5,S4RYE2,A0A2K3CW87,A0A388KES6,A0A226EFL3,A0A3S3PD82,A0A1S3J512,G0QTT2,A0A1J1HRI1,C4V9J2,Q9JMB7,U5HIG6,A0A401PRI6,Q96J94,A0A2B4RHN2,G2QEV0,A0A397UU01,A0A2T7PFL8,A0A024FT57,H3HCL6,A0A0G4IME3,E9FUN9,A0A1S3CYL5,D7FQK3,A0A1Y1YHC8,T1GSU4,F4S231,A0A1D8PMK0,A0A1C7M8P2,A0A4D8YSQ3,A0A158PJG6,J9JZ66,A0A158QZT6,A0A165QYQ9,T0SAU8,R7YY92,A0A3S1A0C3,A0A074YJ47,A0A2K1J482,O04379,A0A371I3C8,M8AEW7,A8P0D4,A0A2K3NY65,F4NYW7,A0A409Y6G2,A0A0L0HAB7,D8PZT7,A0A1D1W4K0,A7RQ46,W4YU94,A7BJS5,D8SNM6,A0A1J8PPA3,X1WG39,M5FQK2,Q69VD5,A0A2R6NSC2,A0A0D8XL16,A0A016WPN3,Q9QZ81,G5EES3,A0A0K0EFP6,Q8CJG0,A0A1D5NTU6,V2WTL2,A0A0V0YLH8,A0A139WDH0,A0A0R3W9Q7,H3DS31,A0A1Y1HWP2,G4T5G9,B7QCC4,A0A0B2UV00,M7BCJ9,E9GN30,Q7PZ41,A0A077Z361,R7U9I3,A0A1X7V1N5,A0A0K0JDP1,A0A0N4UKJ1,A0A498N3A3,A0A3M0IQP5,A0A0L8GBV4,Q32KD4,A0A1J1JBJ0,E0W4C3,A0A482XDA9,A0A3P7EJD6,J9K2Z4,A0A2J7Q8V4,T1IBM6,V3ZRX0,A0A210QKF7,A0A423TSS1,K1PT78,A0A267E8R7,A0A1D2N447,A0A226D7A9,F6YK55,T1KTE4,A0A2C9JGZ6,A0A1V9X9F0,K5X5Z7,A0A3Q0KUG5,T1FY40,1YVU,5G5T,5I4A,A0A1W6MIP2,A0A142XB92,A0A326U7G5,A0A3D8L290,K9RC91,A0A139XGN8,A0YYT3,R6KUL9,A0A2T1G8M7,K9VUN0,A0A0P4UVI8,A0A0V7ZCG4,A0A235B542,R5XQK4,H0HWQ5,F8ERC7,A0A0Q2M2Z1,D3S0S6,I3TE64,A0A0B7I4Z6,A0LL61,Q8DKB1,A0A1J1EK56,A0A239JE83,Q53W94,A0A0Q0ZC47,A0A1V4CHV0,A0A2T1EKT1,A0A0U3AL92,A0A1H3A054,E0UCX3,K9XZC6,A0A0C1VHB4,Q31N05,A0A0C5JKF3,Q2JI93,A0A142Y7A9,A0A372DKU2,C1F5Q7,A0A4R3EV39,A0A1P8WP90,A0A222F7P0,A0A1C9VH88,A0A1E3XF49,A0A1Q1FPH0,E0TGY3,H1YCU5,A0A1Q5ZS75,A0A1H3X247,A0A2R5G167,A0A346PK63,A0A1C3ZXN2,B9LVP8,M5RSF0,A0A343TL88,A0A3P3RGE5,A0A329TBQ3,A0A285N2A8,A0A0W1S8B8,L9VRQ2,E4NRV1,,",366,37
"573","C.H7.2","C.H7.6",287,160,127,3.22785433070866,"4F3T,4KRE,5GUH,5VM9,6KR6,6OON,7KX7,7SWF,A0A163JTZ6,A0A196SDB4,J9D5G4,C4LVV2,A0A2P6N8X7,A2DPV7,A0A0G4H2S4,T1H8B3,R1FDF0,S4RWI0,D2VMG4,A0A074TLL7,F4PH46,A0A3M7S814,A0A383WDW5,Q54G64,S7WCF7,R7QGN7,C1DZY0,A0CB11,R9ACY5,D3BMP8,W7XD45,A0A1U7LLR0,K1VVQ6,A0A158P1R9,G7DVX0,E3KLI3,B7Q5I1,A0A139AUH8,L2GMR6,A0A177URI1,O74957,A6N7Y9,T1KZ60,A0A250WXN5,A0A2G8JLH3,Q5KAT1,L2GUF2,W2T741,A0A1W0E4B5,A0A2J7QB22,A0A2K3CW87,A0A226EFL3,A0A3S3PD82,A0A0L0TEV1,A0A1S3J512,G0QTT2,A0A1J1HRI1,C4V9J2,Q9JMB7,A0A075AN09,Q5TW24,U5HIG6,A0A401PRI6,Q96J94,A0A2B4RHN2,A0A397UU01,A0A2T7PFL8,K7ISV0,A0A024FT57,H3HCL6,A0A0G4IME3,E9FUN9,A0A1S3CYL5,D7FQK3,A0A1Y1YHC8,T1GSU4,A0A1D8PMK0,A0A2G5B1D8,Q5BD61,A0A1C7M8P2,A0A4D8YSQ3,A0A158PJG6,J9JZ66,A0A0C2XG51,A0A158QZT6,A0A165QYQ9,T0SAU8,R7YY92,A0A3S1A0C3,A0A074YJ47,A0A2K1J482,A0A1Q3ENA6,O04379,A0A371I3C8,M8AEW7,A8P0D4,A0A2K3NY65,F4NYW7,A0A409Y6G2,A0A0L0HAB7,D8PZT7,A0A1D1W4K0,A7RQ46,W4YU94,A7BJS5,D8SNM6,A0A1J8PPA3,X1WG39,M5FQK2,Q69VD5,A0A2R6NSC2,A0A0D8XL16,A0A016WPN3,Q9QZ81,G5EES3,A0A0K0EFP6,Q8CJG0,A0A1D5NTU6,V2WTL2,A0A0V0YLH8,A0A139WDH0,A0A0R3W9Q7,H3DS31,A0A1Y1HWP2,G4T5G9,B7QCC4,A0A0B2UV00,M7BCJ9,E9GN30,Q7PZ41,A0A077Z361,R7U9I3,A0A1X7V1N5,A0A0K0JDP1,A0A0N4UKJ1,A0A498N3A3,A0A3M0IQP5,A0A0L8GBV4,Q32KD4,A0A1J1JBJ0,E0W4C3,A0A482XDA9,A0A3P7EJD6,J9K2Z4,A0A2J7Q8V4,T1IBM6,V3ZRX0,A0A210QKF7,A0A423TSS1,K1PT78,A0A267E8R7,A0A1D2N447,A0A226D7A9,F6YK55,T1KTE4,A0A2C9JGZ6,A0A1V9X9F0,K5X5Z7,A0A3Q0KUG5,T1FY40,1YVU,1Z26,3DLB,5AWH,5G5T,5I4A,6QZK,7R8K,E8N0K8,A0A328VKE4,E0ST67,C4L1M1,A0A4R1RMM2,A0A1Y2RDH8,Q11QW7,A0A1M5ZSR3,A0A0K8QX04,A0A0M2PXX3,A0A1I3LMA1,K9TPA9,A0A1C0UUC4,A0A2U2J9E0,A0A2Z6E1D5,A0A0F4NXW8,L8D0R3,B1XJG0,A0A3D8L290,A0A1Q4R485,K9U8J6,A0A097QRL6,K9RC91,A0A0D8ZUC0,A0A139XGN8,A0A1T4Y3A2,Q5P0R2,B6YTQ5,A0A0B0H9B4,A0YYT3,A0A2T1EFY0,G6FTN0,R6KUL9,A0A433NB65,A0A1Z4L0A1,K9UQR0,A0A2T1G8M7,K9VUN0,B7GJX9,K9ZDE3,B0JXD6,A0A2T1LS63,A0A1Z4K1Y3,A0A2Z6E0R7,A0A1N6SSK9,A0A0P4UVI8,A0A0V7ZCG4,A0A1J0AGK2,K9PFF9,K9UEV4,A0A060HNJ0,A0A235B542,R5XQK4,A0A1H3LE92,A0A496APJ8,A0A062U2W9,H0HWQ5,A0A1V9G9U4,A0A1I2ZGP1,A0A317EJY3,A0A1I2BD20,F8ERC7,A0A1A5X8H4,A0A0Q2M2Z1,A0A2D1U4H7,I3TE64,A0A0B7I4Z6,A0LL61,Q8DKB1,A0A139WY18,A0A1J1EK56,A0A2T1E1K4,A0A1Q8ZD62,A0A1Z3HNN4,Q53W94,A0A2T0XH18,A0A2T1EKT1,A0A0A2LKJ7,K1L112,E0UCX3,K9XZC6,A0A0C1VHB4,Q31N05,R5NJJ8,A5D4D9,Q2JI93,A0A3R7KLK4,C1F5Q7,A0A4R3EV39,A0A329TD61,A0A1E3XF49,A0A1H3DGN3,A0A1Q1FPH0,E0TGY3,F6EYI8,A0A2S9Q9J0,H1YCU5,A0A1Q5ZS75,A0A345E7N0,A0A1W2A082,A0A1H3X247,A0A0C1XUA0,A0A346PK63,R7RTW6,A0A1H2RBI2,A0A1C3ZXN2,B9LVP8,M5RSF0,W0JW77,A0A343TL88,L0AJX6,A0A343JEE2,A0A3P3RGE5,A0A329TBQ3,A0A285N2A8,A0A0W1S8B8,L9VRQ2,E4NRV1,A0A1I6HGN0,,",366,37
"576","C.S13.2","N.S1.5",265,160,105,3.05818452380952,"4F1N,4F3T,4KRE,5GUH,5VM9,6KR6,6OON,7KX7,7SWF,Q389P5,C4LVV2,T1H8B3,R1FDF0,S4RWI0,A0A074TLL7,A0A0D1ZAJ4,Q1K660,F4PH46,A0A383WDW5,Q54G64,R7QGN7,C1DZY0,A0CB11,R9ACY5,D3BMP8,W7XD45,A0A1U7LLR0,A0A4S2MWZ7,A0A158P1R9,G7DVX0,E3KLI3,B7Q5I1,A0A1E3QC61,S8ANP9,A0A139AUH8,L2GMR6,U4LBG4,A0A177URI1,O74957,A0A3N4IGK1,A6N7Y9,T1KZ60,A0A250WXN5,A0A2G8JLH3,Q5KAT1,L2GUF2,A0A2J7QB22,S4RYE2,A0A2K3CW87,A0A388KES6,A0A226EFL3,A0A3S3PD82,A0A0L0TEV1,A0A1S3J512,G0QTT2,A0A1J1HRI1,Q9JMB7,A0A075AN09,Q5TW24,U5HIG6,A0A401PRI6,Q96J94,A0A2B4RHN2,G2QEV0,A0A397UU01,A0A2T7PFL8,K7ISV0,A0A024FT57,H3HCL6,A0A0G4IME3,E9FUN9,A0A1S3CYL5,D7FQK3,A0A1Y1YHC8,T1GSU4,F4S231,A0A1D8PMK0,A0A2G5B1D8,Q5BD61,A0A1C7M8P2,A0A4D8YSQ3,A0A158PJG6,J9JZ66,A0A0C2XG51,A0A158QZT6,A0A165QYQ9,T0SAU8,R7YY92,A0A3S1A0C3,A0A074YJ47,A0A2K1J482,A0A1Q3ENA6,O04379,A0A371I3C8,M8AEW7,A8P0D4,A0A2K3NY65,F4NYW7,A0A409Y6G2,A0A0L0HAB7,D8PZT7,A0A1D1W4K0,A7RQ46,W4YU94,A7BJS5,D8SNM6,A0A1J8PPA3,X1WG39,M5FQK2,Q69VD5,A0A2R6NSC2,A0A0D8XL16,A0A016WPN3,Q9QZ81,G5EES3,A0A0K0EFP6,Q8CJG0,A0A1D5NTU6,V2WTL2,A0A0V0YLH8,A0A139WDH0,A0A0R3W9Q7,H3DS31,A0A1Y1HWP2,G4T5G9,B7QCC4,A0A0B2UV00,M7BCJ9,E9GN30,Q7PZ41,A0A077Z361,R7U9I3,A0A1X7V1N5,A0A0K0JDP1,A0A0N4UKJ1,A0A498N3A3,A0A3M0IQP5,A0A0L8GBV4,Q32KD4,A0A1J1JBJ0,E0W4C3,A0A482XDA9,A0A3P7EJD6,J9K2Z4,A0A2J7Q8V4,T1IBM6,V3ZRX0,A0A210QKF7,A0A423TSS1,K1PT78,A0A267E8R7,A0A1D2N447,A0A226D7A9,F6YK55,T1KTE4,A0A2C9JGZ6,A0A1V9X9F0,K5X5Z7,A0A3Q0KUG5,T1FY40,3DLB,5AWH,6QZK,A0A1I7IXT4,A0A2W1JZ37,A0A2S7WBN3,A0A420DFE6,A0A4V1VDY2,A0A368P5I0,A0A1W6MIP2,A0A2U2J9E0,A0A326U7G5,K9U8J6,K9RC91,A0A0D8ZUC0,A0A139XGN8,A0YYT3,A0A2T1EFY0,K9UQR0,A0A2T1G8M7,K9VUN0,B0JXD6,A0A2T1LS63,A0A1Z4K1Y3,A0A0P4UVI8,A0A0V7ZCG4,A0A1J0AGK2,K9UEV4,S7VLM7,H8KXJ0,A0A2D1U4H7,A0A0B7I4Z6,A0LL61,A0A1J1EK56,A0A4Q6XKV6,A0A239JE83,A0A2N4XBY2,Q53W94,R5JEI2,A0A0Q0ZC47,A0A2T0XH18,A0A1V4CHV0,A0A1K1RQP7,A0A1N6LUI7,A0A0P0NGR6,A0A1X7IML5,A0A0A2LKJ7,K1L112,A0A0U3AL92,A0A1H3A054,A0A0C5JKF3,R5NJJ8,A5D4D9,A0A142Y7A9,A0A372DKU2,A0A3R7KLK4,C1F5Q7,A0A4R3EV39,A0A1P8WP90,A0A222F7P0,A0A1C9VH88,A0A2T2YMB1,A0A329TD61,A0A101R2A0,A0A1E3XF49,A0A1U9ND56,A0A4R7BQC4,A0A1H3DGN3,A0A1Q1FPH0,E0TGY3,A0A259TUP4,F6EYI8,A0A2S9Q9J0,A0A4Q2UIU6,A0A1H0LH25,A0A318LG42,H1YCU5,L0JS08,A0A1Q5ZS75,A0A345E7N0,M0AF24,A0A1H3X247,A0A0C1XUA0,M0D2X3,A0A2R5G167,A0A346PK63,R7RTW6,A0A1C3ZXN2,B9LVP8,M5RSF0,W0JW77,B7K585,A0A343TL88,L0AJX6,A0A2A5QS34,A0A343JEE2,A0A3P3RGE5,A0A329TBQ3,A0A285N2A8,A0A0W1S8B8,A0A1V4C8L7,L9VRQ2,E4NRV1,A0A1I6HGN0,A0A1I0NI68,,",366,37
"578","N.H4.2","N.L22.1",265,160,105,2.15,"4F1N,4F3T,5GUH,6KR6,6OON,7SWF,A0A163JTZ6,A0A0N4X8S8,J9D5G4,A8BCK6,A2DPV7,A0A0G4H2S4,T1H8B3,R1FDF0,S4RWI0,A0A0D1ZAJ4,Q1K660,F4PH46,A0A3M7S814,A0A164ZA52,A0A383WDW5,Q54G64,S7WCF7,C1DZY0,A0A2C5Z0M1,A0CB11,D3BMP8,A0A1Z5TVE5,W7XD45,A0A1U7LLR0,A0A4S2MWZ7,K1VVQ6,A0A158P1R9,G7DVX0,V6R0U9,G4N9J3,E3KLI3,A0A139AUH8,L2GMR6,U4LBG4,A0A177URI1,A6N7Y9,A0A0E9NDK5,T1KZ60,A0A250WXN5,A0A2G8JLH3,Q5KAT1,L2GUF2,W2T741,A0A1W0E4B5,A0A2J7QB22,S4RYE2,A0A388KES6,A0A226EFL3,A0A3S3PD82,A0A0L0TEV1,A0A1S3J512,G0QTT2,A0A1J1HRI1,C4V9J2,Q9JMB7,A0A075AN09,Q5TW24,A0A401PRI6,Q96J94,A0A2B4RHN2,G2QEV0,A0A397UU01,A0A2T7PFL8,K7ISV0,A0A024FT57,H3HCL6,A0A0G4IME3,E9FUN9,A0A1S3CYL5,D7FQK3,A0A1Y1YHC8,T1GSU4,F4S231,A0A1D8PMK0,Q5BD61,A0A1C7M8P2,A0A4D8YSQ3,A0A158PJG6,J9JZ66,A0A158QZT6,A0A165QYQ9,T0SAU8,R7YY92,A0A3S1A0C3,A0A074YJ47,A0A2K1J482,A0A1Q3ENA6,O04379,A0A371I3C8,M8AEW7,A8P0D4,A0A2K3NY65,F4NYW7,A0A409Y6G2,A0A0L0HAB7,D8PZT7,A0A1D1W4K0,A7RQ46,W4YU94,A7BJS5,D8SNM6,A0A1J8PPA3,X1WG39,Q69VD5,A0A2R6NSC2,A0A0D8XL16,A0A016WPN3,Q9QZ81,G5EES3,A0A0K0EFP6,Q8CJG0,A0A1D5NTU6,V2WTL2,A0A0V0YLH8,A0A139WDH0,A0A0R3W9Q7,H3DS31,A0A1Y1HWP2,G4T5G9,B7QCC4,A0A0B2UV00,M7BCJ9,E9GN30,Q7PZ41,A0A077Z361,R7U9I3,A0A1X7V1N5,A0A0K0JDP1,A0A0N4UKJ1,A0A498N3A3,A0A3M0IQP5,A0A0L8GBV4,Q32KD4,A0A1J1JBJ0,E0W4C3,A0A482XDA9,A0A3P7EJD6,J9K2Z4,A0A2J7Q8V4,T1IBM6,V3ZRX0,A0A210QKF7,A0A423TSS1,K1PT78,A0A267E8R7,A0A1D2N447,A0A226D7A9,F6YK55,T1KTE4,A0A2C9JGZ6,A0A1V9X9F0,K5X5Z7,A0A3Q0KUG5,T1FY40,1YVU,1Z26,3DLB,5G5T,7R8K,E0ST67,B1XJG0,A0A1T4Y3A2,A0A2G9DT08,Q9L1X1,A0A496APJ8,A0A062U2W9,H0HWQ5,A0A1V9G9U4,A0A1I2ZGP1,A0A317EJY3,A0A1I2BD20,F8ERC7,S7VLM7,A0A1A5X8H4,A0A1I2T6Q1,A0A1R3T9N6,A0A0Q2M2Z1,H8KXJ0,D3S0S6,A0A2D1U4H7,A0A0B7I4Z6,A0LL61,Q8DKB1,A0A139WY18,A0A1J1EK56,A0A2T1E1K4,A0A1Q8ZD62,A0A4Q6XKV6,A0A1Z3HNN4,A0A239JE83,A0A2N4XBY2,Q53W94,R5JEI2,A0A0Q0ZC47,A0A2T0XH18,A0A1V4CHV0,A0A1K1RQP7,A0A2T1EKT1,A0A1N6LUI7,A0A0P0NGR6,A0A1X7IML5,A0A0A2LKJ7,K1L112,A0A0U3AL92,A0A1H3A054,E0UCX3,K9XZC6,A0A0C1VHB4,Q31N05,A0A0C5JKF3,R5NJJ8,A5D4D9,Q2JI93,A0A142Y7A9,A0A432MEQ5,A0A372DKU2,A0A4R3EV39,A0A1P8WP90,A0A222F7P0,A0A1C9VH88,A0A2T2YMB1,A0A329TD61,A0A101R2A0,A0A1E3XF49,A0A1Q1FPH0,E0TGY3,A0A259TUP4,F6EYI8,A0A2S9Q9J0,A0A4Q2UIU6,A0A1H0LH25,A0A318LG42,H1YCU5,L0JS08,A0A1Q5ZS75,A0A345E7N0,M0AF24,A0A1W2A082,A0A1H3X247,A0A0C1XUA0,M0D2X3,A0A2R5G167,A0A346PK63,R7RTW6,A0A1H2RBI2,A0A1C3ZXN2,B9LVP8,B7K585,F8D8G0,A0A343TL88,A0A343JEE2,A0A3P3RGE5,A0A329TBQ3,A0A0W1S8B8,A0A1V4C8L7,L9VRQ2,E4NRV1,A0A1I6HGN0,A0A1I0NI68,,",366,37
"582","C.H1.4","C.H1.8",276,161,115,2.48757763975155,"4F1N,4F3T,4KRE,5GUH,5VM9,6KR6,6OON,7KX7,7SWF,A0A163JTZ6,A0A0N4X8S8,A2DPV7,T1H8B3,S4RWI0,A0A0D1ZAJ4,Q1K660,F4PH46,A0A3M7S814,A0A164ZA52,A0A383WDW5,R7QGN7,C1DZY0,A0A2C5Z0M1,A0CB11,D3BMP8,A0A1Z5TVE5,W7XD45,A0A1U7LLR0,A0A4S2MWZ7,A0A158P1R9,G7DVX0,V6R0U9,G4N9J3,E3KLI3,B7Q5I1,A0A1E3QC61,D5GGK8,S8ANP9,A0A139AUH8,U4LBG4,A0A177URI1,O74957,A0A3N4IGK1,A6N7Y9,A0A0E9NDK5,T1KZ60,A0A250WXN5,A0A2G8JLH3,L2GUF2,W2T741,A0A2J7QB22,S4RYE2,A0A2K3CW87,A0A388KES6,A0A226EFL3,A0A3S3PD82,A0A0L0TEV1,A0A1S3J512,G0QTT2,A0A1J1HRI1,Q9JMB7,A0A075AN09,Q5TW24,U5HIG6,A0A401PRI6,Q96J94,A0A2B4RHN2,G2QEV0,A0A397UU01,A0A2T7PFL8,K7ISV0,A0A024FT57,H3HCL6,A0A0G4IME3,E9FUN9,A0A1S3CYL5,D7FQK3,A0A1Y1YHC8,T1GSU4,F4S231,A0A1D8PMK0,A0A2G5B1D8,A0A1C7M8P2,A0A4D8YSQ3,A0A158PJG6,J9JZ66,A0A0C2XG51,A0A158QZT6,A0A165QYQ9,T0SAU8,R7YY92,A0A3S1A0C3,A0A074YJ47,A0A2K1J482,A0A1Q3ENA6,O04379,A0A371I3C8,M8AEW7,A8P0D4,A0A2K3NY65,F4NYW7,A0A409Y6G2,A0A0L0HAB7,D8PZT7,A0A1D1W4K0,A7RQ46,W4YU94,A7BJS5,D8SNM6,A0A1J8PPA3,X1WG39,Q69VD5,A0A2R6NSC2,A0A0D8XL16,A0A016WPN3,Q9QZ81,G5EES3,A0A0K0EFP6,Q8CJG0,A0A1D5NTU6,V2WTL2,A0A0V0YLH8,A0A139WDH0,A0A0R3W9Q7,H3DS31,A0A1Y1HWP2,G4T5G9,B7QCC4,A0A0B2UV00,M7BCJ9,E9GN30,Q7PZ41,A0A077Z361,R7U9I3,A0A1X7V1N5,A0A0K0JDP1,A0A0N4UKJ1,A0A498N3A3,A0A3M0IQP5,A0A0L8GBV4,Q32KD4,A0A1J1JBJ0,E0W4C3,A0A482XDA9,J9K2Z4,A0A2J7Q8V4,T1IBM6,V3ZRX0,A0A210QKF7,A0A423TSS1,K1PT78,A0A267E8R7,A0A1D2N447,A0A226D7A9,F6YK55,T1KTE4,A0A2C9JGZ6,A0A1V9X9F0,K5X5Z7,A0A3Q0KUG5,T1FY40,1YVU,1Z26,5AWH,5G5T,6QZK,E8N0K8,E0ST67,C4L1M1,A0A0M2PXX3,A0A1C0UUC4,A0A0F4NXW8,A0A142XB92,L8D0R3,A0A097QRL6,A0A1T4Y3A2,Q5P0R2,B6YTQ5,A0A0B0H9B4,R6KUL9,B7GJX9,A0A0P6X5X2,A0A2Z6E0R7,A0A1N6SSK9,A0A2G9DT08,Q9L1X1,A0A060HNJ0,A0A235B542,R5XQK4,A0A496APJ8,A0A1V9G9U4,S7VLM7,A0A1A5X8H4,A0A1I2T6Q1,A0A1R3T9N6,A0A0Q2M2Z1,H8KXJ0,D3S0S6,A0A2D1U4H7,I3TE64,A0A0B7I4Z6,A0LL61,A0A139WY18,A0A2T1E1K4,A0A1Q8ZD62,A0A4Q6XKV6,A0A1Z3HNN4,A0A239JE83,A0A2N4XBY2,R5JEI2,A0A0Q0ZC47,A0A2T0XH18,A0A1V4CHV0,A0A1K1RQP7,A0A1N6LUI7,A0A0P0NGR6,A0A1X7IML5,A0A0A2LKJ7,K1L112,A0A0U3AL92,A0A1H3A054,B9LVW4,A0A0C5JKF3,R5NJJ8,A5D4D9,A0A142Y7A9,A0A432MEQ5,A0A372DKU2,A0A3R7KLK4,C1F5Q7,A0A4R3EV39,A0A1P8WP90,A0A222F7P0,A0A1C9VH88,A0A2T2YMB1,A0A329TD61,A0A101R2A0,A0A1E3XF49,A0A1U9ND56,A0A4R7BQC4,A0A1H3DGN3,A0A1Q1FPH0,E0TGY3,A0A259TUP4,F6EYI8,A0A2S9Q9J0,A0A4Q2UIU6,A0A1H0LH25,A0A318LG42,H1YCU5,A0A1Q5ZS75,A0A345E7N0,M0AF24,A0A1W2A082,A0A1H3X247,A0A0C1XUA0,M0D2X3,A0A2R5G167,A0A346PK63,R7RTW6,A0A1H2RBI2,A0A1C3ZXN2,B9LVP8,M5RSF0,B7K585,F8D8G0,A0A343TL88,L0AJX6,A0A2A5QS34,A0A343JEE2,A0A3P3RGE5,A0A285N2A8,A0A0W1S8B8,A0A1V4C8L7,L9VRQ2,A0A1I0NI68,,",366,37
"584","C.H7.2","C.H7.4",288,161,127,1.98902039418986,"4F1N,4F3T,4KRE,5GUH,5VM9,6KR6,6OON,7KX7,7SWF,A0A163JTZ6,J9D5G4,C4LVV2,A0A2P6N8X7,A8BCK6,A2DPV7,A0A0G4H2S4,T1H8B3,R1FDF0,S4RWI0,D2VMG4,A0A074TLL7,F4PH46,A0A3M7S814,A0A383WDW5,Q54G64,S7WCF7,R7QGN7,C1DZY0,A0CB11,R9ACY5,D3BMP8,W7XD45,A0A1U7LLR0,K1VVQ6,A0A158P1R9,G7DVX0,E3KLI3,B7Q5I1,A0A139AUH8,L2GMR6,A0A177URI1,O74957,A6N7Y9,T1KZ60,A0A250WXN5,A0A2G8JLH3,Q5KAT1,L2GUF2,W2T741,A0A1W0E4B5,A0A2J7QB22,A0A2K3CW87,A0A226EFL3,A0A3S3PD82,A0A0L0TEV1,A0A1S3J512,G0QTT2,A0A1J1HRI1,C4V9J2,Q9JMB7,A0A075AN09,Q5TW24,U5HIG6,A0A401PRI6,Q96J94,A0A2B4RHN2,A0A397UU01,A0A2T7PFL8,K7ISV0,A0A024FT57,H3HCL6,A0A0G4IME3,E9FUN9,A0A1S3CYL5,D7FQK3,A0A1Y1YHC8,T1GSU4,A0A1D8PMK0,A0A2G5B1D8,Q5BD61,A0A1C7M8P2,A0A4D8YSQ3,A0A158PJG6,J9JZ66,A0A0C2XG51,A0A158QZT6,A0A165QYQ9,T0SAU8,R7YY92,A0A3S1A0C3,A0A074YJ47,A0A2K1J482,A0A1Q3ENA6,O04379,A0A371I3C8,M8AEW7,A8P0D4,A0A2K3NY65,F4NYW7,A0A409Y6G2,A0A0L0HAB7,D8PZT7,A0A1D1W4K0,A7RQ46,W4YU94,A7BJS5,D8SNM6,A0A1J8PPA3,X1WG39,M5FQK2,Q69VD5,A0A2R6NSC2,A0A0D8XL16,A0A016WPN3,Q9QZ81,G5EES3,A0A0K0EFP6,Q8CJG0,A0A1D5NTU6,V2WTL2,A0A0V0YLH8,A0A139WDH0,A0A0R3W9Q7,H3DS31,A0A1Y1HWP2,G4T5G9,B7QCC4,A0A0B2UV00,M7BCJ9,E9GN30,Q7PZ41,A0A077Z361,R7U9I3,A0A1X7V1N5,A0A0K0JDP1,A0A0N4UKJ1,A0A498N3A3,A0A3M0IQP5,A0A0L8GBV4,Q32KD4,A0A1J1JBJ0,E0W4C3,A0A482XDA9,A0A3P7EJD6,J9K2Z4,A0A2J7Q8V4,T1IBM6,V3ZRX0,A0A210QKF7,A0A423TSS1,K1PT78,A0A267E8R7,A0A1D2N447,A0A226D7A9,F6YK55,T1KTE4,A0A2C9JGZ6,A0A1V9X9F0,K5X5Z7,A0A3Q0KUG5,T1FY40,1YVU,1Z26,3DLB,5AWH,5G5T,5I4A,6QZK,7R8K,E8N0K8,A0A328VKE4,C4L1M1,A0A4R1RMM2,A0A1Y2RDH8,Q11QW7,A0A1M5ZSR3,A0A0K8QX04,A0A0M2PXX3,A0A1I3LMA1,K9TPA9,A0A1C0UUC4,A0A2U2J9E0,A0A2Z6E1D5,A0A0F4NXW8,L8D0R3,B1XJG0,A0A3D8L290,A0A1Q4R485,K9U8J6,A0A097QRL6,K9RC91,A0A0D8ZUC0,A0A139XGN8,A0A1T4Y3A2,Q5P0R2,B6YTQ5,A0A0B0H9B4,A0YYT3,A0A2T1EFY0,G6FTN0,R6KUL9,A0A433NB65,A0A1Z4L0A1,K9UQR0,A0A2T1G8M7,K9VUN0,B7GJX9,A0A0P6X5X2,K9ZDE3,B0JXD6,A0A2T1LS63,A0A1Z4K1Y3,A0A2Z6E0R7,A0A1N6SSK9,A0A0P4UVI8,A0A0V7ZCG4,A0A1J0AGK2,K9PFF9,K9UEV4,A0A060HNJ0,A0A235B542,R5XQK4,A0A1H3LE92,A0A496APJ8,A0A062U2W9,H0HWQ5,A0A1V9G9U4,A0A1I2ZGP1,A0A317EJY3,A0A1I2BD20,F8ERC7,A0A1A5X8H4,A0A0Q2M2Z1,A0A2D1U4H7,I3TE64,A0A0B7I4Z6,A0LL61,Q8DKB1,A0A139WY18,A0A1J1EK56,A0A2T1E1K4,A0A1Q8ZD62,A0A1Z3HNN4,Q53W94,A0A2T0XH18,A0A2T1EKT1,A0A0A2LKJ7,K1L112,E0UCX3,K9XZC6,A0A0C1VHB4,Q31N05,R5NJJ8,A5D4D9,Q2JI93,A0A3R7KLK4,C1F5Q7,A0A4R3EV39,A0A329TD61,A0A1E3XF49,A0A1H3DGN3,A0A1Q1FPH0,E0TGY3,F6EYI8,A0A2S9Q9J0,H1YCU5,A0A1Q5ZS75,A0A345E7N0,A0A1W2A082,A0A1H3X247,A0A0C1XUA0,A0A346PK63,R7RTW6,A0A1H2RBI2,A0A1C3ZXN2,B9LVP8,M5RSF0,W0JW77,A0A343TL88,L0AJX6,A0A343JEE2,A0A3P3RGE5,A0A329TBQ3,A0A285N2A8,A0A0W1S8B8,L9VRQ2,E4NRV1,A0A1I6HGN0,,",366,37
"585","C.H7.2","C.H7.5",280,161,119,2.53562294483011,"4F1N,4F3T,4KRE,5VM9,6KR6,6OON,7KX7,7SWF,A0A163JTZ6,A0A196SDB4,J9D5G4,C4LVV2,A0A2P6N8X7,A8BCK6,A2DPV7,A0A0G4H2S4,T1H8B3,R1FDF0,S4RWI0,D2VMG4,A0A074TLL7,F4PH46,A0A3M7S814,A0A383WDW5,Q54G64,S7WCF7,R7QGN7,C1DZY0,A0CB11,R9ACY5,D3BMP8,W7XD45,A0A1U7LLR0,K1VVQ6,A0A158P1R9,G7DVX0,E3KLI3,B7Q5I1,A0A139AUH8,L2GMR6,A0A177URI1,O74957,A6N7Y9,T1KZ60,A0A250WXN5,A0A2G8JLH3,Q5KAT1,L2GUF2,W2T741,A0A1W0E4B5,A0A2J7QB22,A0A2K3CW87,A0A226EFL3,A0A3S3PD82,A0A0L0TEV1,A0A1S3J512,G0QTT2,A0A1J1HRI1,C4V9J2,Q9JMB7,A0A075AN09,Q5TW24,U5HIG6,A0A401PRI6,Q96J94,A0A2B4RHN2,A0A397UU01,A0A2T7PFL8,K7ISV0,A0A024FT57,H3HCL6,A0A0G4IME3,E9FUN9,A0A1S3CYL5,D7FQK3,A0A1Y1YHC8,T1GSU4,A0A1D8PMK0,A0A2G5B1D8,Q5BD61,A0A1C7M8P2,A0A4D8YSQ3,A0A158PJG6,J9JZ66,A0A0C2XG51,A0A158QZT6,A0A165QYQ9,T0SAU8,R7YY92,A0A3S1A0C3,A0A074YJ47,A0A2K1J482,A0A1Q3ENA6,O04379,A0A371I3C8,M8AEW7,A8P0D4,A0A2K3NY65,F4NYW7,A0A409Y6G2,A0A0L0HAB7,D8PZT7,A0A1D1W4K0,A7RQ46,W4YU94,A7BJS5,D8SNM6,A0A1J8PPA3,X1WG39,M5FQK2,Q69VD5,A0A2R6NSC2,A0A0D8XL16,A0A016WPN3,Q9QZ81,G5EES3,A0A0K0EFP6,Q8CJG0,A0A1D5NTU6,V2WTL2,A0A0V0YLH8,A0A139WDH0,A0A0R3W9Q7,H3DS31,A0A1Y1HWP2,G4T5G9,B7QCC4,A0A0B2UV00,M7BCJ9,E9GN30,Q7PZ41,A0A077Z361,R7U9I3,A0A1X7V1N5,A0A0K0JDP1,A0A0N4UKJ1,A0A498N3A3,A0A3M0IQP5,A0A0L8GBV4,Q32KD4,A0A1J1JBJ0,E0W4C3,A0A482XDA9,A0A3P7EJD6,J9K2Z4,A0A2J7Q8V4,T1IBM6,V3ZRX0,A0A210QKF7,A0A423TSS1,K1PT78,A0A267E8R7,A0A1D2N447,A0A226D7A9,F6YK55,T1KTE4,A0A2C9JGZ6,A0A1V9X9F0,K5X5Z7,A0A3Q0KUG5,T1FY40,1YVU,1Z26,3DLB,5AWH,5G5T,5I4A,6QZK,E8N0K8,A0A328VKE4,C4L1M1,A0A4R1RMM2,A0A1Y2RDH8,Q11QW7,A0A1M5ZSR3,A0A0K8QX04,A0A0M2PXX3,A0A1I3LMA1,K9TPA9,A0A2U2J9E0,A0A2Z6E1D5,A0A0F4NXW8,L8D0R3,B1XJG0,A0A3D8L290,A0A1Q4R485,K9U8J6,A0A097QRL6,K9RC91,A0A0D8ZUC0,A0A139XGN8,A0A1T4Y3A2,Q5P0R2,B6YTQ5,A0A0B0H9B4,A0YYT3,A0A2T1EFY0,G6FTN0,R6KUL9,A0A433NB65,A0A1Z4L0A1,K9UQR0,A0A2T1G8M7,K9VUN0,B7GJX9,A0A0P6X5X2,K9ZDE3,B0JXD6,A0A2T1LS63,A0A1Z4K1Y3,A0A2Z6E0R7,A0A1N6SSK9,A0A0P4UVI8,A0A0V7ZCG4,A0A1J0AGK2,K9PFF9,K9UEV4,A0A060HNJ0,A0A235B542,R5XQK4,A0A1H3LE92,A0A496APJ8,A0A062U2W9,H0HWQ5,A0A1V9G9U4,A0A1I2ZGP1,A0A317EJY3,A0A1I2BD20,F8ERC7,A0A0Q2M2Z1,A0A2D1U4H7,I3TE64,A0LL61,Q8DKB1,A0A139WY18,A0A1J1EK56,A0A2T1E1K4,A0A1Q8ZD62,A0A1Z3HNN4,Q53W94,A0A2T0XH18,A0A2T1EKT1,K1L112,E0UCX3,K9XZC6,A0A0C1VHB4,Q31N05,R5NJJ8,A5D4D9,Q2JI93,A0A3R7KLK4,A0A329TD61,A0A1E3XF49,A0A1H3DGN3,A0A1Q1FPH0,E0TGY3,A0A2S9Q9J0,H1YCU5,A0A1Q5ZS75,A0A345E7N0,A0A1W2A082,A0A1H3X247,A0A0C1XUA0,A0A346PK63,R7RTW6,A0A1H2RBI2,A0A1C3ZXN2,B9LVP8,M5RSF0,W0JW77,A0A343TL88,L0AJX6,A0A343JEE2,A0A3P3RGE5,A0A329TBQ3,A0A285N2A8,A0A0W1S8B8,L9VRQ2,E4NRV1,A0A1I6HGN0,,",366,37
"586","C.H7.4","C.H7.6",306,161,145,1.95240950953095,"4F1N,4F3T,4KRE,5GUH,5VM9,6KR6,6OON,7KX7,A0A163JTZ6,J9D5G4,Q389P5,C4LVV2,A0A2P6N8X7,A8BCK6,A2DPV7,A0A0G4H2S4,T1H8B3,R1FDF0,S4RWI0,D2VMG4,A0A074TLL7,F4PH46,A0A3M7S814,A0A383WDW5,Q54G64,S7WCF7,R7QGN7,C1DZY0,A0CB11,R9ACY5,D3BMP8,W7XD45,A0A1U7LLR0,K1VVQ6,A0A158P1R9,G7DVX0,E3KLI3,B7Q5I1,A0A139AUH8,L2GMR6,A0A177URI1,O74957,A6N7Y9,T1KZ60,A0A250WXN5,A0A2G8JLH3,Q5KAT1,L2GUF2,W2T741,A0A1W0E4B5,A0A2J7QB22,A0A2K3CW87,A0A226EFL3,A0A3S3PD82,A0A0L0TEV1,A0A1S3J512,G0QTT2,A0A1J1HRI1,C4V9J2,Q9JMB7,A0A075AN09,Q5TW24,U5HIG6,A0A401PRI6,Q96J94,A0A2B4RHN2,A0A397UU01,A0A2T7PFL8,K7ISV0,A0A024FT57,H3HCL6,A0A0G4IME3,E9FUN9,A0A1S3CYL5,D7FQK3,A0A1Y1YHC8,T1GSU4,A0A1D8PMK0,A0A2G5B1D8,Q5BD61,A0A1C7M8P2,A0A4D8YSQ3,A0A158PJG6,J9JZ66,A0A0C2XG51,A0A158QZT6,A0A165QYQ9,T0SAU8,R7YY92,A0A3S1A0C3,A0A074YJ47,A0A2K1J482,A0A1Q3ENA6,O04379,A0A371I3C8,M8AEW7,A8P0D4,A0A2K3NY65,F4NYW7,A0A409Y6G2,A0A0L0HAB7,D8PZT7,A0A1D1W4K0,A7RQ46,W4YU94,A7BJS5,D8SNM6,A0A1J8PPA3,X1WG39,M5FQK2,Q69VD5,A0A2R6NSC2,A0A0D8XL16,A0A016WPN3,Q9QZ81,G5EES3,A0A0K0EFP6,Q8CJG0,A0A1D5NTU6,V2WTL2,A0A0V0YLH8,A0A139WDH0,A0A0R3W9Q7,H3DS31,A0A1Y1HWP2,G4T5G9,B7QCC4,A0A0B2UV00,M7BCJ9,E9GN30,Q7PZ41,A0A077Z361,R7U9I3,A0A1X7V1N5,A0A0K0JDP1,A0A0N4UKJ1,A0A498N3A3,A0A3M0IQP5,A0A0L8GBV4,Q32KD4,A0A1J1JBJ0,E0W4C3,A0A482XDA9,A0A3P7EJD6,J9K2Z4,A0A2J7Q8V4,T1IBM6,V3ZRX0,A0A210QKF7,A0A423TSS1,K1PT78,A0A267E8R7,A0A1D2N447,A0A226D7A9,F6YK55,T1KTE4,A0A2C9JGZ6,A0A1V9X9F0,K5X5Z7,A0A3Q0KUG5,T1FY40,1YVU,1Z26,3DLB,5AWH,5G5T,5I4A,6QZK,7R8K,E8N0K8,A0A328VKE4,C4L1M1,A0A4R1RMM2,A0A1Y2RDH8,Q11QW7,A0A1M5ZSR3,A0A0K8QX04,A0A0M2PXX3,A0A1I3LMA1,K9TPA9,A0A1L3JHM3,A0A1W6MIP2,A0A1C0UUC4,A0A2U2J9E0,A0A2Z6E1D5,A0A0F4NXW8,L8D0R3,B1XJG0,A0A326U7G5,A0A3D8L290,A0A1Q4R485,K9U8J6,A0A097QRL6,K9RC91,A0A0D8ZUC0,A0A139XGN8,A0A1T4Y3A2,Q5P0R2,B6YTQ5,A0A0B0H9B4,A0YYT3,A0A2T1EFY0,G6FTN0,R6KUL9,A0A433NB65,A0A1Z4L0A1,K9UQR0,A0A2T1G8M7,K9VUN0,B7GJX9,A0A0P6X5X2,K9ZDE3,B0JXD6,A0A2T1LS63,A0A1Z4K1Y3,A0A2Z6E0R7,A0A1N6SSK9,A0A0P4UVI8,A0A0V7ZCG4,A0A1J0AGK2,K9PFF9,A0A2G9DT08,K9UEV4,A0A060HNJ0,A0A235B542,R5XQK4,A0A1H3LE92,A0A496APJ8,A0A062U2W9,H0HWQ5,A0A1V9G9U4,A0A1I2ZGP1,A0A317EJY3,A0A1I2BD20,F8ERC7,A0A1A5X8H4,A0A1I2T6Q1,A0A0Q2M2Z1,H8KXJ0,A0A2D1U4H7,I3TE64,A0A0B7I4Z6,A0LL61,Q8DKB1,A0A139WY18,A0A1J1EK56,A0A2T1E1K4,A0A1Q8ZD62,A0A4Q6XKV6,A0A1Z3HNN4,A0A2N4XBY2,Q53W94,R5JEI2,A0A2T0XH18,A0A1K1RQP7,A0A2T1EKT1,A0A1N6LUI7,A0A0P0NGR6,A0A0A2LKJ7,K1L112,E0UCX3,K9XZC6,A0A0C1VHB4,Q31N05,R5NJJ8,A5D4D9,Q2JI93,A0A3R7KLK4,C1F5Q7,A0A4R3EV39,A0A222F7P0,A0A2T2YMB1,A0A329TD61,A0A1E3XF49,A0A1H3DGN3,A0A1Q1FPH0,E0TGY3,F6EYI8,A0A2S9Q9J0,H1YCU5,L0JS08,A0A1Q5ZS75,A0A345E7N0,M0AF24,A0A1W2A082,A0A1H3X247,A0A0C1XUA0,M0D2X3,A0A346PK63,R7RTW6,A0A1H2RBI2,A0A1C3ZXN2,B9LVP8,M5RSF0,W0JW77,A0A343TL88,L0AJX6,A0A2A5QS34,A0A343JEE2,A0A3P3RGE5,A0A329TBQ3,A0A285N2A8,A0A0W1S8B8,L9VRQ2,E4NRV1,A0A1I6HGN0,,",366,37
"587","C.S1.1","C.S7.1",320,161,159,2.26667057306926,"4F1N,4KRE,5VM9,6KR6,6OON,7KX7,7SWF,A0A163JTZ6,J9D5G4,Q389P5,T1H8B3,R1FDF0,S4RWI0,D2VMG4,A0A074TLL7,A0A0D1ZAJ4,Q1K660,F4PH46,A0A3M7S814,A0A164ZA52,A0A383WDW5,Q54G64,S7WCF7,I0YVB2,R7QGN7,C1DZY0,A0A2C5Z0M1,A0CB11,R9ACY5,D3BMP8,A0A1Z5TVE5,W7XD45,A0A1U7LLR0,A0A4S2MWZ7,K1VVQ6,G7DVX0,G4N9J3,E3KLI3,B7Q5I1,A0A1E3QC61,D5GGK8,S8ANP9,A0A139AUH8,L2GMR6,U4LBG4,O74957,A0A3N4IGK1,A6N7Y9,A0A0E9NDK5,T1KZ60,A0A250WXN5,A0A2G8JLH3,Q5KAT1,L2GUF2,W2T741,A0A1W0E4B5,A0A2J7QB22,S4RYE2,A0A2K3CW87,A0A388KES6,A0A0L0TEV1,A0A1S3J512,G0QTT2,A0A1J1HRI1,C4V9J2,A0A075AN09,A0A401PRI6,G2QEV0,A0A397UU01,A0A2T7PFL8,K7ISV0,A0A024FT57,H3HCL6,A0A0G4IME3,E9FUN9,A0A1S3CYL5,D7FQK3,T1GSU4,F4S231,A0A1D8PMK0,A0A2G5B1D8,Q5BD61,A0A1C7M8P2,A0A4D8YSQ3,A0A158PJG6,J9JZ66,A0A0C2XG51,A0A158QZT6,A0A165QYQ9,T0SAU8,R7YY92,A0A3S1A0C3,A0A074YJ47,A0A2K1J482,A0A1Q3ENA6,O04379,A0A371I3C8,M8AEW7,A8P0D4,A0A2K3NY65,A0A409Y6G2,D8PZT7,A0A1D1W4K0,A7RQ46,W4YU94,A7BJS5,D8SNM6,A0A1J8PPA3,X1WG39,M5FQK2,Q69VD5,A0A2R6NSC2,A0A0D8XL16,A0A016WPN3,Q9QZ81,G5EES3,A0A0K0EFP6,Q8CJG0,A0A1D5NTU6,V2WTL2,A0A0V0YLH8,A0A139WDH0,A0A0R3W9Q7,H3DS31,A0A1Y1HWP2,G4T5G9,B7QCC4,A0A0B2UV00,M7BCJ9,E9GN30,Q7PZ41,A0A077Z361,R7U9I3,A0A1X7V1N5,A0A0K0JDP1,A0A0N4UKJ1,A0A498N3A3,A0A3M0IQP5,A0A0L8GBV4,Q32KD4,A0A1J1JBJ0,E0W4C3,A0A482XDA9,A0A3P7EJD6,J9K2Z4,A0A2J7Q8V4,T1IBM6,V3ZRX0,A0A210QKF7,A0A423TSS1,K1PT78,A0A267E8R7,A0A1D2N447,A0A226D7A9,F6YK55,T1KTE4,A0A2C9JGZ6,A0A1V9X9F0,K5X5Z7,A0A3Q0KUG5,T1FY40,1YVU,5AWH,5G5T,6QZK,A0A1I7IXT4,A0A2W1JZ37,A0A2S7WBN3,A0A420DFE6,E0ST67,A0A4V1VDY2,A0A368P5I0,C4L1M1,A0A4R1RMM2,A0A1Y2RDH8,Q11QW7,A0A1M5ZSR3,A0A0K8QX04,A0A1I3LMA1,K9TPA9,A0A1L3JHM3,A0A1W6MIP2,A0A2U2J9E0,A0A2Z6E1D5,A0A0F4NXW8,L8D0R3,B1XJG0,A0A3D8L290,A0A1Q4R485,K9U8J6,K9RC91,A0A0D8ZUC0,A0A139XGN8,A0A1T4Y3A2,Q5P0R2,A0A0B0H9B4,A0YYT3,A0A2T1EFY0,G6FTN0,R6KUL9,A0A433NB65,A0A1Z4L0A1,K9UQR0,A0A2T1G8M7,K9VUN0,B7GJX9,K9ZDE3,B0JXD6,A0A2T1LS63,A0A1Z4K1Y3,A0A2Z6E0R7,A0A1N6SSK9,A0A0P4UVI8,A0A0V7ZCG4,A0A1J0AGK2,K9PFF9,A0A2G9DT08,K9UEV4,Q9L1X1,A0A235B542,R5XQK4,A0A1H3LE92,A0A496APJ8,A0A062U2W9,H0HWQ5,A0A1V9G9U4,A0A1I2ZGP1,A0A317EJY3,A0A1I2BD20,F8ERC7,A0A1A5X8H4,A0A1I2T6Q1,A0A1R3T9N6,H8KXJ0,A0A2D1U4H7,A0LL61,Q8DKB1,A0A139WY18,A0A1J1EK56,A0A2T1E1K4,A0A1Q8ZD62,A0A4Q6XKV6,A0A1Z3HNN4,Q53W94,A0A2T0XH18,A0A1V4CHV0,A0A1K1RQP7,A0A2T1EKT1,A0A1N6LUI7,A0A0P0NGR6,A0A1X7IML5,A0A0A2LKJ7,K1L112,A0A0U3AL92,A0A1H3A054,E0UCX3,K9XZC6,B9LVW4,A0A0C1VHB4,Q31N05,A0A0C5JKF3,R5NJJ8,A5D4D9,Q2JI93,A0A142Y7A9,A0A432MEQ5,A0A372DKU2,A0A3R7KLK4,C1F5Q7,A0A4R3EV39,A0A1P8WP90,A0A222F7P0,A0A1C9VH88,A0A2T2YMB1,A0A329TD61,A0A101R2A0,A0A1E3XF49,A0A1U9ND56,A0A4R7BQC4,A0A1H3DGN3,A0A1Q1FPH0,E0TGY3,A0A259TUP4,F6EYI8,A0A2S9Q9J0,A0A4Q2UIU6,A0A1H0LH25,A0A318LG42,H1YCU5,L0JS08,A0A1Q5ZS75,A0A345E7N0,M0AF24,A0A1W2A082,A0A1H3X247,A0A0C1XUA0,M0D2X3,A0A2R5G167,A0A346PK63,R7RTW6,A0A1H2RBI2,A0A1C3ZXN2,B9LVP8,M5RSF0,W0JW77,B7K585,F8D8G0,A0A343TL88,L0AJX6,A0A2A5QS34,A0A343JEE2,A0A3P3RGE5,A0A329TBQ3,A0A285N2A8,A0A0W1S8B8,A0A1V4C8L7,L9VRQ2,E4NRV1,A0A1I6HGN0,A0A1I0NI68,,",366,37
"589","C.S5.6","C.S6.6",291,161,130,2.20797897754419,"4F1N,4F3T,4KRE,5GUH,5VM9,6KR6,6OON,7KX7,7SWF,A0A163JTZ6,J9D5G4,A2DPV7,T1H8B3,S4RWI0,D2VMG4,A0A0D1ZAJ4,Q1K660,F4PH46,A0A3M7S814,A0A164ZA52,A0A383WDW5,Q54G64,S7WCF7,R7QGN7,A0A2C5Z0M1,A0CB11,R9ACY5,D3BMP8,A0A1Z5TVE5,A0A1U7LLR0,A0A4S2MWZ7,K1VVQ6,A0A158P1R9,G7DVX0,V6R0U9,G4N9J3,E3KLI3,B7Q5I1,A0A1E3QC61,D5GGK8,S8ANP9,A0A139AUH8,L2GMR6,U4LBG4,A0A177URI1,O74957,A0A3N4IGK1,A6N7Y9,A0A0E9NDK5,T1KZ60,A0A250WXN5,A0A2G8JLH3,Q5KAT1,L2GUF2,W2T741,A0A1W0E4B5,A0A2J7QB22,S4RYE2,A0A2K3CW87,A0A388KES6,A0A226EFL3,A0A3S3PD82,A0A0L0TEV1,A0A1S3J512,A0A1J1HRI1,C4V9J2,Q9JMB7,Q5TW24,A0A401PRI6,Q96J94,A0A2B4RHN2,G2QEV0,A0A397UU01,A0A2T7PFL8,K7ISV0,A0A024FT57,H3HCL6,A0A0G4IME3,A0A1S3CYL5,D7FQK3,A0A1Y1YHC8,F4S231,A0A1D8PMK0,A0A2G5B1D8,Q5BD61,A0A1C7M8P2,A0A4D8YSQ3,A0A158PJG6,J9JZ66,A0A158QZT6,A0A165QYQ9,T0SAU8,R7YY92,A0A3S1A0C3,A0A074YJ47,A0A2K1J482,A0A1Q3ENA6,O04379,A0A371I3C8,M8AEW7,A0A2K3NY65,F4NYW7,A0A409Y6G2,A0A0L0HAB7,D8PZT7,A0A1D1W4K0,A7RQ46,W4YU94,A7BJS5,D8SNM6,X1WG39,Q69VD5,A0A2R6NSC2,A0A0D8XL16,A0A016WPN3,Q9QZ81,G5EES3,A0A0K0EFP6,Q8CJG0,A0A1D5NTU6,A0A0V0YLH8,A0A139WDH0,A0A0R3W9Q7,H3DS31,A0A1Y1HWP2,G4T5G9,B7QCC4,A0A0B2UV00,M7BCJ9,E9GN30,Q7PZ41,A0A077Z361,R7U9I3,A0A1X7V1N5,A0A0K0JDP1,A0A0N4UKJ1,A0A498N3A3,A0A3M0IQP5,A0A0L8GBV4,Q32KD4,A0A1J1JBJ0,E0W4C3,A0A482XDA9,A0A3P7EJD6,J9K2Z4,A0A2J7Q8V4,T1IBM6,V3ZRX0,A0A210QKF7,A0A423TSS1,K1PT78,A0A267E8R7,A0A1D2N447,A0A226D7A9,F6YK55,T1KTE4,A0A2C9JGZ6,A0A1V9X9F0,K5X5Z7,A0A3Q0KUG5,T1FY40,1YVU,1Z26,3DLB,5AWH,5I4A,7R8K,E8N0K8,A0A328VKE4,E0ST67,Q11QW7,A0A0M2PXX3,K9TPA9,A0A1C0UUC4,A0A2Z6E1D5,A0A142XB92,L8D0R3,A0A326U7G5,A0A3D8L290,A0A1Q4R485,K9U8J6,K9RC91,A0A0D8ZUC0,A0A139XGN8,A0A1T4Y3A2,A0YYT3,A0A2T1EFY0,G6FTN0,A0A433NB65,A0A1Z4L0A1,K9UQR0,A0A2T1G8M7,K9VUN0,A0A0P6X5X2,K9ZDE3,B0JXD6,A0A2T1LS63,A0A1Z4K1Y3,A0A0P4UVI8,A0A0V7ZCG4,A0A1J0AGK2,K9PFF9,A0A2G9DT08,K9UEV4,Q9L1X1,A0A1H3LE92,A0A496APJ8,A0A062U2W9,H0HWQ5,A0A1I2ZGP1,A0A317EJY3,A0A1I2BD20,F8ERC7,S7VLM7,A0A1A5X8H4,A0A1I2T6Q1,A0A1R3T9N6,A0A0Q2M2Z1,H8KXJ0,A0A2D1U4H7,A0A0B7I4Z6,A0LL61,A0A139WY18,A0A1J1EK56,A0A1Q8ZD62,A0A4Q6XKV6,A0A1Z3HNN4,A0A239JE83,A0A2N4XBY2,Q53W94,R5JEI2,A0A0Q0ZC47,A0A2T0XH18,A0A1V4CHV0,A0A1K1RQP7,A0A1N6LUI7,A0A0P0NGR6,A0A1X7IML5,A0A0A2LKJ7,K1L112,A0A0U3AL92,A0A1H3A054,A0A0C5JKF3,R5NJJ8,A5D4D9,A0A142Y7A9,A0A432MEQ5,A0A372DKU2,A0A3R7KLK4,C1F5Q7,A0A4R3EV39,A0A1P8WP90,A0A222F7P0,A0A1C9VH88,A0A2T2YMB1,A0A101R2A0,A0A1E3XF49,A0A1U9ND56,A0A4R7BQC4,A0A1H3DGN3,A0A1Q1FPH0,E0TGY3,A0A259TUP4,F6EYI8,A0A2S9Q9J0,A0A4Q2UIU6,A0A1H0LH25,A0A318LG42,L0JS08,M0AF24,A0A1H3X247,M0D2X3,A0A2R5G167,A0A346PK63,B9LVP8,M5RSF0,W0JW77,B7K585,F8D8G0,A0A343TL88,L0AJX6,A0A2A5QS34,A0A343JEE2,A0A3P3RGE5,A0A329TBQ3,A0A0W1S8B8,A0A1V4C8L7,L9VRQ2,E4NRV1,A0A1I6HGN0,A0A1I0NI68,,",366,37
"604","N.S3.5","N.S7.7",212,162,50,4.31283950617284,"4F1N,4F3T,4KRE,5GUH,5VM9,6OON,A2DPV7,T1H8B3,S4RWI0,D2VMG4,A0A0D1ZAJ4,Q1K660,F4PH46,A0A164ZA52,Q54G64,S7WCF7,I0YVB2,C1DZY0,A0A2C5Z0M1,A0CB11,R9ACY5,D3BMP8,A0A1Z5TVE5,W7XD45,A0A1U7LLR0,A0A4S2MWZ7,K1VVQ6,A0A158P1R9,G7DVX0,V6R0U9,G4N9J3,E3KLI3,B7Q5I1,A0A1E3QC61,D5GGK8,S8ANP9,A0A139AUH8,L2GMR6,U4LBG4,A0A177URI1,O74957,A0A3N4IGK1,A6N7Y9,A0A0E9NDK5,T1KZ60,A0A250WXN5,A0A2G8JLH3,Q5KAT1,L2GUF2,A0A1W0E4B5,A0A2J7QB22,S4RYE2,A0A2K3CW87,A0A388KES6,A0A226EFL3,A0A3S3PD82,A0A0L0TEV1,A0A1S3J512,G0QTT2,A0A1J1HRI1,C4V9J2,Q9JMB7,A0A075AN09,Q5TW24,U5HIG6,A0A401PRI6,Q96J94,A0A2B4RHN2,A0A397UU01,K7ISV0,A0A024FT57,H3HCL6,E9FUN9,A0A1S3CYL5,D7FQK3,A0A1Y1YHC8,T1GSU4,F4S231,A0A1D8PMK0,A0A2G5B1D8,Q5BD61,A0A1C7M8P2,A0A4D8YSQ3,A0A158PJG6,J9JZ66,A0A0C2XG51,A0A158QZT6,A0A165QYQ9,T0SAU8,R7YY92,A0A3S1A0C3,A0A074YJ47,A0A2K1J482,A0A1Q3ENA6,O04379,A0A371I3C8,M8AEW7,A8P0D4,A0A2K3NY65,F4NYW7,A0A409Y6G2,A0A0L0HAB7,D8PZT7,A0A1D1W4K0,A7RQ46,W4YU94,A7BJS5,D8SNM6,A0A1J8PPA3,X1WG39,M5FQK2,Q69VD5,A0A2R6NSC2,A0A0D8XL16,A0A016WPN3,Q9QZ81,G5EES3,A0A0K0EFP6,Q8CJG0,A0A1D5NTU6,V2WTL2,A0A0V0YLH8,A0A139WDH0,A0A0R3W9Q7,H3DS31,A0A1Y1HWP2,G4T5G9,B7QCC4,A0A0B2UV00,M7BCJ9,E9GN30,Q7PZ41,A0A077Z361,R7U9I3,A0A1X7V1N5,A0A0K0JDP1,A0A0N4UKJ1,A0A498N3A3,A0A3M0IQP5,A0A0L8GBV4,Q32KD4,A0A1J1JBJ0,E0W4C3,A0A482XDA9,A0A3P7EJD6,J9K2Z4,A0A2J7Q8V4,T1IBM6,V3ZRX0,A0A210QKF7,A0A423TSS1,K1PT78,A0A267E8R7,A0A1D2N447,A0A226D7A9,F6YK55,T1KTE4,A0A2C9JGZ6,A0A1V9X9F0,K5X5Z7,A0A3Q0KUG5,T1FY40,1Z26,5G5T,6QZK,A0A1I3LMA1,A0A0B0H9B4,R6KUL9,B7GJX9,A0A1N6SSK9,A0A060HNJ0,A0A235B542,A0A0Q2M2Z1,D3S0S6,Q8DKB1,A0A1J1EK56,Q53W94,A0A2T1EKT1,E0UCX3,K9XZC6,B9LVW4,A0A0C1VHB4,Q31N05,R5NJJ8,Q2JI93,A0A329TD61,A0A1H3DGN3,A0A1Q1FPH0,H1YCU5,A0A1Q5ZS75,A0A345E7N0,A0A1W2A082,A0A1H3X247,A0A346PK63,R7RTW6,A0A1H2RBI2,A0A1C3ZXN2,B9LVP8,W0JW77,F8D8G0,A0A343TL88,L0AJX6,A0A2A5QS34,A0A343JEE2,A0A3P3RGE5,A0A329TBQ3,A0A285N2A8,A0A0W1S8B8,A0A1V4C8L7,L9VRQ2,E4NRV1,A0A1I6HGN0,,",366,37
"608","C.L22.6","C.S15.1",267,163,104,5.24460240679566,"4F1N,4F3T,4KRE,5GUH,5VM9,6OON,7KX7,7SWF,A0A163JTZ6,A0A0N4X8S8,A0A196SDB4,C4LVV2,A0A0D1ZAJ4,Q1K660,F4PH46,A0A3M7S814,A0A164ZA52,A0A383WDW5,Q54G64,I0YVB2,R7QGN7,A0A2C5Z0M1,A0CB11,R9ACY5,D3BMP8,A0A1Z5TVE5,W7XD45,A0A1U7LLR0,A0A4S2MWZ7,K1VVQ6,A0A158P1R9,G7DVX0,V6R0U9,G4N9J3,E3KLI3,A0A1E3QC61,D5GGK8,S8ANP9,A0A139AUH8,L2GMR6,U4LBG4,A0A177URI1,O74957,A0A3N4IGK1,A6N7Y9,A0A0E9NDK5,T1KZ60,A0A250WXN5,A0A2G8JLH3,Q5KAT1,L2GUF2,W2T741,A0A2J7QB22,S4RYE2,A0A2K3CW87,A0A388KES6,A0A226EFL3,A0A3S3PD82,A0A0L0TEV1,A0A1S3J512,A0A1J1HRI1,C4V9J2,Q9JMB7,A0A075AN09,Q5TW24,U5HIG6,A0A401PRI6,Q96J94,A0A2B4RHN2,G2QEV0,A0A397UU01,A0A2T7PFL8,K7ISV0,A0A024FT57,H3HCL6,A0A0G4IME3,A0A1S3CYL5,D7FQK3,A0A1Y1YHC8,T1GSU4,F4S231,A0A1D8PMK0,A0A2G5B1D8,A0A1C7M8P2,A0A4D8YSQ3,A0A158PJG6,J9JZ66,A0A0C2XG51,A0A158QZT6,A0A165QYQ9,T0SAU8,A0A3S1A0C3,A0A074YJ47,A0A2K1J482,A0A1Q3ENA6,O04379,A0A371I3C8,M8AEW7,A8P0D4,A0A2K3NY65,F4NYW7,A0A409Y6G2,A0A0L0HAB7,D8PZT7,A0A1D1W4K0,A7RQ46,W4YU94,A7BJS5,D8SNM6,A0A1J8PPA3,X1WG39,M5FQK2,Q69VD5,A0A2R6NSC2,A0A0D8XL16,A0A016WPN3,Q9QZ81,G5EES3,A0A0K0EFP6,Q8CJG0,A0A1D5NTU6,V2WTL2,A0A0V0YLH8,A0A139WDH0,A0A0R3W9Q7,H3DS31,A0A1Y1HWP2,G4T5G9,B7QCC4,A0A0B2UV00,M7BCJ9,E9GN30,Q7PZ41,A0A077Z361,R7U9I3,A0A1X7V1N5,A0A0K0JDP1,A0A0N4UKJ1,A0A498N3A3,A0A3M0IQP5,A0A0L8GBV4,Q32KD4,A0A1J1JBJ0,E0W4C3,A0A482XDA9,A0A3P7EJD6,J9K2Z4,A0A2J7Q8V4,T1IBM6,V3ZRX0,A0A210QKF7,A0A423TSS1,K1PT78,A0A267E8R7,A0A1D2N447,A0A226D7A9,F6YK55,T1KTE4,A0A2C9JGZ6,A0A1V9X9F0,K5X5Z7,A0A3Q0KUG5,T1FY40,5AWH,5I4A,E8N0K8,A0A1I7IXT4,A0A2W1JZ37,A0A2S7WBN3,A0A328VKE4,A0A420DFE6,E0ST67,A0A4V1VDY2,A0A368P5I0,A0A4R1RMM2,A0A1Y2RDH8,Q11QW7,A0A1M5ZSR3,A0A0K8QX04,K9TPA9,A0A1L3JHM3,A0A1W6MIP2,A0A2U2J9E0,A0A326U7G5,A0A1Q4R485,K9U8J6,K9RC91,A0A0D8ZUC0,A0A139XGN8,A0A1T4Y3A2,A0YYT3,A0A2T1EFY0,G6FTN0,A0A433NB65,A0A1Z4L0A1,K9UQR0,A0A2T1G8M7,K9VUN0,A0A0P6X5X2,K9ZDE3,B0JXD6,A0A2T1LS63,A0A1Z4K1Y3,A0A0P4UVI8,A0A0V7ZCG4,A0A1J0AGK2,K9PFF9,A0A2G9DT08,K9UEV4,Q9L1X1,A0A496APJ8,A0A1V9G9U4,S7VLM7,A0A1A5X8H4,A0A1I2T6Q1,A0A1R3T9N6,H8KXJ0,A0A2D1U4H7,A0A0B7I4Z6,A0LL61,A0A139WY18,A0A2T1E1K4,A0A1Q8ZD62,A0A4Q6XKV6,A0A1Z3HNN4,A0A239JE83,A0A2N4XBY2,R5JEI2,A0A0Q0ZC47,A0A2T0XH18,A0A1V4CHV0,A0A1K1RQP7,A0A1N6LUI7,A0A0P0NGR6,A0A1X7IML5,A0A0A2LKJ7,K1L112,A0A0U3AL92,A0A1H3A054,A0A0C5JKF3,A5D4D9,A0A142Y7A9,A0A432MEQ5,A0A372DKU2,C1F5Q7,A0A4R3EV39,A0A1P8WP90,A0A222F7P0,A0A1C9VH88,A0A329TD61,A0A101R2A0,A0A1U9ND56,A0A4R7BQC4,A0A1Q1FPH0,E0TGY3,A0A259TUP4,F6EYI8,A0A2S9Q9J0,A0A4Q2UIU6,A0A1H0LH25,A0A318LG42,A0A345E7N0,A0A1H3X247,A0A2R5G167,B9LVP8,M5RSF0,B7K585,,",366,37
"609","C.L23.1","C.S15.4",294,163,131,1.65672270875287,"4F1N,4F3T,4KRE,5VM9,6OON,7KX7,7SWF,A0A163JTZ6,A0A196SDB4,J9D5G4,C4LVV2,A0A2P6N8X7,A8BCK6,A2DPV7,A0A0G4H2S4,A0A074TLL7,A0A0D1ZAJ4,Q1K660,F4PH46,A0A3M7S814,A0A164ZA52,A0A383WDW5,Q54G64,I0YVB2,R7QGN7,C1DZY0,A0A2C5Z0M1,A0CB11,R9ACY5,D3BMP8,A0A1Z5TVE5,W7XD45,A0A1U7LLR0,K1VVQ6,A0A158P1R9,G7DVX0,V6R0U9,G4N9J3,D5GGK8,S8ANP9,A0A139AUH8,L2GMR6,A0A177URI1,O74957,A0A3N4IGK1,A6N7Y9,A0A0E9NDK5,T1KZ60,A0A250WXN5,A0A2G8JLH3,Q5KAT1,W2T741,A0A1W0E4B5,S4RYE2,A0A2K3CW87,A0A388KES6,A0A226EFL3,A0A3S3PD82,A0A0L0TEV1,A0A1S3J512,G0QTT2,A0A1J1HRI1,C4V9J2,Q9JMB7,A0A075AN09,Q5TW24,U5HIG6,A0A401PRI6,Q96J94,G2QEV0,A0A397UU01,A0A2T7PFL8,K7ISV0,A0A024FT57,H3HCL6,A0A0G4IME3,E9FUN9,A0A1S3CYL5,D7FQK3,A0A1Y1YHC8,T1GSU4,A0A1D8PMK0,A0A2G5B1D8,Q5BD61,A0A4D8YSQ3,A0A158PJG6,A0A0C2XG51,A0A158QZT6,A0A165QYQ9,T0SAU8,R7YY92,A0A3S1A0C3,A0A074YJ47,A0A2K1J482,A0A1Q3ENA6,O04379,A0A371I3C8,M8AEW7,A8P0D4,A0A2K3NY65,F4NYW7,A0A409Y6G2,A0A0L0HAB7,D8PZT7,A0A1D1W4K0,A7RQ46,W4YU94,A7BJS5,D8SNM6,A0A1J8PPA3,X1WG39,M5FQK2,Q69VD5,A0A2R6NSC2,A0A0D8XL16,A0A016WPN3,Q9QZ81,G5EES3,A0A0K0EFP6,Q8CJG0,A0A1D5NTU6,V2WTL2,A0A0V0YLH8,A0A139WDH0,A0A0R3W9Q7,H3DS31,A0A1Y1HWP2,G4T5G9,B7QCC4,A0A0B2UV00,M7BCJ9,E9GN30,Q7PZ41,A0A077Z361,R7U9I3,A0A1X7V1N5,A0A0K0JDP1,A0A0N4UKJ1,A0A498N3A3,A0A3M0IQP5,A0A0L8GBV4,Q32KD4,A0A1J1JBJ0,E0W4C3,A0A482XDA9,A0A3P7EJD6,J9K2Z4,A0A2J7Q8V4,T1IBM6,V3ZRX0,A0A210QKF7,A0A423TSS1,K1PT78,A0A267E8R7,A0A1D2N447,A0A226D7A9,F6YK55,T1KTE4,A0A2C9JGZ6,A0A1V9X9F0,K5X5Z7,A0A3Q0KUG5,T1FY40,1YVU,1Z26,5AWH,5G5T,5I4A,6QZK,7R8K,A0A328VKE4,A0A0M2PXX3,K9TPA9,A0A1C0UUC4,A0A142XB92,B1XJG0,A0A326U7G5,A0A1Q4R485,K9U8J6,A0A097QRL6,K9RC91,A0A0D8ZUC0,A0A139XGN8,A0A1T4Y3A2,B6YTQ5,A0A0B0H9B4,A0YYT3,A0A2T1EFY0,G6FTN0,A0A433NB65,A0A1Z4L0A1,K9UQR0,A0A2T1G8M7,K9VUN0,B7GJX9,A0A0P6X5X2,K9ZDE3,B0JXD6,A0A2T1LS63,A0A1Z4K1Y3,A0A1N6SSK9,A0A0P4UVI8,A0A0V7ZCG4,A0A1J0AGK2,K9PFF9,A0A2G9DT08,K9UEV4,Q9L1X1,A0A060HNJ0,A0A235B542,R5XQK4,A0A1H3LE92,A0A496APJ8,A0A062U2W9,H0HWQ5,A0A1V9G9U4,A0A317EJY3,A0A1I2BD20,F8ERC7,S7VLM7,A0A1A5X8H4,A0A1I2T6Q1,A0A1R3T9N6,A0A0Q2M2Z1,H8KXJ0,A0A2D1U4H7,A0A0B7I4Z6,A0LL61,Q8DKB1,A0A139WY18,A0A1J1EK56,A0A2T1E1K4,A0A1Q8ZD62,A0A1Z3HNN4,A0A239JE83,Q53W94,R5JEI2,A0A0Q0ZC47,A0A2T0XH18,A0A1V4CHV0,A0A1K1RQP7,A0A1N6LUI7,A0A0P0NGR6,K1L112,A0A0U3AL92,A0A1H3A054,E0UCX3,B9LVW4,R5NJJ8,A5D4D9,Q2JI93,A0A142Y7A9,A0A432MEQ5,A0A372DKU2,C1F5Q7,A0A4R3EV39,A0A1P8WP90,A0A222F7P0,A0A1C9VH88,A0A2T2YMB1,A0A101R2A0,A0A1U9ND56,A0A4R7BQC4,E0TGY3,A0A259TUP4,F6EYI8,A0A2S9Q9J0,A0A4Q2UIU6,A0A1H0LH25,A0A318LG42,H1YCU5,L0JS08,A0A1Q5ZS75,A0A345E7N0,A0A1W2A082,A0A2R5G167,A0A346PK63,R7RTW6,A0A1H2RBI2,A0A1C3ZXN2,M5RSF0,W0JW77,B7K585,F8D8G0,A0A343TL88,A0A2A5QS34,A0A343JEE2,A0A3P3RGE5,A0A329TBQ3,A0A285N2A8,A0A0W1S8B8,A0A1V4C8L7,L9VRQ2,A0A1I0NI68,,",366,37
"611","C.L9.2","C.L9.4",308,163,145,2.62547070023271,"4F1N,4F3T,4KRE,5VM9,6OON,7KX7,A0A163JTZ6,A0A0N4X8S8,A0A2P6N8X7,A2DPV7,T1H8B3,S4RWI0,D2VMG4,A0A0D1ZAJ4,Q1K660,F4PH46,A0A3M7S814,A0A164ZA52,Q54G64,I0YVB2,R7QGN7,C1DZY0,A0A2C5Z0M1,A0CB11,R9ACY5,D3BMP8,A0A1Z5TVE5,W7XD45,A0A1U7LLR0,A0A4S2MWZ7,A0A158P1R9,G7DVX0,V6R0U9,G4N9J3,E3KLI3,B7Q5I1,A0A1E3QC61,D5GGK8,A0A139AUH8,L2GMR6,U4LBG4,O74957,A0A3N4IGK1,A6N7Y9,A0A0E9NDK5,T1KZ60,A0A250WXN5,A0A2G8JLH3,Q5KAT1,L2GUF2,W2T741,A0A1W0E4B5,A0A2J7QB22,S4RYE2,A0A2K3CW87,A0A388KES6,A0A226EFL3,A0A3S3PD82,A0A0L0TEV1,A0A1S3J512,G0QTT2,A0A1J1HRI1,C4V9J2,Q9JMB7,A0A075AN09,Q5TW24,U5HIG6,A0A401PRI6,Q96J94,A0A2B4RHN2,G2QEV0,A0A397UU01,A0A2T7PFL8,K7ISV0,A0A024FT57,A0A0G4IME3,E9FUN9,A0A1S3CYL5,D7FQK3,A0A1Y1YHC8,T1GSU4,A0A1D8PMK0,A0A2G5B1D8,A0A1C7M8P2,A0A4D8YSQ3,A0A158PJG6,J9JZ66,A0A0C2XG51,A0A158QZT6,A0A165QYQ9,T0SAU8,R7YY92,A0A3S1A0C3,A0A074YJ47,A0A2K1J482,A0A1Q3ENA6,O04379,A0A371I3C8,M8AEW7,A0A2K3NY65,F4NYW7,A0A409Y6G2,A0A0L0HAB7,D8PZT7,A0A1D1W4K0,A7RQ46,W4YU94,A7BJS5,D8SNM6,A0A1J8PPA3,X1WG39,M5FQK2,Q69VD5,A0A2R6NSC2,A0A0D8XL16,A0A016WPN3,Q9QZ81,G5EES3,A0A0K0EFP6,Q8CJG0,A0A1D5NTU6,V2WTL2,A0A0V0YLH8,A0A139WDH0,A0A0R3W9Q7,H3DS31,A0A1Y1HWP2,G4T5G9,B7QCC4,A0A0B2UV00,M7BCJ9,E9GN30,Q7PZ41,A0A077Z361,R7U9I3,A0A1X7V1N5,A0A0K0JDP1,A0A0N4UKJ1,A0A498N3A3,A0A3M0IQP5,A0A0L8GBV4,Q32KD4,A0A1J1JBJ0,E0W4C3,A0A482XDA9,A0A3P7EJD6,J9K2Z4,A0A2J7Q8V4,T1IBM6,V3ZRX0,A0A210QKF7,A0A423TSS1,K1PT78,A0A267E8R7,A0A1D2N447,A0A226D7A9,F6YK55,T1KTE4,A0A2C9JGZ6,A0A1V9X9F0,K5X5Z7,A0A3Q0KUG5,T1FY40,1YVU,1Z26,3DLB,5AWH,5G5T,5I4A,6QZK,7R8K,E8N0K8,A0A328VKE4,K9TPA9,A0A2Z6E1D5,A0A0F4NXW8,L8D0R3,B1XJG0,A0A326U7G5,A0A1Q4R485,K9U8J6,A0A097QRL6,K9RC91,A0A0D8ZUC0,A0A139XGN8,A0A1T4Y3A2,Q5P0R2,B6YTQ5,A0YYT3,A0A2T1EFY0,G6FTN0,A0A433NB65,A0A1Z4L0A1,K9UQR0,A0A2T1G8M7,K9VUN0,K9ZDE3,B0JXD6,A0A2T1LS63,A0A1Z4K1Y3,A0A2Z6E0R7,A0A0P4UVI8,A0A0V7ZCG4,A0A1J0AGK2,K9PFF9,A0A2G9DT08,K9UEV4,Q9L1X1,A0A1H3LE92,A0A496APJ8,A0A062U2W9,H0HWQ5,A0A1V9G9U4,A0A1I2ZGP1,A0A317EJY3,A0A1I2BD20,F8ERC7,S7VLM7,A0A1A5X8H4,A0A1I2T6Q1,A0A1R3T9N6,A0A0Q2M2Z1,H8KXJ0,A0A2D1U4H7,I3TE64,A0A0B7I4Z6,A0LL61,Q8DKB1,A0A139WY18,A0A1J1EK56,A0A2T1E1K4,A0A1Q8ZD62,A0A4Q6XKV6,A0A1Z3HNN4,A0A239JE83,A0A2N4XBY2,Q53W94,R5JEI2,A0A0Q0ZC47,A0A2T0XH18,A0A1V4CHV0,A0A1K1RQP7,A0A2T1EKT1,A0A1N6LUI7,A0A0P0NGR6,A0A1X7IML5,A0A0A2LKJ7,K1L112,A0A0U3AL92,A0A1H3A054,E0UCX3,K9XZC6,B9LVW4,A0A0C1VHB4,Q31N05,A0A0C5JKF3,R5NJJ8,A5D4D9,Q2JI93,A0A142Y7A9,A0A432MEQ5,A0A372DKU2,C1F5Q7,A0A4R3EV39,A0A1P8WP90,A0A222F7P0,A0A1C9VH88,A0A2T2YMB1,A0A101R2A0,A0A1E3XF49,A0A1U9ND56,A0A4R7BQC4,E0TGY3,A0A259TUP4,F6EYI8,A0A2S9Q9J0,A0A4Q2UIU6,A0A1H0LH25,A0A318LG42,H1YCU5,L0JS08,A0A1Q5ZS75,M0AF24,A0A1W2A082,A0A0C1XUA0,M0D2X3,A0A2R5G167,A0A346PK63,R7RTW6,A0A1H2RBI2,A0A1C3ZXN2,M5RSF0,W0JW77,B7K585,F8D8G0,A0A343TL88,L0AJX6,A0A2A5QS34,A0A343JEE2,A0A3P3RGE5,A0A329TBQ3,A0A285N2A8,A0A0W1S8B8,A0A1V4C8L7,L9VRQ2,E4NRV1,A0A1I6HGN0,A0A1I0NI68,,",366,37
"616","N.L26.1","N.S2.2",237,163,74,1.90909467749959,"4F1N,4F3T,4KRE,5VM9,6KR6,6OON,7KX7,7SWF,Q389P5,C4LVV2,T1H8B3,R1FDF0,S4RWI0,D2VMG4,A0A0D1ZAJ4,Q1K660,F4PH46,A0A164ZA52,A0A383WDW5,Q54G64,S7WCF7,R7QGN7,C1DZY0,A0A2C5Z0M1,A0CB11,R9ACY5,D3BMP8,A0A1Z5TVE5,W7XD45,A0A1U7LLR0,A0A4S2MWZ7,K1VVQ6,A0A158P1R9,G7DVX0,V6R0U9,G4N9J3,E3KLI3,B7Q5I1,A0A1E3QC61,D5GGK8,S8ANP9,A0A139AUH8,L2GMR6,U4LBG4,A0A177URI1,O74957,A0A3N4IGK1,A6N7Y9,A0A0E9NDK5,T1KZ60,A0A250WXN5,A0A2G8JLH3,Q5KAT1,L2GUF2,A0A1W0E4B5,S4RYE2,A0A2K3CW87,A0A388KES6,A0A226EFL3,A0A3S3PD82,A0A0L0TEV1,G0QTT2,A0A1J1HRI1,C4V9J2,Q9JMB7,A0A075AN09,Q5TW24,U5HIG6,A0A401PRI6,Q96J94,A0A2B4RHN2,G2QEV0,A0A397UU01,A0A2T7PFL8,K7ISV0,A0A024FT57,H3HCL6,A0A0G4IME3,E9FUN9,A0A1S3CYL5,D7FQK3,A0A1Y1YHC8,T1GSU4,F4S231,A0A1D8PMK0,A0A2G5B1D8,Q5BD61,A0A1C7M8P2,A0A4D8YSQ3,A0A158PJG6,J9JZ66,A0A0C2XG51,A0A158QZT6,T0SAU8,R7YY92,A0A3S1A0C3,A0A074YJ47,A0A2K1J482,O04379,A0A371I3C8,M8AEW7,A8P0D4,A0A2K3NY65,F4NYW7,A0A0L0HAB7,D8PZT7,A0A1D1W4K0,A7RQ46,W4YU94,A7BJS5,D8SNM6,X1WG39,M5FQK2,Q69VD5,A0A2R6NSC2,A0A0D8XL16,A0A016WPN3,Q9QZ81,G5EES3,A0A0K0EFP6,Q8CJG0,A0A1D5NTU6,V2WTL2,A0A0V0YLH8,A0A139WDH0,A0A0R3W9Q7,H3DS31,A0A1Y1HWP2,B7QCC4,A0A0B2UV00,M7BCJ9,E9GN30,Q7PZ41,A0A077Z361,R7U9I3,A0A1X7V1N5,A0A0K0JDP1,A0A0N4UKJ1,A0A498N3A3,A0A3M0IQP5,A0A0L8GBV4,Q32KD4,A0A1J1JBJ0,E0W4C3,A0A482XDA9,A0A3P7EJD6,J9K2Z4,A0A2J7Q8V4,T1IBM6,V3ZRX0,A0A210QKF7,A0A423TSS1,K1PT78,A0A267E8R7,A0A1D2N447,A0A226D7A9,F6YK55,T1KTE4,A0A2C9JGZ6,A0A1V9X9F0,K5X5Z7,A0A3Q0KUG5,T1FY40,1YVU,1Z26,5AWH,5G5T,5I4A,6QZK,H0HWQ5,A0A317EJY3,A0A1I2BD20,F8ERC7,S7VLM7,H8KXJ0,A0A2D1U4H7,A0A0B7I4Z6,A0LL61,A0A4Q6XKV6,A0A239JE83,A0A2N4XBY2,R5JEI2,A0A0Q0ZC47,A0A2T0XH18,A0A1V4CHV0,A0A1K1RQP7,A0A1N6LUI7,A0A0P0NGR6,A0A1X7IML5,A0A0A2LKJ7,K1L112,A0A1H3A054,A0A0C5JKF3,A0A142Y7A9,A0A372DKU2,A0A3R7KLK4,C1F5Q7,A0A4R3EV39,A0A1P8WP90,A0A222F7P0,A0A1C9VH88,A0A2T2YMB1,A0A329TD61,A0A101R2A0,A0A1E3XF49,A0A1Q1FPH0,E0TGY3,A0A259TUP4,F6EYI8,A0A2S9Q9J0,A0A4Q2UIU6,A0A1H0LH25,A0A318LG42,H1YCU5,L0JS08,A0A1Q5ZS75,A0A345E7N0,M0AF24,A0A1H3X247,A0A0C1XUA0,M0D2X3,A0A2R5G167,A0A346PK63,A0A1C3ZXN2,B9LVP8,M5RSF0,W0JW77,B7K585,F8D8G0,L0AJX6,A0A2A5QS34,A0A343JEE2,A0A1V4C8L7,L9VRQ2,E4NRV1,A0A1I6HGN0,A0A1I0NI68,,",366,37
"622","C.L18.1","C.S8.7",210,164,46,2.87009544008484,"4F1N,4F3T,4KRE,5GUH,5VM9,6KR6,6OON,A0A163JTZ6,A0A0N4X8S8,A0A196SDB4,A0A2P6N8X7,A8BCK6,A2DPV7,A0A0G4H2S4,R1FDF0,S4RWI0,D2VMG4,A0A074TLL7,A0A0D1ZAJ4,Q1K660,F4PH46,A0A3M7S814,A0A164ZA52,A0A383WDW5,Q54G64,S7WCF7,I0YVB2,R7QGN7,C1DZY0,A0A2C5Z0M1,A0CB11,R9ACY5,D3BMP8,A0A1Z5TVE5,W7XD45,A0A1U7LLR0,A0A4S2MWZ7,K1VVQ6,G7DVX0,V6R0U9,G4N9J3,E3KLI3,B7Q5I1,A0A1E3QC61,D5GGK8,S8ANP9,A0A139AUH8,A0A177URI1,O74957,A0A3N4IGK1,A6N7Y9,T1KZ60,A0A250WXN5,A0A2G8JLH3,Q5KAT1,L2GUF2,W2T741,A0A2K3CW87,A0A3S3PD82,A0A0L0TEV1,A0A1S3J512,G0QTT2,A0A1J1HRI1,Q9JMB7,A0A075AN09,U5HIG6,A0A401PRI6,Q96J94,A0A2B4RHN2,G2QEV0,A0A397UU01,A0A2T7PFL8,K7ISV0,A0A024FT57,H3HCL6,A0A0G4IME3,E9FUN9,A0A1S3CYL5,D7FQK3,A0A1Y1YHC8,T1GSU4,F4S231,A0A1D8PMK0,A0A2G5B1D8,Q5BD61,A0A1C7M8P2,A0A4D8YSQ3,A0A158PJG6,J9JZ66,A0A0C2XG51,A0A158QZT6,A0A165QYQ9,T0SAU8,R7YY92,A0A3S1A0C3,A0A074YJ47,A0A2K1J482,A0A1Q3ENA6,O04379,A0A371I3C8,A8P0D4,A0A2K3NY65,F4NYW7,A0A409Y6G2,A0A0L0HAB7,D8PZT7,A0A1D1W4K0,A7RQ46,W4YU94,A7BJS5,D8SNM6,X1WG39,M5FQK2,Q69VD5,A0A2R6NSC2,A0A0D8XL16,A0A016WPN3,Q9QZ81,G5EES3,A0A0K0EFP6,Q8CJG0,A0A1D5NTU6,V2WTL2,A0A0V0YLH8,A0A139WDH0,A0A0R3W9Q7,H3DS31,A0A1Y1HWP2,G4T5G9,B7QCC4,A0A0B2UV00,M7BCJ9,E9GN30,Q7PZ41,A0A077Z361,R7U9I3,A0A1X7V1N5,A0A0K0JDP1,A0A0N4UKJ1,A0A498N3A3,A0A3M0IQP5,A0A0L8GBV4,Q32KD4,A0A1J1JBJ0,E0W4C3,A0A482XDA9,A0A3P7EJD6,J9K2Z4,A0A2J7Q8V4,T1IBM6,V3ZRX0,A0A210QKF7,A0A423TSS1,K1PT78,A0A267E8R7,A0A1D2N447,A0A226D7A9,F6YK55,T1KTE4,A0A2C9JGZ6,A0A1V9X9F0,K5X5Z7,A0A3Q0KUG5,T1FY40,1YVU,6QZK,7R8K,E0ST67,C4L1M1,A0A0M2PXX3,A0A142XB92,B1XJG0,A0A0B0H9B4,B7GJX9,A0A1N6SSK9,A0A060HNJ0,A0A235B542,A0A062U2W9,H0HWQ5,A0A1I2ZGP1,A0A317EJY3,A0A1I2BD20,F8ERC7,Q8DKB1,A0A1J1EK56,Q53W94,A0A2T1EKT1,E0UCX3,K9XZC6,A0A0C1VHB4,Q31N05,R5NJJ8,A5D4D9,Q2JI93,A0A3R7KLK4,A0A4R3EV39,A0A329TD61,A0A1E3XF49,A0A1H3DGN3,A0A1Q1FPH0,A0A4Q2UIU6,H1YCU5,A0A1Q5ZS75,A0A345E7N0,A0A0C1XUA0,A0A346PK63,R7RTW6,A0A1H2RBI2,A0A1C3ZXN2,A0A343JEE2,,",366,37
"623","C.L20.5","C.L23.11",285,164,121,1.54792380568434,"4F1N,4F3T,4KRE,5GUH,5VM9,6KR6,6OON,7KX7,7SWF,A0A163JTZ6,A0A0N4X8S8,J9D5G4,A8BCK6,A2DPV7,A0A0G4H2S4,D2VMG4,A0A074TLL7,A0A0D1ZAJ4,Q1K660,F4PH46,A0A164ZA52,A0A383WDW5,Q54G64,S7WCF7,I0YVB2,C1DZY0,A0A2C5Z0M1,A0CB11,R9ACY5,D3BMP8,A0A1Z5TVE5,W7XD45,A0A1U7LLR0,A0A4S2MWZ7,A0A158P1R9,V6R0U9,G4N9J3,B7Q5I1,A0A1E3QC61,D5GGK8,A0A139AUH8,L2GMR6,U4LBG4,O74957,A0A3N4IGK1,A6N7Y9,A0A0E9NDK5,T1KZ60,A0A250WXN5,A0A2G8JLH3,Q5KAT1,L2GUF2,A0A1W0E4B5,A0A2J7QB22,S4RYE2,A0A2K3CW87,A0A388KES6,A0A226EFL3,A0A3S3PD82,A0A0L0TEV1,A0A1S3J512,G0QTT2,A0A1J1HRI1,C4V9J2,Q9JMB7,A0A075AN09,Q5TW24,A0A401PRI6,Q96J94,A0A2B4RHN2,G2QEV0,A0A397UU01,A0A2T7PFL8,K7ISV0,A0A024FT57,H3HCL6,A0A0G4IME3,E9FUN9,A0A1S3CYL5,D7FQK3,T1GSU4,A0A1D8PMK0,A0A2G5B1D8,Q5BD61,A0A1C7M8P2,A0A4D8YSQ3,A0A158PJG6,J9JZ66,A0A158QZT6,A0A165QYQ9,T0SAU8,R7YY92,A0A3S1A0C3,A0A074YJ47,A0A2K1J482,A0A1Q3ENA6,O04379,A0A371I3C8,M8AEW7,A8P0D4,A0A2K3NY65,F4NYW7,A0A409Y6G2,A0A0L0HAB7,D8PZT7,A0A1D1W4K0,A7RQ46,W4YU94,A7BJS5,D8SNM6,A0A1J8PPA3,X1WG39,M5FQK2,Q69VD5,A0A2R6NSC2,A0A0D8XL16,A0A016WPN3,Q9QZ81,G5EES3,A0A0K0EFP6,Q8CJG0,A0A1D5NTU6,V2WTL2,A0A0V0YLH8,A0A139WDH0,A0A0R3W9Q7,H3DS31,A0A1Y1HWP2,G4T5G9,B7QCC4,A0A0B2UV00,M7BCJ9,E9GN30,Q7PZ41,A0A077Z361,R7U9I3,A0A1X7V1N5,A0A0K0JDP1,A0A0N4UKJ1,A0A498N3A3,A0A3M0IQP5,A0A0L8GBV4,Q32KD4,A0A1J1JBJ0,E0W4C3,A0A482XDA9,A0A3P7EJD6,J9K2Z4,A0A2J7Q8V4,T1IBM6,V3ZRX0,A0A210QKF7,A0A423TSS1,K1PT78,A0A267E8R7,A0A1D2N447,A0A226D7A9,F6YK55,T1KTE4,A0A2C9JGZ6,A0A1V9X9F0,K5X5Z7,A0A3Q0KUG5,T1FY40,1YVU,1Z26,3DLB,5AWH,5G5T,6QZK,A0A328VKE4,E0ST67,C4L1M1,Q11QW7,A0A0M2PXX3,K9TPA9,A0A1C0UUC4,A0A2Z6E1D5,A0A0F4NXW8,A0A142XB92,L8D0R3,B1XJG0,A0A326U7G5,H1KXR6,A0A1Q4R485,K9U8J6,A0A097QRL6,K9RC91,A0A0D8ZUC0,A0A139XGN8,A0A1T4Y3A2,Q5P0R2,A0A2T1EFY0,G6FTN0,R6KUL9,A0A433NB65,A0A1Z4L0A1,K9UQR0,A0A2T1G8M7,K9VUN0,B7GJX9,A0A0P6X5X2,K9ZDE3,B0JXD6,A0A2T1LS63,A0A2Z6E0R7,A0A1N6SSK9,A0A0P4UVI8,A0A0V7ZCG4,A0A1J0AGK2,K9PFF9,A0A2G9DT08,K9UEV4,Q9L1X1,A0A235B542,R5XQK4,A0A1H3LE92,A0A496APJ8,A0A1V9G9U4,S7VLM7,H8KXJ0,A0A2D1U4H7,I3TE64,A0LL61,A0A1J1EK56,A0A2T1E1K4,A0A1Q8ZD62,A0A4Q6XKV6,A0A1Z3HNN4,A0A239JE83,A0A2N4XBY2,Q53W94,A0A0Q0ZC47,A0A2T0XH18,A0A1K1RQP7,A0A1N6LUI7,A0A0P0NGR6,A0A1X7IML5,A0A0A2LKJ7,K1L112,K9XZC6,Q31N05,Q2JI93,A0A142Y7A9,A0A432MEQ5,A0A3R7KLK4,C1F5Q7,A0A1P8WP90,A0A329TD61,A0A101R2A0,A0A1U9ND56,A0A4R7BQC4,A0A1H3DGN3,A0A1Q1FPH0,A0A259TUP4,A0A2S9Q9J0,A0A4Q2UIU6,A0A1H0LH25,A0A318LG42,L0JS08,A0A345E7N0,M0AF24,A0A1H3X247,M0D2X3,A0A2R5G167,A0A346PK63,R7RTW6,B9LVP8,M5RSF0,W0JW77,B7K585,F8D8G0,A0A343TL88,L0AJX6,A0A2A5QS34,A0A343JEE2,A0A3P3RGE5,A0A329TBQ3,A0A285N2A8,A0A0W1S8B8,A0A1V4C8L7,L9VRQ2,E4NRV1,A0A1I6HGN0,A0A1I0NI68,,",366,37
"624","C.L23.11","C.S15.4",341,164,177,2.3383801846493,"7KX7,7SWF,A0A163JTZ6,A0A0N4X8S8,A0A196SDB4,J9D5G4,Q389P5,C4LVV2,A0A2P6N8X7,A8BCK6,A2DPV7,A0A0G4H2S4,R1FDF0,D2VMG4,A0A074TLL7,A0A0D1ZAJ4,F4PH46,A0A3M7S814,A0A164ZA52,A0A383WDW5,Q54G64,S7WCF7,I0YVB2,R7QGN7,A0A2C5Z0M1,R9ACY5,W7XD45,A0A1U7LLR0,A0A4S2MWZ7,K1VVQ6,A0A158P1R9,G7DVX0,G4N9J3,E3KLI3,A0A1E3QC61,D5GGK8,S8ANP9,A0A139AUH8,L2GMR6,U4LBG4,A0A177URI1,O74957,A0A3N4IGK1,A6N7Y9,A0A0E9NDK5,T1KZ60,A0A250WXN5,A0A2G8JLH3,Q5KAT1,L2GUF2,W2T741,A0A1W0E4B5,S4RYE2,A0A2K3CW87,A0A388KES6,A0A226EFL3,A0A3S3PD82,A0A0L0TEV1,A0A1S3J512,G0QTT2,A0A1J1HRI1,C4V9J2,Q9JMB7,A0A075AN09,Q5TW24,U5HIG6,A0A401PRI6,Q96J94,G2QEV0,A0A397UU01,A0A2T7PFL8,K7ISV0,A0A024FT57,H3HCL6,A0A0G4IME3,E9FUN9,A0A1S3CYL5,D7FQK3,A0A1Y1YHC8,T1GSU4,F4S231,A0A1D8PMK0,A0A2G5B1D8,Q5BD61,A0A1C7M8P2,A0A4D8YSQ3,A0A158PJG6,A0A0C2XG51,A0A158QZT6,A0A165QYQ9,T0SAU8,R7YY92,A0A3S1A0C3,A0A074YJ47,A0A2K1J482,A0A1Q3ENA6,O04379,A0A371I3C8,M8AEW7,A8P0D4,A0A2K3NY65,F4NYW7,A0A409Y6G2,A0A0L0HAB7,D8PZT7,A0A1D1W4K0,A7RQ46,W4YU94,A7BJS5,D8SNM6,A0A1J8PPA3,X1WG39,M5FQK2,Q69VD5,A0A2R6NSC2,A0A0D8XL16,A0A016WPN3,Q9QZ81,G5EES3,A0A0K0EFP6,Q8CJG0,A0A1D5NTU6,V2WTL2,A0A0V0YLH8,A0A139WDH0,A0A0R3W9Q7,H3DS31,A0A1Y1HWP2,G4T5G9,B7QCC4,A0A0B2UV00,M7BCJ9,E9GN30,Q7PZ41,A0A077Z361,R7U9I3,A0A1X7V1N5,A0A0K0JDP1,A0A0N4UKJ1,A0A498N3A3,A0A3M0IQP5,A0A0L8GBV4,Q32KD4,A0A1J1JBJ0,E0W4C3,A0A482XDA9,A0A3P7EJD6,J9K2Z4,A0A2J7Q8V4,T1IBM6,V3ZRX0,A0A210QKF7,A0A423TSS1,K1PT78,A0A267E8R7,A0A1D2N447,A0A226D7A9,F6YK55,T1KTE4,A0A2C9JGZ6,A0A1V9X9F0,K5X5Z7,A0A3Q0KUG5,T1FY40,1YVU,1Z26,3DLB,5AWH,5G5T,5I4A,6QZK,7R8K,A0A1I7IXT4,A0A2W1JZ37,A0A2S7WBN3,A0A328VKE4,A0A420DFE6,E0ST67,A0A4V1VDY2,A0A368P5I0,C4L1M1,A0A4R1RMM2,A0A1Y2RDH8,Q11QW7,A0A1M5ZSR3,A0A0K8QX04,A0A0M2PXX3,K9TPA9,A0A1L3JHM3,A0A1W6MIP2,A0A1C0UUC4,A0A2U2J9E0,A0A2Z6E1D5,A0A0F4NXW8,A0A142XB92,L8D0R3,B1XJG0,A0A326U7G5,A0A3D8L290,H1KXR6,A0A1Q4R485,K9U8J6,A0A097QRL6,K9RC91,A0A0D8ZUC0,A0A139XGN8,A0A1T4Y3A2,Q5P0R2,B6YTQ5,A0A0B0H9B4,A0YYT3,A0A2T1EFY0,G6FTN0,R6KUL9,A0A433NB65,A0A1Z4L0A1,K9UQR0,A0A2T1G8M7,K9VUN0,B7GJX9,A0A0P6X5X2,K9ZDE3,B0JXD6,A0A2T1LS63,A0A1Z4K1Y3,A0A2Z6E0R7,A0A1N6SSK9,A0A0P4UVI8,A0A0V7ZCG4,A0A1J0AGK2,K9PFF9,A0A2G9DT08,K9UEV4,Q9L1X1,A0A235B542,R5XQK4,A0A1H3LE92,A0A496APJ8,A0A062U2W9,H0HWQ5,A0A1V9G9U4,A0A1I2ZGP1,A0A317EJY3,A0A1I2BD20,F8ERC7,S7VLM7,A0A1A5X8H4,A0A1I2T6Q1,A0A1R3T9N6,A0A0Q2M2Z1,H8KXJ0,D3S0S6,A0A2D1U4H7,I3TE64,A0A0B7I4Z6,A0LL61,Q8DKB1,A0A139WY18,A0A1J1EK56,A0A2T1E1K4,A0A1Q8ZD62,A0A4Q6XKV6,A0A1Z3HNN4,A0A239JE83,A0A2N4XBY2,Q53W94,R5JEI2,A0A0Q0ZC47,A0A2T0XH18,A0A1V4CHV0,A0A1K1RQP7,A0A2T1EKT1,A0A1N6LUI7,A0A0P0NGR6,A0A1X7IML5,A0A0A2LKJ7,K1L112,A0A0U3AL92,A0A1H3A054,E0UCX3,K9XZC6,A0A0C1VHB4,Q31N05,A0A0C5JKF3,R5NJJ8,A5D4D9,Q2JI93,A0A142Y7A9,A0A432MEQ5,A0A372DKU2,C1F5Q7,A0A4R3EV39,A0A1P8WP90,A0A222F7P0,A0A1C9VH88,A0A2T2YMB1,A0A329TD61,A0A101R2A0,A0A1E3XF49,A0A1U9ND56,A0A4R7BQC4,A0A1Q1FPH0,E0TGY3,A0A259TUP4,F6EYI8,A0A2S9Q9J0,A0A4Q2UIU6,A0A1H0LH25,A0A318LG42,H1YCU5,L0JS08,A0A1Q5ZS75,A0A345E7N0,M0AF24,A0A1W2A082,A0A1H3X247,A0A0C1XUA0,M0D2X3,A0A2R5G167,A0A346PK63,R7RTW6,A0A1H2RBI2,A0A1C3ZXN2,B9LVP8,M5RSF0,W0JW77,B7K585,F8D8G0,A0A343TL88,L0AJX6,A0A2A5QS34,A0A343JEE2,A0A3P3RGE5,A0A329TBQ3,A0A285N2A8,A0A0W1S8B8,A0A1V4C8L7,L9VRQ2,E4NRV1,A0A1I6HGN0,A0A1I0NI68,,",366,37
"625","C.L23.8","N.H8.2",244,164,80,2.15213414634146,"4F1N,4F3T,4KRE,5GUH,6OON,7KX7,A0A163JTZ6,A0A0N4X8S8,A0A196SDB4,J9D5G4,C4LVV2,A0A2P6N8X7,A8BCK6,A0A0G4H2S4,R1FDF0,D2VMG4,A0A074TLL7,A0A0D1ZAJ4,Q1K660,F4PH46,A0A3M7S814,A0A164ZA52,A0A383WDW5,S7WCF7,I0YVB2,R7QGN7,C1DZY0,A0A2C5Z0M1,R9ACY5,A0A1Z5TVE5,W7XD45,A0A1U7LLR0,A0A4S2MWZ7,K1VVQ6,G7DVX0,V6R0U9,G4N9J3,E3KLI3,B7Q5I1,A0A1E3QC61,D5GGK8,S8ANP9,A0A139AUH8,L2GMR6,U4LBG4,A0A177URI1,O74957,A0A3N4IGK1,A0A0E9NDK5,A0A250WXN5,A0A2G8JLH3,Q5KAT1,L2GUF2,W2T741,A0A1W0E4B5,A0A2J7QB22,S4RYE2,A0A2K3CW87,A0A388KES6,A0A226EFL3,A0A3S3PD82,A0A0L0TEV1,A0A1S3J512,G0QTT2,A0A1J1HRI1,C4V9J2,Q5TW24,U5HIG6,A0A401PRI6,A0A2B4RHN2,G2QEV0,A0A397UU01,A0A2T7PFL8,K7ISV0,A0A024FT57,H3HCL6,A0A0G4IME3,E9FUN9,D7FQK3,A0A1Y1YHC8,T1GSU4,F4S231,A0A1D8PMK0,A0A2G5B1D8,Q5BD61,A0A4D8YSQ3,A0A158PJG6,A0A0C2XG51,A0A158QZT6,A0A165QYQ9,T0SAU8,R7YY92,A0A3S1A0C3,A0A074YJ47,A0A2K1J482,A0A1Q3ENA6,O04379,A0A371I3C8,M8AEW7,A8P0D4,A0A2K3NY65,F4NYW7,A0A409Y6G2,A0A0L0HAB7,D8PZT7,A0A1D1W4K0,A7RQ46,W4YU94,A7BJS5,D8SNM6,A0A1J8PPA3,X1WG39,M5FQK2,Q69VD5,A0A2R6NSC2,A0A0D8XL16,A0A016WPN3,Q9QZ81,G5EES3,A0A0K0EFP6,Q8CJG0,A0A1D5NTU6,V2WTL2,A0A0V0YLH8,A0A139WDH0,A0A0R3W9Q7,H3DS31,A0A1Y1HWP2,G4T5G9,B7QCC4,A0A0B2UV00,M7BCJ9,E9GN30,Q7PZ41,A0A077Z361,R7U9I3,A0A1X7V1N5,A0A0K0JDP1,A0A0N4UKJ1,A0A498N3A3,A0A3M0IQP5,A0A0L8GBV4,Q32KD4,A0A1J1JBJ0,E0W4C3,A0A482XDA9,A0A3P7EJD6,J9K2Z4,A0A2J7Q8V4,T1IBM6,V3ZRX0,A0A210QKF7,A0A423TSS1,K1PT78,A0A267E8R7,A0A1D2N447,A0A226D7A9,F6YK55,T1KTE4,A0A2C9JGZ6,A0A1V9X9F0,K5X5Z7,A0A3Q0KUG5,T1FY40,1Z26,5G5T,6QZK,7R8K,E0ST67,A0A142XB92,A0A3D8L290,A0A0B0H9B4,B7GJX9,A0A1N6SSK9,A0A2G9DT08,A0A235B542,A0A496APJ8,H0HWQ5,A0A1V9G9U4,A0A1I2BD20,S7VLM7,A0A1R3T9N6,A0A0Q2M2Z1,A0A0B7I4Z6,Q8DKB1,A0A139WY18,A0A2T1E1K4,A0A1Q8ZD62,A0A4Q6XKV6,A0A1Z3HNN4,A0A2N4XBY2,R5JEI2,A0A0Q0ZC47,A0A2T0XH18,A0A1V4CHV0,A0A1K1RQP7,A0A0P0NGR6,A0A1X7IML5,A0A0A2LKJ7,K1L112,A0A0U3AL92,A0A1H3A054,K9XZC6,B9LVW4,A0A0C5JKF3,R5NJJ8,A0A372DKU2,A0A3R7KLK4,C1F5Q7,A0A4R3EV39,A0A1P8WP90,A0A1C9VH88,A0A2T2YMB1,A0A101R2A0,A0A1E3XF49,A0A1H3DGN3,A0A1Q1FPH0,A0A259TUP4,A0A1H0LH25,A0A318LG42,H1YCU5,L0JS08,A0A1Q5ZS75,A0A345E7N0,M0AF24,A0A1H3X247,A0A0C1XUA0,M0D2X3,A0A346PK63,R7RTW6,W0JW77,F8D8G0,A0A343TL88,L0AJX6,A0A343JEE2,A0A3P3RGE5,A0A329TBQ3,A0A285N2A8,A0A0W1S8B8,A0A1V4C8L7,L9VRQ2,E4NRV1,A0A1I6HGN0,A0A1I0NI68,,",366,37
"629","N.L2.1","N.S12.4",253,164,89,3.36434639627295,"4F1N,4F3T,4KRE,5GUH,5VM9,6KR6,6OON,C4LVV2,A0A2P6N8X7,A8BCK6,A2DPV7,A0A0G4H2S4,T1H8B3,R1FDF0,S4RWI0,D2VMG4,A0A0D1ZAJ4,Q1K660,F4PH46,A0A164ZA52,A0A383WDW5,Q54G64,S7WCF7,R7QGN7,C1DZY0,A0A2C5Z0M1,A0CB11,R9ACY5,D3BMP8,A0A1Z5TVE5,W7XD45,A0A1U7LLR0,A0A4S2MWZ7,K1VVQ6,G7DVX0,V6R0U9,G4N9J3,E3KLI3,B7Q5I1,A0A1E3QC61,D5GGK8,S8ANP9,A0A139AUH8,L2GMR6,U4LBG4,A0A177URI1,O74957,A0A3N4IGK1,A6N7Y9,A0A0E9NDK5,A0A250WXN5,A0A2G8JLH3,Q5KAT1,L2GUF2,A0A1W0E4B5,A0A2J7QB22,S4RYE2,A0A2K3CW87,A0A388KES6,A0A226EFL3,A0A3S3PD82,A0A0L0TEV1,A0A1S3J512,G0QTT2,A0A1J1HRI1,C4V9J2,A0A075AN09,Q5TW24,A0A401PRI6,G2QEV0,A0A397UU01,A0A2T7PFL8,K7ISV0,A0A024FT57,H3HCL6,A0A0G4IME3,A0A1S3CYL5,D7FQK3,A0A1Y1YHC8,T1GSU4,F4S231,A0A1D8PMK0,A0A2G5B1D8,Q5BD61,A0A1C7M8P2,A0A4D8YSQ3,A0A158PJG6,A0A0C2XG51,A0A158QZT6,A0A165QYQ9,T0SAU8,R7YY92,A0A3S1A0C3,A0A074YJ47,A0A2K1J482,A0A1Q3ENA6,O04379,A0A371I3C8,M8AEW7,A8P0D4,A0A2K3NY65,F4NYW7,A0A409Y6G2,A0A0L0HAB7,D8PZT7,A0A1D1W4K0,A7RQ46,W4YU94,A7BJS5,D8SNM6,A0A1J8PPA3,X1WG39,M5FQK2,Q69VD5,A0A2R6NSC2,A0A0D8XL16,A0A016WPN3,Q9QZ81,G5EES3,A0A0K0EFP6,Q8CJG0,A0A1D5NTU6,V2WTL2,A0A0V0YLH8,A0A139WDH0,A0A0R3W9Q7,H3DS31,A0A1Y1HWP2,G4T5G9,B7QCC4,A0A0B2UV00,M7BCJ9,E9GN30,Q7PZ41,A0A077Z361,R7U9I3,A0A1X7V1N5,A0A0K0JDP1,A0A0N4UKJ1,A0A498N3A3,A0A3M0IQP5,A0A0L8GBV4,Q32KD4,A0A1J1JBJ0,E0W4C3,A0A482XDA9,A0A3P7EJD6,J9K2Z4,A0A2J7Q8V4,T1IBM6,V3ZRX0,A0A210QKF7,A0A423TSS1,K1PT78,A0A267E8R7,A0A1D2N447,A0A226D7A9,F6YK55,T1KTE4,A0A2C9JGZ6,A0A1V9X9F0,K5X5Z7,A0A3Q0KUG5,T1FY40,1YVU,1Z26,5AWH,5G5T,5I4A,7R8K,A0A1I3LMA1,A0A2U2J9E0,A0A3D8L290,A0A0B0H9B4,R6KUL9,B7GJX9,A0A1N6SSK9,A0A060HNJ0,A0A235B542,R5XQK4,H0HWQ5,A0A1I2BD20,F8ERC7,S7VLM7,A0A0Q2M2Z1,H8KXJ0,D3S0S6,A0A2D1U4H7,A0A0B7I4Z6,A0LL61,Q8DKB1,A0A1J1EK56,A0A4Q6XKV6,A0A239JE83,A0A2N4XBY2,Q53W94,R5JEI2,A0A0Q0ZC47,A0A2T0XH18,A0A1V4CHV0,A0A1K1RQP7,A0A2T1EKT1,A0A1N6LUI7,A0A0P0NGR6,A0A1X7IML5,A0A0A2LKJ7,K1L112,A0A0U3AL92,A0A1H3A054,E0UCX3,K9XZC6,A0A0C1VHB4,Q31N05,A0A0C5JKF3,A5D4D9,Q2JI93,A0A142Y7A9,A0A372DKU2,A0A3R7KLK4,C1F5Q7,A0A4R3EV39,A0A1P8WP90,A0A222F7P0,A0A1C9VH88,A0A2T2YMB1,A0A329TD61,A0A101R2A0,A0A1E3XF49,A0A1U9ND56,A0A4R7BQC4,A0A1H3DGN3,A0A1Q1FPH0,E0TGY3,A0A259TUP4,F6EYI8,A0A2S9Q9J0,A0A4Q2UIU6,A0A1H0LH25,A0A318LG42,H1YCU5,L0JS08,A0A1Q5ZS75,A0A345E7N0,M0AF24,A0A1H3X247,A0A0C1XUA0,M0D2X3,A0A2R5G167,A0A346PK63,A0A1C3ZXN2,B9LVP8,W0JW77,B7K585,,",366,37
"632","N.S3.5","N.S7.6",212,164,48,3.09705284552845,"4F1N,4F3T,4KRE,5GUH,6OON,7KX7,A0A196SDB4,Q389P5,A2DPV7,T1H8B3,S4RWI0,D2VMG4,A0A0D1ZAJ4,Q1K660,F4PH46,A0A164ZA52,Q54G64,S7WCF7,I0YVB2,C1DZY0,A0A2C5Z0M1,A0CB11,R9ACY5,D3BMP8,A0A1Z5TVE5,W7XD45,A0A1U7LLR0,A0A4S2MWZ7,K1VVQ6,A0A158P1R9,G7DVX0,V6R0U9,G4N9J3,E3KLI3,B7Q5I1,A0A1E3QC61,D5GGK8,S8ANP9,A0A139AUH8,L2GMR6,U4LBG4,A0A177URI1,O74957,A0A3N4IGK1,A6N7Y9,A0A0E9NDK5,T1KZ60,A0A250WXN5,A0A2G8JLH3,Q5KAT1,L2GUF2,A0A1W0E4B5,A0A2J7QB22,S4RYE2,A0A2K3CW87,A0A388KES6,A0A226EFL3,A0A3S3PD82,A0A0L0TEV1,A0A1S3J512,G0QTT2,A0A1J1HRI1,C4V9J2,Q9JMB7,A0A075AN09,Q5TW24,U5HIG6,A0A401PRI6,Q96J94,A0A2B4RHN2,A0A397UU01,K7ISV0,A0A024FT57,H3HCL6,E9FUN9,A0A1S3CYL5,D7FQK3,A0A1Y1YHC8,T1GSU4,F4S231,A0A1D8PMK0,A0A2G5B1D8,Q5BD61,A0A1C7M8P2,A0A4D8YSQ3,A0A158PJG6,J9JZ66,A0A0C2XG51,A0A158QZT6,A0A165QYQ9,T0SAU8,R7YY92,A0A3S1A0C3,A0A074YJ47,A0A2K1J482,A0A1Q3ENA6,O04379,A0A371I3C8,M8AEW7,A8P0D4,A0A2K3NY65,F4NYW7,A0A409Y6G2,A0A0L0HAB7,D8PZT7,A0A1D1W4K0,A7RQ46,W4YU94,A7BJS5,D8SNM6,A0A1J8PPA3,X1WG39,M5FQK2,Q69VD5,A0A2R6NSC2,A0A0D8XL16,A0A016WPN3,Q9QZ81,G5EES3,A0A0K0EFP6,Q8CJG0,A0A1D5NTU6,V2WTL2,A0A0V0YLH8,A0A139WDH0,A0A0R3W9Q7,H3DS31,A0A1Y1HWP2,G4T5G9,B7QCC4,A0A0B2UV00,M7BCJ9,E9GN30,Q7PZ41,A0A077Z361,R7U9I3,A0A1X7V1N5,A0A0K0JDP1,A0A0N4UKJ1,A0A498N3A3,A0A3M0IQP5,A0A0L8GBV4,Q32KD4,A0A1J1JBJ0,E0W4C3,A0A482XDA9,A0A3P7EJD6,J9K2Z4,A0A2J7Q8V4,T1IBM6,V3ZRX0,A0A210QKF7,A0A423TSS1,K1PT78,A0A267E8R7,A0A1D2N447,A0A226D7A9,F6YK55,T1KTE4,A0A2C9JGZ6,A0A1V9X9F0,K5X5Z7,A0A3Q0KUG5,T1FY40,1YVU,1Z26,5G5T,A0A1I3LMA1,A0A0B0H9B4,R6KUL9,B7GJX9,A0A1N6SSK9,A0A235B542,A0A0Q2M2Z1,D3S0S6,Q8DKB1,A0A1J1EK56,Q53W94,A0A2T1EKT1,E0UCX3,K9XZC6,B9LVW4,A0A0C1VHB4,Q31N05,R5NJJ8,Q2JI93,A0A3R7KLK4,A0A329TD61,A0A1H3DGN3,A0A1Q1FPH0,L0JS08,A0A345E7N0,M0AF24,A0A1H3X247,M0D2X3,A0A346PK63,R7RTW6,B9LVP8,W0JW77,F8D8G0,A0A343TL88,L0AJX6,A0A2A5QS34,A0A343JEE2,A0A3P3RGE5,A0A329TBQ3,A0A285N2A8,A0A0W1S8B8,A0A1V4C8L7,L9VRQ2,E4NRV1,A0A1I6HGN0,,",366,37
"635","C.L1.4","C.L25.1",284,165,119,4.51645021645022,"4F1N,4F3T,4KRE,5GUH,6KR6,6OON,7KX7,7SWF,A0A163JTZ6,A0A0N4X8S8,A0A196SDB4,J9D5G4,Q389P5,A2DPV7,D2VMG4,A0A074TLL7,A0A0D1ZAJ4,Q1K660,F4PH46,A0A3M7S814,A0A164ZA52,A0A383WDW5,Q54G64,S7WCF7,I0YVB2,R7QGN7,C1DZY0,A0A2C5Z0M1,A0CB11,R9ACY5,D3BMP8,A0A1Z5TVE5,W7XD45,A0A1U7LLR0,A0A4S2MWZ7,K1VVQ6,A0A158P1R9,G7DVX0,V6R0U9,G4N9J3,E3KLI3,A0A1E3QC61,D5GGK8,S8ANP9,A0A139AUH8,L2GMR6,U4LBG4,A0A177URI1,O74957,A0A3N4IGK1,A0A0E9NDK5,T1KZ60,A0A250WXN5,A0A2G8JLH3,Q5KAT1,L2GUF2,W2T741,A0A1W0E4B5,A0A2K3CW87,A0A388KES6,A0A0L0TEV1,A0A1S3J512,G0QTT2,A0A1J1HRI1,C4V9J2,Q9JMB7,A0A075AN09,Q5TW24,U5HIG6,A0A2B4RHN2,G2QEV0,A0A397UU01,A0A2T7PFL8,A0A024FT57,H3HCL6,A0A0G4IME3,E9FUN9,D7FQK3,A0A1Y1YHC8,T1GSU4,F4S231,A0A1D8PMK0,A0A2G5B1D8,Q5BD61,A0A1C7M8P2,A0A4D8YSQ3,A0A158PJG6,J9JZ66,A0A0C2XG51,A0A158QZT6,A0A165QYQ9,T0SAU8,R7YY92,A0A3S1A0C3,A0A074YJ47,A0A2K1J482,A0A1Q3ENA6,O04379,A0A371I3C8,M8AEW7,A8P0D4,A0A2K3NY65,F4NYW7,A0A409Y6G2,A0A0L0HAB7,D8PZT7,A0A1D1W4K0,A7RQ46,W4YU94,A7BJS5,D8SNM6,A0A1J8PPA3,X1WG39,M5FQK2,Q69VD5,A0A2R6NSC2,A0A0D8XL16,A0A016WPN3,Q9QZ81,G5EES3,A0A0K0EFP6,Q8CJG0,A0A1D5NTU6,V2WTL2,A0A0V0YLH8,A0A139WDH0,A0A0R3W9Q7,H3DS31,A0A1Y1HWP2,G4T5G9,B7QCC4,A0A0B2UV00,M7BCJ9,E9GN30,Q7PZ41,A0A077Z361,R7U9I3,A0A1X7V1N5,A0A0K0JDP1,A0A0N4UKJ1,A0A498N3A3,A0A3M0IQP5,A0A0L8GBV4,Q32KD4,A0A1J1JBJ0,E0W4C3,A0A482XDA9,A0A3P7EJD6,J9K2Z4,A0A2J7Q8V4,T1IBM6,V3ZRX0,A0A210QKF7,A0A423TSS1,K1PT78,A0A267E8R7,A0A1D2N447,A0A226D7A9,F6YK55,T1KTE4,A0A2C9JGZ6,A0A1V9X9F0,K5X5Z7,A0A3Q0KUG5,T1FY40,1YVU,5AWH,5G5T,7R8K,A0A1I7IXT4,A0A2W1JZ37,A0A2S7WBN3,A0A420DFE6,A0A4V1VDY2,A0A368P5I0,C4L1M1,A0A4R1RMM2,A0A1Y2RDH8,Q11QW7,A0A1M5ZSR3,K9TPA9,A0A1L3JHM3,A0A1W6MIP2,A0A3D8L290,K9U8J6,K9RC91,A0A0D8ZUC0,A0A139XGN8,A0A1T4Y3A2,A0A0B0H9B4,A0YYT3,A0A2T1EFY0,G6FTN0,R6KUL9,A0A433NB65,A0A1Z4L0A1,K9UQR0,A0A2T1G8M7,K9VUN0,B7GJX9,K9ZDE3,B0JXD6,A0A2T1LS63,A0A1Z4K1Y3,A0A1N6SSK9,A0A0P4UVI8,A0A0V7ZCG4,A0A1J0AGK2,K9PFF9,A0A2G9DT08,K9UEV4,Q9L1X1,A0A235B542,R5XQK4,A0A496APJ8,A0A062U2W9,H0HWQ5,A0A1V9G9U4,A0A1I2ZGP1,A0A317EJY3,A0A1I2BD20,F8ERC7,S7VLM7,A0A1A5X8H4,A0A1I2T6Q1,H8KXJ0,A0A2D1U4H7,A0A0B7I4Z6,A0LL61,Q8DKB1,A0A1J1EK56,A0A2T1E1K4,A0A1Q8ZD62,A0A4Q6XKV6,A0A239JE83,A0A2N4XBY2,Q53W94,R5JEI2,A0A0Q0ZC47,A0A2T0XH18,A0A1V4CHV0,A0A1K1RQP7,A0A2T1EKT1,A0A1N6LUI7,A0A0P0NGR6,A0A1X7IML5,A0A0A2LKJ7,K1L112,A0A0U3AL92,A0A1H3A054,A0A0C5JKF3,A5D4D9,Q2JI93,A0A142Y7A9,A0A432MEQ5,A0A372DKU2,C1F5Q7,A0A4R3EV39,A0A1P8WP90,A0A1C9VH88,A0A101R2A0,A0A1E3XF49,A0A1U9ND56,A0A4R7BQC4,A0A1Q1FPH0,E0TGY3,A0A259TUP4,F6EYI8,A0A2S9Q9J0,A0A4Q2UIU6,A0A1H0LH25,A0A318LG42,H1YCU5,A0A1Q5ZS75,A0A345E7N0,A0A1W2A082,A0A1H3X247,A0A0C1XUA0,A0A2R5G167,R7RTW6,A0A1H2RBI2,A0A1C3ZXN2,B9LVP8,B7K585,,",366,37
"638","C.S11.6","C.S8.8",215,165,50,3.82090909090909,"A0A163JTZ6,A0A0N4X8S8,A0A196SDB4,J9D5G4,C4LVV2,A0A2P6N8X7,A8BCK6,A2DPV7,T1H8B3,R1FDF0,S4RWI0,D2VMG4,A0A0D1ZAJ4,Q1K660,F4PH46,A0A3M7S814,A0A164ZA52,A0A383WDW5,Q54G64,S7WCF7,R7QGN7,C1DZY0,A0A2C5Z0M1,A0CB11,R9ACY5,D3BMP8,A0A1Z5TVE5,W7XD45,A0A1U7LLR0,A0A4S2MWZ7,K1VVQ6,A0A158P1R9,G7DVX0,V6R0U9,G4N9J3,E3KLI3,B7Q5I1,A0A1E3QC61,D5GGK8,S8ANP9,A0A139AUH8,L2GMR6,U4LBG4,A0A177URI1,O74957,A0A3N4IGK1,A6N7Y9,A0A0E9NDK5,T1KZ60,A0A250WXN5,A0A2G8JLH3,Q5KAT1,L2GUF2,W2T741,A0A1W0E4B5,A0A2J7QB22,A0A2K3CW87,A0A226EFL3,A0A3S3PD82,A0A0L0TEV1,A0A1S3J512,A0A1J1HRI1,C4V9J2,Q9JMB7,A0A075AN09,Q5TW24,U5HIG6,A0A401PRI6,Q96J94,A0A2B4RHN2,G2QEV0,A0A397UU01,A0A2T7PFL8,K7ISV0,A0A024FT57,H3HCL6,A0A0G4IME3,E9FUN9,A0A1S3CYL5,D7FQK3,A0A1Y1YHC8,T1GSU4,F4S231,A0A1D8PMK0,A0A2G5B1D8,Q5BD61,A0A1C7M8P2,A0A4D8YSQ3,A0A158PJG6,J9JZ66,A0A0C2XG51,A0A158QZT6,A0A165QYQ9,T0SAU8,R7YY92,A0A3S1A0C3,A0A2K1J482,A0A1Q3ENA6,O04379,A0A371I3C8,A8P0D4,A0A2K3NY65,F4NYW7,A0A409Y6G2,A0A0L0HAB7,D8PZT7,A0A1D1W4K0,A7RQ46,W4YU94,A7BJS5,D8SNM6,A0A1J8PPA3,X1WG39,M5FQK2,Q69VD5,A0A2R6NSC2,A0A0D8XL16,A0A016WPN3,Q9QZ81,G5EES3,A0A0K0EFP6,Q8CJG0,A0A1D5NTU6,V2WTL2,A0A0V0YLH8,A0A139WDH0,A0A0R3W9Q7,H3DS31,A0A1Y1HWP2,G4T5G9,B7QCC4,A0A0B2UV00,M7BCJ9,E9GN30,Q7PZ41,A0A077Z361,R7U9I3,A0A1X7V1N5,A0A0K0JDP1,A0A0N4UKJ1,A0A498N3A3,A0A3M0IQP5,A0A0L8GBV4,Q32KD4,A0A1J1JBJ0,E0W4C3,A0A482XDA9,A0A3P7EJD6,J9K2Z4,A0A2J7Q8V4,T1IBM6,V3ZRX0,A0A210QKF7,A0A423TSS1,K1PT78,A0A267E8R7,A0A1D2N447,A0A226D7A9,F6YK55,T1KTE4,A0A2C9JGZ6,A0A1V9X9F0,K5X5Z7,A0A3Q0KUG5,T1FY40,1YVU,5I4A,6QZK,E8N0K8,A0A328VKE4,E0ST67,A0A0M2PXX3,A0A142XB92,L8D0R3,A0A1Q4R485,K9U8J6,A0A097QRL6,K9RC91,A0A0D8ZUC0,A0A139XGN8,B6YTQ5,A0A2T1EFY0,A0A433NB65,A0A1Z4L0A1,K9UQR0,A0A2T1G8M7,K9VUN0,K9ZDE3,A0A1Z4K1Y3,A0A0P4UVI8,A0A0V7ZCG4,A0A1J0AGK2,K9PFF9,K9UEV4,A0A496APJ8,A0A1V9G9U4,A0A139WY18,A0A2T1E1K4,A0A1Q8ZD62,A0A329TD61,A0A1Q1FPH0,H1YCU5,A0A1Q5ZS75,A0A345E7N0,A0A1H3X247,A0A0C1XUA0,A0A1H2RBI2,A0A1C3ZXN2,B9LVP8,A0A343TL88,A0A3P3RGE5,A0A329TBQ3,A0A0W1S8B8,L9VRQ2,A0A1I6HGN0,,",366,37
"640","N.H3.16","N.S9.2",225,165,60,3.98560606060606,"4F1N,4F3T,4KRE,5GUH,5VM9,6KR6,6OON,7KX7,7SWF,Q389P5,T1H8B3,S4RWI0,A0A074TLL7,A0A0D1ZAJ4,Q1K660,F4PH46,A0A3M7S814,A0A164ZA52,Q54G64,S7WCF7,I0YVB2,R7QGN7,C1DZY0,A0A2C5Z0M1,A0CB11,D3BMP8,A0A1Z5TVE5,W7XD45,A0A1U7LLR0,A0A4S2MWZ7,A0A158P1R9,G7DVX0,V6R0U9,G4N9J3,E3KLI3,B7Q5I1,A0A1E3QC61,D5GGK8,S8ANP9,A0A139AUH8,L2GMR6,U4LBG4,A0A177URI1,O74957,A0A3N4IGK1,A6N7Y9,A0A0E9NDK5,T1KZ60,A0A250WXN5,A0A2G8JLH3,Q5KAT1,L2GUF2,W2T741,A0A1W0E4B5,A0A2J7QB22,S4RYE2,A0A2K3CW87,A0A388KES6,A0A226EFL3,A0A0L0TEV1,A0A1S3J512,G0QTT2,Q9JMB7,A0A075AN09,Q5TW24,U5HIG6,A0A401PRI6,Q96J94,A0A2B4RHN2,G2QEV0,A0A397UU01,A0A2T7PFL8,K7ISV0,A0A024FT57,H3HCL6,A0A0G4IME3,E9FUN9,A0A1S3CYL5,D7FQK3,A0A1Y1YHC8,T1GSU4,F4S231,A0A1D8PMK0,A0A2G5B1D8,Q5BD61,A0A1C7M8P2,A0A4D8YSQ3,A0A158PJG6,J9JZ66,A0A0C2XG51,A0A158QZT6,A0A165QYQ9,T0SAU8,R7YY92,A0A3S1A0C3,A0A074YJ47,A0A2K1J482,A0A1Q3ENA6,O04379,A0A371I3C8,M8AEW7,A8P0D4,A0A2K3NY65,F4NYW7,A0A409Y6G2,A0A0L0HAB7,D8PZT7,A0A1D1W4K0,A7RQ46,W4YU94,A7BJS5,D8SNM6,A0A1J8PPA3,X1WG39,M5FQK2,Q69VD5,A0A2R6NSC2,A0A0D8XL16,A0A016WPN3,Q9QZ81,G5EES3,A0A0K0EFP6,Q8CJG0,A0A1D5NTU6,V2WTL2,A0A0V0YLH8,A0A139WDH0,A0A0R3W9Q7,H3DS31,A0A1Y1HWP2,G4T5G9,B7QCC4,A0A0B2UV00,M7BCJ9,E9GN30,Q7PZ41,A0A077Z361,R7U9I3,A0A1X7V1N5,A0A0K0JDP1,A0A0N4UKJ1,A0A498N3A3,A0A3M0IQP5,A0A0L8GBV4,Q32KD4,A0A1J1JBJ0,E0W4C3,A0A482XDA9,A0A3P7EJD6,J9K2Z4,A0A2J7Q8V4,T1IBM6,V3ZRX0,A0A210QKF7,A0A423TSS1,K1PT78,A0A267E8R7,A0A1D2N447,A0A226D7A9,F6YK55,T1KTE4,A0A2C9JGZ6,A0A1V9X9F0,K5X5Z7,A0A3Q0KUG5,3DLB,5AWH,5I4A,6QZK,7R8K,A0A2G9DT08,Q9L1X1,A0A062U2W9,H0HWQ5,A0A1V9G9U4,A0A1I2ZGP1,A0A317EJY3,A0A1I2BD20,F8ERC7,S7VLM7,A0A1A5X8H4,A0A1I2T6Q1,A0A1R3T9N6,H8KXJ0,A0A2D1U4H7,A0LL61,A0A1J1EK56,R5JEI2,A0A0Q0ZC47,A0A2T0XH18,A0A1V4CHV0,A0A1K1RQP7,A0A1N6LUI7,K1L112,A5D4D9,A0A142Y7A9,A0A432MEQ5,A0A4R3EV39,A0A1P8WP90,A0A222F7P0,A0A329TD61,A0A101R2A0,A0A1E3XF49,A0A1U9ND56,A0A4R7BQC4,A0A1Q1FPH0,E0TGY3,A0A259TUP4,A0A1H0LH25,A0A318LG42,H1YCU5,A0A1Q5ZS75,A0A345E7N0,M0AF24,A0A1W2A082,A0A1H3X247,A0A0C1XUA0,M0D2X3,A0A2R5G167,A0A346PK63,A0A1H2RBI2,A0A1C3ZXN2,B9LVP8,M5RSF0,A0A343JEE2,,",366,37
"641","N.H5.12","N.S14.4",262,165,97,1.8203373945642,"4F1N,4F3T,4KRE,5GUH,5VM9,6OON,A0A163JTZ6,A0A196SDB4,J9D5G4,Q389P5,C4LVV2,A0A2P6N8X7,A0A0G4H2S4,T1H8B3,S4RWI0,A0A074TLL7,Q1K660,F4PH46,A0A3M7S814,A0A164ZA52,I0YVB2,R7QGN7,C1DZY0,A0A2C5Z0M1,A0CB11,R9ACY5,D3BMP8,A0A1Z5TVE5,W7XD45,A0A1U7LLR0,A0A4S2MWZ7,K1VVQ6,A0A158P1R9,G7DVX0,V6R0U9,E3KLI3,B7Q5I1,A0A1E3QC61,D5GGK8,S8ANP9,L2GMR6,U4LBG4,A0A177URI1,O74957,A0A3N4IGK1,A6N7Y9,A0A0E9NDK5,T1KZ60,A0A2G8JLH3,Q5KAT1,L2GUF2,W2T741,A0A1W0E4B5,A0A2J7QB22,S4RYE2,A0A388KES6,A0A3S3PD82,A0A0L0TEV1,A0A1S3J512,G0QTT2,A0A1J1HRI1,C4V9J2,Q9JMB7,A0A075AN09,Q5TW24,U5HIG6,A0A401PRI6,Q96J94,A0A2B4RHN2,G2QEV0,A0A397UU01,A0A2T7PFL8,K7ISV0,A0A024FT57,H3HCL6,A0A0G4IME3,E9FUN9,A0A1S3CYL5,D7FQK3,A0A1Y1YHC8,T1GSU4,F4S231,A0A2G5B1D8,Q5BD61,A0A1C7M8P2,A0A4D8YSQ3,A0A158PJG6,J9JZ66,A0A0C2XG51,A0A158QZT6,A0A165QYQ9,T0SAU8,R7YY92,A0A3S1A0C3,A0A074YJ47,A0A2K1J482,A0A1Q3ENA6,O04379,A0A371I3C8,M8AEW7,A8P0D4,A0A2K3NY65,F4NYW7,A0A409Y6G2,A0A0L0HAB7,D8PZT7,A0A1D1W4K0,A7RQ46,W4YU94,A7BJS5,D8SNM6,A0A1J8PPA3,X1WG39,M5FQK2,Q69VD5,A0A2R6NSC2,A0A0D8XL16,A0A016WPN3,Q9QZ81,G5EES3,A0A0K0EFP6,Q8CJG0,A0A1D5NTU6,V2WTL2,A0A0V0YLH8,A0A139WDH0,A0A0R3W9Q7,H3DS31,A0A1Y1HWP2,G4T5G9,B7QCC4,A0A0B2UV00,M7BCJ9,E9GN30,Q7PZ41,A0A077Z361,R7U9I3,A0A1X7V1N5,A0A0K0JDP1,A0A0N4UKJ1,A0A498N3A3,A0A3M0IQP5,A0A0L8GBV4,Q32KD4,A0A1J1JBJ0,E0W4C3,A0A482XDA9,A0A3P7EJD6,J9K2Z4,A0A2J7Q8V4,T1IBM6,V3ZRX0,A0A210QKF7,A0A423TSS1,K1PT78,A0A267E8R7,A0A1D2N447,A0A226D7A9,F6YK55,T1KTE4,A0A2C9JGZ6,A0A1V9X9F0,K5X5Z7,A0A3Q0KUG5,T1FY40,1YVU,3DLB,5AWH,5G5T,5I4A,6QZK,7R8K,C4L1M1,A0A1I3LMA1,A0A326U7G5,A0A1T4Y3A2,A0A0B0H9B4,R6KUL9,B7GJX9,A0A1N6SSK9,A0A2G9DT08,Q9L1X1,A0A235B542,R5XQK4,A0A496APJ8,A0A062U2W9,H0HWQ5,A0A1V9G9U4,S7VLM7,A0A1A5X8H4,A0A1I2T6Q1,A0A1R3T9N6,H8KXJ0,A0A2D1U4H7,A0A0B7I4Z6,A0LL61,A0A139WY18,A0A1J1EK56,A0A2T1E1K4,A0A1Q8ZD62,A0A4Q6XKV6,A0A1Z3HNN4,A0A239JE83,A0A2N4XBY2,Q53W94,R5JEI2,A0A0Q0ZC47,A0A2T0XH18,A0A1V4CHV0,A0A1K1RQP7,A0A1N6LUI7,A0A0P0NGR6,A0A1X7IML5,A0A0A2LKJ7,K1L112,A0A0U3AL92,A0A1H3A054,A0A0C5JKF3,R5NJJ8,A5D4D9,A0A142Y7A9,A0A432MEQ5,A0A372DKU2,C1F5Q7,A0A4R3EV39,A0A1P8WP90,A0A222F7P0,A0A1C9VH88,A0A2T2YMB1,A0A101R2A0,A0A1U9ND56,A0A4R7BQC4,E0TGY3,A0A259TUP4,F6EYI8,A0A2S9Q9J0,A0A4Q2UIU6,A0A1H0LH25,A0A318LG42,H1YCU5,A0A1Q5ZS75,M0AF24,A0A1W2A082,A0A0C1XUA0,M0D2X3,A0A2R5G167,A0A346PK63,R7RTW6,A0A1H2RBI2,A0A1C3ZXN2,M5RSF0,B7K585,F8D8G0,A0A343TL88,A0A343JEE2,A0A3P3RGE5,A0A329TBQ3,A0A0W1S8B8,L9VRQ2,E4NRV1,A0A1I6HGN0,A0A1I0NI68,,",366,37
"642","N.H8.12","N.H8.9",300,165,135,3.38451178451178,"4F1N,4F3T,4KRE,5GUH,5VM9,6KR6,6OON,7KX7,7SWF,A0A163JTZ6,J9D5G4,Q389P5,C4LVV2,A2DPV7,A0A0G4H2S4,T1H8B3,R1FDF0,S4RWI0,A0A074TLL7,A0A0D1ZAJ4,Q1K660,F4PH46,A0A3M7S814,A0A164ZA52,Q54G64,S7WCF7,I0YVB2,R7QGN7,C1DZY0,A0A2C5Z0M1,A0CB11,R9ACY5,D3BMP8,A0A1Z5TVE5,W7XD45,A0A1U7LLR0,A0A4S2MWZ7,K1VVQ6,A0A158P1R9,V6R0U9,G4N9J3,E3KLI3,B7Q5I1,A0A1E3QC61,D5GGK8,S8ANP9,A0A139AUH8,L2GMR6,U4LBG4,A0A177URI1,O74957,A0A3N4IGK1,A6N7Y9,A0A0E9NDK5,T1KZ60,A0A250WXN5,A0A2G8JLH3,Q5KAT1,L2GUF2,W2T741,A0A1W0E4B5,A0A2J7QB22,S4RYE2,A0A388KES6,A0A226EFL3,A0A3S3PD82,A0A0L0TEV1,A0A1S3J512,G0QTT2,A0A1J1HRI1,C4V9J2,Q9JMB7,A0A075AN09,Q5TW24,U5HIG6,A0A401PRI6,Q96J94,A0A2B4RHN2,A0A397UU01,A0A2T7PFL8,K7ISV0,A0A024FT57,H3HCL6,A0A0G4IME3,E9FUN9,A0A1S3CYL5,D7FQK3,A0A1Y1YHC8,T1GSU4,F4S231,A0A1D8PMK0,A0A2G5B1D8,A0A4D8YSQ3,A0A158PJG6,J9JZ66,A0A0C2XG51,A0A158QZT6,A0A165QYQ9,T0SAU8,A0A3S1A0C3,A0A2K1J482,A0A1Q3ENA6,O04379,A0A371I3C8,M8AEW7,A0A2K3NY65,F4NYW7,A0A409Y6G2,A0A0L0HAB7,A0A1D1W4K0,A7RQ46,W4YU94,A7BJS5,D8SNM6,A0A1J8PPA3,X1WG39,M5FQK2,Q69VD5,A0A0D8XL16,A0A016WPN3,Q9QZ81,G5EES3,A0A0K0EFP6,Q8CJG0,A0A1D5NTU6,A0A0V0YLH8,A0A139WDH0,A0A0R3W9Q7,H3DS31,A0A1Y1HWP2,G4T5G9,B7QCC4,A0A0B2UV00,M7BCJ9,E9GN30,Q7PZ41,A0A077Z361,R7U9I3,A0A1X7V1N5,A0A0K0JDP1,A0A0N4UKJ1,A0A498N3A3,A0A3M0IQP5,A0A0L8GBV4,Q32KD4,A0A1J1JBJ0,E0W4C3,A0A482XDA9,A0A3P7EJD6,J9K2Z4,A0A2J7Q8V4,T1IBM6,V3ZRX0,A0A210QKF7,A0A423TSS1,K1PT78,A0A267E8R7,A0A1D2N447,A0A226D7A9,F6YK55,T1KTE4,A0A2C9JGZ6,A0A1V9X9F0,A0A3Q0KUG5,T1FY40,1YVU,1Z26,5AWH,5G5T,5I4A,6QZK,7R8K,A0A1I7IXT4,A0A2W1JZ37,A0A2S7WBN3,A0A420DFE6,E0ST67,A0A4V1VDY2,A0A368P5I0,A0A4R1RMM2,A0A1Y2RDH8,Q11QW7,A0A1L3JHM3,A0A1W6MIP2,A0A1C0UUC4,A0A2U2J9E0,A0A142XB92,B1XJG0,H1KXR6,A0A1T4Y3A2,A0A0P6X5X2,A0A2G9DT08,Q9L1X1,A0A1H3LE92,A0A496APJ8,A0A062U2W9,H0HWQ5,A0A1V9G9U4,A0A1I2ZGP1,A0A317EJY3,A0A1I2BD20,F8ERC7,S7VLM7,A0A1A5X8H4,A0A1I2T6Q1,A0A1R3T9N6,A0A0Q2M2Z1,H8KXJ0,A0A2D1U4H7,I3TE64,A0A0B7I4Z6,A0LL61,Q8DKB1,A0A139WY18,A0A1J1EK56,A0A2T1E1K4,A0A1Q8ZD62,A0A4Q6XKV6,A0A1Z3HNN4,A0A239JE83,A0A2N4XBY2,Q53W94,R5JEI2,A0A0Q0ZC47,A0A2T0XH18,A0A1V4CHV0,A0A1K1RQP7,A0A2T1EKT1,A0A1N6LUI7,A0A0P0NGR6,A0A1X7IML5,A0A0A2LKJ7,K1L112,A0A0U3AL92,A0A1H3A054,E0UCX3,K9XZC6,B9LVW4,A0A0C1VHB4,Q31N05,A0A0C5JKF3,R5NJJ8,A5D4D9,Q2JI93,A0A142Y7A9,A0A432MEQ5,A0A372DKU2,A0A3R7KLK4,C1F5Q7,A0A4R3EV39,A0A1P8WP90,A0A222F7P0,A0A1C9VH88,A0A2T2YMB1,A0A329TD61,A0A101R2A0,A0A1E3XF49,A0A1U9ND56,A0A4R7BQC4,A0A1H3DGN3,A0A1Q1FPH0,E0TGY3,A0A259TUP4,F6EYI8,A0A2S9Q9J0,A0A4Q2UIU6,A0A1H0LH25,A0A318LG42,H1YCU5,L0JS08,A0A1Q5ZS75,A0A345E7N0,M0AF24,A0A1W2A082,A0A1H3X247,A0A0C1XUA0,M0D2X3,A0A2R5G167,A0A346PK63,R7RTW6,A0A1H2RBI2,A0A1C3ZXN2,B9LVP8,M5RSF0,W0JW77,B7K585,F8D8G0,A0A343TL88,L0AJX6,A0A2A5QS34,A0A343JEE2,A0A3P3RGE5,A0A329TBQ3,A0A285N2A8,A0A0W1S8B8,A0A1V4C8L7,L9VRQ2,E4NRV1,A0A1I6HGN0,A0A1I0NI68,,",366,37
"645","N.L7.4","N.S3.5",209,165,44,4.74318181818182,"4F1N,4F3T,4KRE,5GUH,5VM9,6OON,7SWF,A0A0N4X8S8,A0A196SDB4,Q389P5,C4LVV2,A8BCK6,A2DPV7,T1H8B3,S4RWI0,D2VMG4,Q1K660,A0A164ZA52,A0A383WDW5,S7WCF7,I0YVB2,R7QGN7,C1DZY0,A0A2C5Z0M1,A0CB11,R9ACY5,A0A1Z5TVE5,W7XD45,A0A1U7LLR0,A0A4S2MWZ7,K1VVQ6,A0A158P1R9,G7DVX0,V6R0U9,G4N9J3,E3KLI3,B7Q5I1,A0A1E3QC61,D5GGK8,S8ANP9,A0A139AUH8,L2GMR6,U4LBG4,A0A177URI1,O74957,A0A3N4IGK1,A6N7Y9,A0A0E9NDK5,A0A2G8JLH3,Q5KAT1,L2GUF2,A0A1W0E4B5,A0A2J7QB22,S4RYE2,A0A2K3CW87,A0A388KES6,A0A226EFL3,A0A0L0TEV1,A0A1S3J512,G0QTT2,A0A1J1HRI1,C4V9J2,Q9JMB7,A0A075AN09,Q5TW24,U5HIG6,A0A401PRI6,Q96J94,A0A2B4RHN2,G2QEV0,A0A397UU01,A0A2T7PFL8,K7ISV0,A0A024FT57,A0A0G4IME3,E9FUN9,A0A1S3CYL5,D7FQK3,A0A1Y1YHC8,T1GSU4,F4S231,A0A1D8PMK0,A0A2G5B1D8,Q5BD61,A0A1C7M8P2,A0A4D8YSQ3,A0A158PJG6,J9JZ66,A0A0C2XG51,A0A158QZT6,A0A165QYQ9,T0SAU8,R7YY92,A0A3S1A0C3,A0A074YJ47,A0A2K1J482,A0A1Q3ENA6,O04379,A0A371I3C8,M8AEW7,A8P0D4,A0A2K3NY65,F4NYW7,A0A409Y6G2,A0A0L0HAB7,D8PZT7,A0A1D1W4K0,A7RQ46,W4YU94,A7BJS5,D8SNM6,A0A1J8PPA3,X1WG39,M5FQK2,Q69VD5,A0A2R6NSC2,A0A0D8XL16,A0A016WPN3,Q9QZ81,G5EES3,A0A0K0EFP6,Q8CJG0,A0A1D5NTU6,V2WTL2,A0A0V0YLH8,A0A139WDH0,A0A0R3W9Q7,H3DS31,A0A1Y1HWP2,G4T5G9,B7QCC4,A0A0B2UV00,M7BCJ9,E9GN30,Q7PZ41,A0A077Z361,R7U9I3,A0A1X7V1N5,A0A0K0JDP1,A0A0N4UKJ1,A0A498N3A3,A0A3M0IQP5,A0A0L8GBV4,Q32KD4,A0A1J1JBJ0,E0W4C3,A0A482XDA9,A0A3P7EJD6,J9K2Z4,A0A2J7Q8V4,T1IBM6,V3ZRX0,A0A210QKF7,A0A423TSS1,K1PT78,A0A267E8R7,A0A1D2N447,A0A226D7A9,F6YK55,T1KTE4,A0A2C9JGZ6,A0A1V9X9F0,K5X5Z7,A0A3Q0KUG5,T1FY40,1Z26,5G5T,6QZK,A0A1I3LMA1,A0A0B0H9B4,R6KUL9,B7GJX9,A0A0P6X5X2,A0A1N6SSK9,A0A235B542,R5XQK4,A0A0Q2M2Z1,D3S0S6,I3TE64,Q8DKB1,A0A2T1EKT1,E0UCX3,K9XZC6,B9LVW4,A0A0C1VHB4,Q31N05,R5NJJ8,Q2JI93,A0A1Q1FPH0,L0JS08,M0AF24,A0A1H3X247,M0D2X3,A0A346PK63,R7RTW6,W0JW77,F8D8G0,A0A343TL88,L0AJX6,A0A2A5QS34,A0A343JEE2,A0A3P3RGE5,A0A329TBQ3,A0A285N2A8,A0A0W1S8B8,A0A1V4C8L7,L9VRQ2,E4NRV1,A0A1I6HGN0,,",366,37
"647","N.S11.3","N.S12.10",321,165,156,1.82517482517483,"4F1N,4F3T,4KRE,5GUH,5VM9,6KR6,6OON,7SWF,J9D5G4,Q389P5,C4LVV2,A2DPV7,A0A0G4H2S4,T1H8B3,R1FDF0,S4RWI0,D2VMG4,A0A0D1ZAJ4,Q1K660,F4PH46,A0A164ZA52,A0A383WDW5,Q54G64,S7WCF7,I0YVB2,R7QGN7,C1DZY0,A0A2C5Z0M1,A0CB11,R9ACY5,D3BMP8,A0A1Z5TVE5,W7XD45,A0A1U7LLR0,A0A4S2MWZ7,K1VVQ6,A0A158P1R9,G7DVX0,V6R0U9,G4N9J3,E3KLI3,B7Q5I1,A0A1E3QC61,D5GGK8,S8ANP9,A0A139AUH8,L2GMR6,U4LBG4,A0A177URI1,O74957,A0A3N4IGK1,A6N7Y9,A0A0E9NDK5,T1KZ60,A0A250WXN5,A0A2G8JLH3,Q5KAT1,L2GUF2,W2T741,A0A1W0E4B5,A0A2J7QB22,S4RYE2,A0A2K3CW87,A0A388KES6,A0A226EFL3,A0A3S3PD82,A0A0L0TEV1,A0A1S3J512,G0QTT2,A0A1J1HRI1,Q9JMB7,A0A075AN09,Q5TW24,U5HIG6,A0A401PRI6,Q96J94,A0A2B4RHN2,G2QEV0,A0A397UU01,A0A2T7PFL8,K7ISV0,A0A024FT57,H3HCL6,A0A0G4IME3,E9FUN9,A0A1S3CYL5,D7FQK3,A0A1Y1YHC8,T1GSU4,A0A1D8PMK0,A0A2G5B1D8,Q5BD61,A0A1C7M8P2,A0A4D8YSQ3,A0A158PJG6,J9JZ66,A0A0C2XG51,A0A158QZT6,A0A165QYQ9,T0SAU8,R7YY92,A0A3S1A0C3,A0A074YJ47,A0A2K1J482,A0A1Q3ENA6,O04379,A0A371I3C8,M8AEW7,A8P0D4,A0A2K3NY65,F4NYW7,A0A409Y6G2,A0A0L0HAB7,D8PZT7,A0A1D1W4K0,A7RQ46,W4YU94,A7BJS5,D8SNM6,A0A1J8PPA3,X1WG39,M5FQK2,Q69VD5,A0A2R6NSC2,A0A0D8XL16,A0A016WPN3,Q9QZ81,G5EES3,A0A0K0EFP6,Q8CJG0,A0A1D5NTU6,V2WTL2,A0A0V0YLH8,A0A0R3W9Q7,H3DS31,A0A1Y1HWP2,G4T5G9,A0A0B2UV00,E9GN30,Q7PZ41,A0A077Z361,R7U9I3,A0A1X7V1N5,A0A0K0JDP1,A0A0N4UKJ1,A0A498N3A3,A0A0L8GBV4,Q32KD4,A0A1J1JBJ0,E0W4C3,A0A482XDA9,A0A3P7EJD6,J9K2Z4,A0A2J7Q8V4,T1IBM6,A0A210QKF7,A0A423TSS1,K1PT78,A0A267E8R7,A0A226D7A9,T1KTE4,A0A2C9JGZ6,A0A1V9X9F0,K5X5Z7,A0A3Q0KUG5,1YVU,1Z26,3DLB,5AWH,5G5T,5I4A,6QZK,7R8K,A0A1I7IXT4,A0A2W1JZ37,A0A2S7WBN3,A0A420DFE6,A0A4V1VDY2,A0A368P5I0,C4L1M1,A0A1I3LMA1,K9TPA9,B1XJG0,A0A326U7G5,A0A3D8L290,K9U8J6,K9RC91,A0A0D8ZUC0,A0A139XGN8,A0A1T4Y3A2,A0A0B0H9B4,A0YYT3,A0A2T1EFY0,G6FTN0,R6KUL9,A0A433NB65,A0A1Z4L0A1,K9UQR0,A0A2T1G8M7,K9VUN0,B7GJX9,K9ZDE3,B0JXD6,A0A2T1LS63,A0A1Z4K1Y3,A0A1N6SSK9,A0A0P4UVI8,A0A0V7ZCG4,A0A1J0AGK2,K9PFF9,A0A2G9DT08,K9UEV4,Q9L1X1,A0A060HNJ0,A0A235B542,R5XQK4,A0A1H3LE92,A0A496APJ8,A0A062U2W9,H0HWQ5,A0A1V9G9U4,A0A1I2ZGP1,A0A317EJY3,A0A1I2BD20,F8ERC7,S7VLM7,A0A1A5X8H4,A0A1I2T6Q1,A0A1R3T9N6,A0A0Q2M2Z1,H8KXJ0,D3S0S6,A0A2D1U4H7,I3TE64,A0A0B7I4Z6,A0LL61,Q8DKB1,A0A139WY18,A0A1J1EK56,A0A2T1E1K4,A0A1Q8ZD62,A0A4Q6XKV6,A0A1Z3HNN4,A0A239JE83,A0A2N4XBY2,Q53W94,R5JEI2,A0A0Q0ZC47,A0A2T0XH18,A0A1V4CHV0,A0A1K1RQP7,A0A2T1EKT1,A0A1N6LUI7,A0A0P0NGR6,A0A1X7IML5,A0A0A2LKJ7,K1L112,A0A0U3AL92,A0A1H3A054,E0UCX3,K9XZC6,B9LVW4,A0A0C1VHB4,Q31N05,A0A0C5JKF3,A5D4D9,Q2JI93,A0A142Y7A9,A0A432MEQ5,A0A372DKU2,C1F5Q7,A0A4R3EV39,A0A1P8WP90,A0A222F7P0,A0A1C9VH88,A0A2T2YMB1,A0A329TD61,A0A101R2A0,A0A1E3XF49,A0A1U9ND56,A0A4R7BQC4,A0A1Q1FPH0,E0TGY3,A0A259TUP4,F6EYI8,A0A2S9Q9J0,A0A4Q2UIU6,A0A1H0LH25,A0A318LG42,H1YCU5,L0JS08,A0A1Q5ZS75,A0A345E7N0,M0AF24,A0A1W2A082,A0A1H3X247,A0A0C1XUA0,M0D2X3,A0A2R5G167,A0A346PK63,R7RTW6,A0A1H2RBI2,A0A1C3ZXN2,B9LVP8,M5RSF0,W0JW77,B7K585,F8D8G0,A0A343TL88,L0AJX6,A0A2A5QS34,A0A343JEE2,A0A3P3RGE5,A0A329TBQ3,A0A285N2A8,A0A0W1S8B8,A0A1V4C8L7,L9VRQ2,E4NRV1,A0A1I6HGN0,A0A1I0NI68,,",366,37
"648","N.S13.2","N.S14.4",284,165,119,1.37440794499618,"4F1N,4F3T,4KRE,5GUH,6OON,7SWF,A0A163JTZ6,A0A196SDB4,J9D5G4,A0A2P6N8X7,A8BCK6,A0A0G4H2S4,T1H8B3,S4RWI0,D2VMG4,A0A074TLL7,Q1K660,F4PH46,A0A3M7S814,A0A164ZA52,A0A383WDW5,Q54G64,S7WCF7,C1DZY0,A0A2C5Z0M1,A0CB11,D3BMP8,A0A1Z5TVE5,W7XD45,A0A1U7LLR0,A0A4S2MWZ7,K1VVQ6,A0A158P1R9,G7DVX0,V6R0U9,G4N9J3,E3KLI3,B7Q5I1,A0A1E3QC61,D5GGK8,S8ANP9,A0A139AUH8,L2GMR6,U4LBG4,A0A177URI1,O74957,A0A3N4IGK1,A6N7Y9,A0A0E9NDK5,T1KZ60,A0A250WXN5,A0A2G8JLH3,Q5KAT1,L2GUF2,W2T741,A0A2J7QB22,S4RYE2,A0A388KES6,A0A226EFL3,A0A3S3PD82,A0A0L0TEV1,A0A1S3J512,G0QTT2,A0A1J1HRI1,Q9JMB7,A0A075AN09,Q5TW24,U5HIG6,A0A401PRI6,Q96J94,A0A2B4RHN2,G2QEV0,A0A397UU01,A0A2T7PFL8,K7ISV0,A0A024FT57,A0A0G4IME3,E9FUN9,A0A1S3CYL5,D7FQK3,A0A1Y1YHC8,T1GSU4,F4S231,A0A1D8PMK0,A0A2G5B1D8,Q5BD61,A0A1C7M8P2,A0A4D8YSQ3,A0A158PJG6,J9JZ66,A0A0C2XG51,A0A158QZT6,A0A165QYQ9,T0SAU8,R7YY92,A0A3S1A0C3,A0A074YJ47,A0A2K1J482,A0A1Q3ENA6,O04379,A0A371I3C8,M8AEW7,A0A2K3NY65,F4NYW7,A0A409Y6G2,A0A0L0HAB7,D8PZT7,A0A1D1W4K0,A7RQ46,W4YU94,A7BJS5,D8SNM6,A0A1J8PPA3,X1WG39,M5FQK2,Q69VD5,A0A0D8XL16,A0A016WPN3,Q9QZ81,G5EES3,A0A0K0EFP6,Q8CJG0,A0A1D5NTU6,V2WTL2,A0A0V0YLH8,A0A139WDH0,A0A0R3W9Q7,H3DS31,A0A1Y1HWP2,G4T5G9,B7QCC4,A0A0B2UV00,M7BCJ9,E9GN30,Q7PZ41,A0A077Z361,R7U9I3,A0A1X7V1N5,A0A0K0JDP1,A0A0N4UKJ1,A0A498N3A3,A0A3M0IQP5,A0A0L8GBV4,Q32KD4,A0A1J1JBJ0,E0W4C3,A0A482XDA9,A0A3P7EJD6,J9K2Z4,A0A2J7Q8V4,T1IBM6,V3ZRX0,A0A210QKF7,A0A423TSS1,K1PT78,A0A267E8R7,A0A1D2N447,A0A226D7A9,F6YK55,T1KTE4,A0A2C9JGZ6,A0A1V9X9F0,K5X5Z7,A0A3Q0KUG5,T1FY40,1YVU,3DLB,5AWH,5G5T,5I4A,6QZK,E8N0K8,A0A328VKE4,E0ST67,A0A0M2PXX3,K9TPA9,A0A1C0UUC4,A0A2Z6E1D5,B1XJG0,A0A326U7G5,A0A1Q4R485,K9U8J6,K9RC91,A0A0D8ZUC0,A0A139XGN8,A0A1T4Y3A2,A0YYT3,A0A2T1EFY0,G6FTN0,A0A433NB65,A0A1Z4L0A1,K9UQR0,A0A2T1G8M7,K9VUN0,K9ZDE3,B0JXD6,A0A2T1LS63,A0A1Z4K1Y3,A0A1N6SSK9,A0A0P4UVI8,A0A0V7ZCG4,A0A1J0AGK2,K9PFF9,A0A2G9DT08,K9UEV4,Q9L1X1,A0A496APJ8,A0A062U2W9,H0HWQ5,A0A1V9G9U4,A0A1I2ZGP1,A0A1I2BD20,F8ERC7,S7VLM7,A0A1A5X8H4,A0A1I2T6Q1,A0A1R3T9N6,A0A0Q2M2Z1,H8KXJ0,A0A2D1U4H7,A0A0B7I4Z6,A0LL61,A0A139WY18,A0A2T1E1K4,A0A1Q8ZD62,A0A4Q6XKV6,A0A1Z3HNN4,A0A239JE83,A0A2N4XBY2,R5JEI2,A0A1V4CHV0,A0A1K1RQP7,A0A1N6LUI7,A0A0P0NGR6,A0A1X7IML5,A0A0A2LKJ7,A0A0U3AL92,A0A1H3A054,B9LVW4,A0A0C5JKF3,A5D4D9,A0A142Y7A9,A0A432MEQ5,A0A372DKU2,A0A4R3EV39,A0A1P8WP90,A0A222F7P0,A0A1C9VH88,A0A2T2YMB1,A0A101R2A0,A0A1U9ND56,A0A4R7BQC4,E0TGY3,A0A259TUP4,F6EYI8,A0A2S9Q9J0,A0A4Q2UIU6,A0A1H0LH25,A0A318LG42,H1YCU5,A0A1Q5ZS75,M0AF24,A0A0C1XUA0,M0D2X3,A0A2R5G167,A0A346PK63,R7RTW6,A0A1H2RBI2,A0A1C3ZXN2,W0JW77,B7K585,F8D8G0,A0A343TL88,L0AJX6,A0A2A5QS34,A0A343JEE2,A0A3P3RGE5,A0A329TBQ3,A0A285N2A8,A0A0W1S8B8,A0A1V4C8L7,L9VRQ2,E4NRV1,A0A1I6HGN0,,",366,37
"650","N.S18.4","N.S19.1",267,165,102,1.43119429590018,"4F3T,4KRE,5GUH,5VM9,6KR6,6OON,7KX7,A0A163JTZ6,A0A0N4X8S8,A0A196SDB4,C4LVV2,A0A2P6N8X7,A8BCK6,A2DPV7,T1H8B3,R1FDF0,S4RWI0,D2VMG4,A0A074TLL7,Q1K660,F4PH46,A0A3M7S814,A0A383WDW5,Q54G64,S7WCF7,I0YVB2,R7QGN7,C1DZY0,A0A2C5Z0M1,A0CB11,R9ACY5,D3BMP8,A0A1Z5TVE5,W7XD45,A0A1U7LLR0,A0A4S2MWZ7,A0A158P1R9,V6R0U9,G4N9J3,E3KLI3,D5GGK8,S8ANP9,A0A139AUH8,L2GMR6,U4LBG4,A0A177URI1,O74957,A6N7Y9,A0A0E9NDK5,T1KZ60,A0A250WXN5,A0A2G8JLH3,Q5KAT1,L2GUF2,W2T741,A0A2J7QB22,S4RYE2,A0A2K3CW87,A0A388KES6,A0A226EFL3,A0A3S3PD82,A0A1S3J512,G0QTT2,A0A1J1HRI1,Q9JMB7,A0A075AN09,Q5TW24,U5HIG6,A0A401PRI6,Q96J94,A0A2B4RHN2,G2QEV0,A0A397UU01,A0A2T7PFL8,K7ISV0,A0A024FT57,H3HCL6,A0A0G4IME3,E9FUN9,A0A1S3CYL5,D7FQK3,A0A1Y1YHC8,T1GSU4,F4S231,A0A2G5B1D8,Q5BD61,A0A1C7M8P2,A0A4D8YSQ3,A0A158PJG6,J9JZ66,A0A0C2XG51,A0A158QZT6,T0SAU8,R7YY92,A0A3S1A0C3,A0A2K1J482,A0A1Q3ENA6,O04379,A0A371I3C8,M8AEW7,A8P0D4,A0A2K3NY65,F4NYW7,A0A409Y6G2,A0A0L0HAB7,D8PZT7,A0A1D1W4K0,A7RQ46,W4YU94,A7BJS5,D8SNM6,A0A1J8PPA3,X1WG39,M5FQK2,Q69VD5,A0A2R6NSC2,A0A0D8XL16,A0A016WPN3,Q9QZ81,G5EES3,A0A0K0EFP6,Q8CJG0,A0A1D5NTU6,V2WTL2,A0A0V0YLH8,A0A139WDH0,A0A0R3W9Q7,H3DS31,A0A1Y1HWP2,G4T5G9,B7QCC4,A0A0B2UV00,M7BCJ9,E9GN30,Q7PZ41,A0A077Z361,R7U9I3,A0A1X7V1N5,A0A0K0JDP1,A0A0N4UKJ1,A0A498N3A3,A0A3M0IQP5,A0A0L8GBV4,Q32KD4,A0A1J1JBJ0,E0W4C3,A0A482XDA9,A0A3P7EJD6,J9K2Z4,A0A2J7Q8V4,T1IBM6,V3ZRX0,A0A210QKF7,A0A423TSS1,K1PT78,A0A267E8R7,A0A1D2N447,A0A226D7A9,F6YK55,T1KTE4,A0A2C9JGZ6,A0A1V9X9F0,K5X5Z7,A0A3Q0KUG5,T1FY40,1Z26,3DLB,5AWH,5G5T,5I4A,6QZK,7R8K,C4L1M1,A0A0M2PXX3,A0A1I3LMA1,A0A1C0UUC4,A0A1T4Y3A2,A0A0B0H9B4,R6KUL9,B7GJX9,A0A1N6SSK9,A0A2G9DT08,Q9L1X1,A0A060HNJ0,A0A235B542,R5XQK4,A0A062U2W9,H0HWQ5,A0A1I2ZGP1,A0A317EJY3,A0A1I2BD20,F8ERC7,S7VLM7,A0A1A5X8H4,A0A1I2T6Q1,A0A1R3T9N6,A0A0Q2M2Z1,H8KXJ0,D3S0S6,A0A2D1U4H7,I3TE64,A0A0B7I4Z6,A0LL61,Q8DKB1,A0A139WY18,A0A1J1EK56,A0A4Q6XKV6,A0A1Z3HNN4,A0A239JE83,A0A2N4XBY2,Q53W94,R5JEI2,A0A0Q0ZC47,A0A2T0XH18,A0A1V4CHV0,A0A1K1RQP7,A0A2T1EKT1,A0A1N6LUI7,A0A0P0NGR6,A0A1X7IML5,A0A0A2LKJ7,K1L112,A0A0U3AL92,E0UCX3,K9XZC6,A0A0C1VHB4,Q31N05,A0A0C5JKF3,A5D4D9,Q2JI93,A0A142Y7A9,A0A372DKU2,C1F5Q7,A0A4R3EV39,A0A1P8WP90,A0A222F7P0,A0A1C9VH88,A0A2T2YMB1,A0A101R2A0,A0A1E3XF49,A0A1U9ND56,A0A1Q1FPH0,E0TGY3,A0A259TUP4,F6EYI8,A0A2S9Q9J0,A0A4Q2UIU6,A0A1H0LH25,A0A318LG42,L0JS08,A0A345E7N0,M0AF24,A0A1H3X247,A0A0C1XUA0,M0D2X3,A0A346PK63,B9LVP8,M5RSF0,F8D8G0,A0A343TL88,A0A3P3RGE5,A0A329TBQ3,A0A0W1S8B8,L9VRQ2,E4NRV1,A0A1I6HGN0,A0A1I0NI68,,",366,37
"656","C.L2.1","C.L3.13",305,166,139,2.17998613157667,"4F1N,4F3T,4KRE,5GUH,5VM9,6KR6,6OON,7KX7,7SWF,A0A163JTZ6,A0A0N4X8S8,J9D5G4,T1H8B3,S4RWI0,D2VMG4,A0A074TLL7,A0A0D1ZAJ4,Q1K660,A0A3M7S814,A0A164ZA52,A0A383WDW5,I0YVB2,R7QGN7,A0A2C5Z0M1,A0CB11,R9ACY5,A0A1Z5TVE5,W7XD45,A0A1U7LLR0,A0A4S2MWZ7,K1VVQ6,A0A158P1R9,V6R0U9,G4N9J3,E3KLI3,B7Q5I1,A0A1E3QC61,D5GGK8,S8ANP9,A0A139AUH8,L2GMR6,U4LBG4,A0A177URI1,O74957,A0A3N4IGK1,A6N7Y9,A0A0E9NDK5,T1KZ60,A0A250WXN5,A0A2G8JLH3,Q5KAT1,L2GUF2,W2T741,A0A1W0E4B5,A0A2J7QB22,S4RYE2,A0A2K3CW87,A0A388KES6,A0A226EFL3,A0A0L0TEV1,A0A1S3J512,G0QTT2,A0A1J1HRI1,C4V9J2,Q9JMB7,A0A075AN09,Q5TW24,A0A401PRI6,Q96J94,A0A2B4RHN2,G2QEV0,A0A397UU01,A0A2T7PFL8,K7ISV0,A0A024FT57,H3HCL6,A0A0G4IME3,E9FUN9,A0A1S3CYL5,D7FQK3,A0A1Y1YHC8,T1GSU4,F4S231,A0A1D8PMK0,A0A2G5B1D8,Q5BD61,A0A1C7M8P2,A0A4D8YSQ3,A0A158PJG6,A0A0C2XG51,A0A158QZT6,A0A165QYQ9,T0SAU8,R7YY92,A0A3S1A0C3,A0A074YJ47,A0A2K1J482,A0A1Q3ENA6,O04379,A0A371I3C8,M8AEW7,A8P0D4,A0A2K3NY65,F4NYW7,A0A409Y6G2,A0A0L0HAB7,D8PZT7,A0A1D1W4K0,A7RQ46,W4YU94,A7BJS5,D8SNM6,A0A1J8PPA3,X1WG39,M5FQK2,Q69VD5,A0A2R6NSC2,A0A0D8XL16,A0A016WPN3,Q9QZ81,G5EES3,A0A0K0EFP6,Q8CJG0,A0A1D5NTU6,V2WTL2,A0A0V0YLH8,A0A139WDH0,A0A0R3W9Q7,H3DS31,A0A1Y1HWP2,G4T5G9,B7QCC4,A0A0B2UV00,M7BCJ9,E9GN30,Q7PZ41,A0A077Z361,R7U9I3,A0A1X7V1N5,A0A0K0JDP1,A0A0N4UKJ1,A0A498N3A3,A0A3M0IQP5,A0A0L8GBV4,Q32KD4,A0A1J1JBJ0,E0W4C3,A0A482XDA9,A0A3P7EJD6,J9K2Z4,A0A2J7Q8V4,T1IBM6,V3ZRX0,A0A210QKF7,A0A423TSS1,K1PT78,A0A267E8R7,A0A1D2N447,A0A226D7A9,F6YK55,T1KTE4,A0A2C9JGZ6,A0A1V9X9F0,K5X5Z7,A0A3Q0KUG5,T1FY40,1YVU,1Z26,5AWH,5I4A,7R8K,A0A1I7IXT4,A0A2W1JZ37,A0A2S7WBN3,A0A420DFE6,A0A4V1VDY2,A0A368P5I0,C4L1M1,A0A4R1RMM2,A0A1Y2RDH8,A0A1M5ZSR3,A0A0K8QX04,A0A1I3LMA1,A0A1L3JHM3,A0A1W6MIP2,A0A2U2J9E0,A0A2Z6E1D5,A0A0F4NXW8,L8D0R3,B1XJG0,A0A3D8L290,K9U8J6,A0A0D8ZUC0,A0A1T4Y3A2,Q5P0R2,A0A0B0H9B4,A0YYT3,R6KUL9,A0A433NB65,A0A1Z4L0A1,A0A2T1G8M7,B7GJX9,K9ZDE3,B0JXD6,A0A2T1LS63,A0A2Z6E0R7,A0A1J0AGK2,K9PFF9,A0A2G9DT08,Q9L1X1,A0A060HNJ0,A0A235B542,R5XQK4,A0A1H3LE92,A0A496APJ8,A0A062U2W9,H0HWQ5,A0A1V9G9U4,F8ERC7,S7VLM7,A0A1A5X8H4,A0A1I2T6Q1,A0A1R3T9N6,A0A0Q2M2Z1,H8KXJ0,A0A2D1U4H7,A0A0B7I4Z6,A0LL61,Q8DKB1,A0A139WY18,A0A1J1EK56,A0A2T1E1K4,A0A1Q8ZD62,A0A4Q6XKV6,A0A1Z3HNN4,A0A239JE83,A0A2N4XBY2,Q53W94,R5JEI2,A0A0Q0ZC47,A0A2T0XH18,A0A1V4CHV0,A0A1K1RQP7,A0A2T1EKT1,A0A1N6LUI7,A0A0P0NGR6,A0A1X7IML5,A0A0A2LKJ7,K1L112,A0A0U3AL92,A0A1H3A054,E0UCX3,K9XZC6,B9LVW4,A0A0C1VHB4,Q31N05,A0A0C5JKF3,R5NJJ8,A5D4D9,A0A142Y7A9,A0A432MEQ5,A0A372DKU2,A0A3R7KLK4,A0A4R3EV39,A0A1P8WP90,A0A222F7P0,A0A1C9VH88,A0A2T2YMB1,A0A101R2A0,A0A1E3XF49,A0A1U9ND56,A0A4R7BQC4,A0A1H3DGN3,E0TGY3,A0A259TUP4,F6EYI8,A0A2S9Q9J0,A0A4Q2UIU6,A0A1H0LH25,A0A318LG42,L0JS08,M0AF24,A0A0C1XUA0,M0D2X3,A0A2R5G167,A0A346PK63,R7RTW6,B9LVP8,M5RSF0,W0JW77,B7K585,F8D8G0,A0A343TL88,L0AJX6,A0A2A5QS34,A0A343JEE2,A0A3P3RGE5,A0A329TBQ3,A0A285N2A8,A0A0W1S8B8,A0A1V4C8L7,L9VRQ2,E4NRV1,A0A1I6HGN0,A0A1I0NI68,,",366,37
"657","C.S15.1","C.S16.2",268,166,102,4.75147649421214,"4F1N,4F3T,4KRE,5VM9,6OON,7KX7,7SWF,A0A163JTZ6,A0A0N4X8S8,A0A196SDB4,J9D5G4,A0A2P6N8X7,A8BCK6,A2DPV7,A0A0G4H2S4,D2VMG4,A0A074TLL7,A0A0D1ZAJ4,Q1K660,F4PH46,A0A3M7S814,A0A164ZA52,A0A383WDW5,Q54G64,I0YVB2,R7QGN7,C1DZY0,A0A2C5Z0M1,A0CB11,R9ACY5,D3BMP8,A0A1Z5TVE5,W7XD45,A0A1U7LLR0,A0A4S2MWZ7,K1VVQ6,A0A158P1R9,G7DVX0,V6R0U9,G4N9J3,E3KLI3,A0A1E3QC61,D5GGK8,S8ANP9,A0A139AUH8,L2GMR6,U4LBG4,A0A177URI1,O74957,A0A3N4IGK1,A6N7Y9,A0A0E9NDK5,A0A250WXN5,A0A2G8JLH3,Q5KAT1,L2GUF2,W2T741,A0A1W0E4B5,S4RYE2,A0A2K3CW87,A0A388KES6,A0A3S3PD82,A0A0L0TEV1,A0A1S3J512,G0QTT2,C4V9J2,Q9JMB7,U5HIG6,A0A401PRI6,Q96J94,A0A2B4RHN2,G2QEV0,A0A397UU01,A0A2T7PFL8,A0A024FT57,H3HCL6,A0A0G4IME3,A0A1S3CYL5,D7FQK3,A0A1Y1YHC8,T1GSU4,F4S231,A0A1D8PMK0,A0A2G5B1D8,Q5BD61,A0A1C7M8P2,A0A4D8YSQ3,A0A158PJG6,J9JZ66,A0A0C2XG51,A0A158QZT6,A0A165QYQ9,T0SAU8,R7YY92,A0A3S1A0C3,A0A074YJ47,A0A2K1J482,A0A1Q3ENA6,O04379,A0A371I3C8,M8AEW7,A8P0D4,A0A2K3NY65,F4NYW7,A0A409Y6G2,A0A0L0HAB7,D8PZT7,A0A1D1W4K0,A7RQ46,W4YU94,A7BJS5,D8SNM6,A0A1J8PPA3,X1WG39,M5FQK2,Q69VD5,A0A2R6NSC2,A0A0D8XL16,A0A016WPN3,Q9QZ81,G5EES3,A0A0K0EFP6,Q8CJG0,A0A1D5NTU6,V2WTL2,A0A0V0YLH8,A0A139WDH0,A0A0R3W9Q7,H3DS31,A0A1Y1HWP2,G4T5G9,B7QCC4,A0A0B2UV00,M7BCJ9,E9GN30,Q7PZ41,A0A077Z361,R7U9I3,A0A1X7V1N5,A0A0K0JDP1,A0A0N4UKJ1,A0A498N3A3,A0A3M0IQP5,A0A0L8GBV4,Q32KD4,A0A1J1JBJ0,E0W4C3,A0A482XDA9,A0A3P7EJD6,J9K2Z4,A0A2J7Q8V4,T1IBM6,V3ZRX0,A0A210QKF7,A0A423TSS1,K1PT78,A0A267E8R7,A0A1D2N447,A0A226D7A9,F6YK55,T1KTE4,A0A2C9JGZ6,A0A1V9X9F0,K5X5Z7,A0A3Q0KUG5,T1FY40,1Z26,7R8K,A0A328VKE4,E0ST67,C4L1M1,Q11QW7,A0A1M5ZSR3,A0A0K8QX04,A0A0M2PXX3,K9TPA9,A0A1L3JHM3,A0A1C0UUC4,A0A142XB92,B1XJG0,A0A326U7G5,A0A1Q4R485,K9U8J6,A0A097QRL6,K9RC91,A0A0D8ZUC0,A0A139XGN8,A0A0B0H9B4,A0YYT3,A0A2T1EFY0,G6FTN0,A0A433NB65,A0A1Z4L0A1,K9UQR0,A0A2T1G8M7,K9VUN0,A0A0P6X5X2,K9ZDE3,B0JXD6,A0A2T1LS63,A0A1Z4K1Y3,A0A1N6SSK9,A0A0P4UVI8,A0A0V7ZCG4,A0A1J0AGK2,K9PFF9,K9UEV4,A0A235B542,R5XQK4,A0A496APJ8,A0A062U2W9,H0HWQ5,A0A1V9G9U4,A0A1I2ZGP1,A0A317EJY3,A0A1I2BD20,F8ERC7,S7VLM7,A0A0Q2M2Z1,H8KXJ0,D3S0S6,A0A2D1U4H7,I3TE64,A0A0B7I4Z6,A0A139WY18,A0A1J1EK56,A0A2T1E1K4,A0A1Q8ZD62,A0A4Q6XKV6,A0A1Z3HNN4,A0A239JE83,Q53W94,A0A0Q0ZC47,A0A2T0XH18,A0A1K1RQP7,A0A0P0NGR6,A0A1X7IML5,A0A0A2LKJ7,K1L112,A0A329TD61,A0A1E3XF49,A0A259TUP4,A0A2S9Q9J0,A0A4Q2UIU6,H1YCU5,L0JS08,A0A1Q5ZS75,A0A345E7N0,M0AF24,A0A1W2A082,A0A1H3X247,A0A0C1XUA0,M0D2X3,A0A346PK63,R7RTW6,A0A1C3ZXN2,B9LVP8,M5RSF0,A0A343TL88,A0A343JEE2,A0A3P3RGE5,A0A329TBQ3,A0A285N2A8,A0A0W1S8B8,L9VRQ2,E4NRV1,A0A1I6HGN0,A0A1I0NI68,,",366,37
"671","C.H3.1","C.H3.3",279,167,112,2.95025128314799,"4F1N,4F3T,4KRE,5GUH,5VM9,6KR6,6OON,7KX7,7SWF,A0A163JTZ6,J9D5G4,Q389P5,A0A0G4H2S4,T1H8B3,S4RWI0,D2VMG4,A0A0D1ZAJ4,F4PH46,A0A3M7S814,A0A164ZA52,Q54G64,S7WCF7,I0YVB2,R7QGN7,C1DZY0,A0CB11,R9ACY5,D3BMP8,A0A1Z5TVE5,W7XD45,A0A1U7LLR0,A0A4S2MWZ7,K1VVQ6,A0A158P1R9,G7DVX0,V6R0U9,G4N9J3,E3KLI3,B7Q5I1,A0A1E3QC61,D5GGK8,L2GMR6,U4LBG4,A0A177URI1,O74957,A0A3N4IGK1,A6N7Y9,A0A0E9NDK5,T1KZ60,A0A250WXN5,A0A2G8JLH3,Q5KAT1,L2GUF2,W2T741,A0A1W0E4B5,A0A2J7QB22,S4RYE2,A0A2K3CW87,A0A226EFL3,A0A3S3PD82,A0A0L0TEV1,A0A1S3J512,G0QTT2,A0A1J1HRI1,C4V9J2,Q9JMB7,A0A075AN09,Q5TW24,U5HIG6,A0A401PRI6,Q96J94,A0A2B4RHN2,G2QEV0,A0A397UU01,A0A2T7PFL8,K7ISV0,A0A024FT57,H3HCL6,A0A0G4IME3,E9FUN9,A0A1S3CYL5,D7FQK3,A0A1Y1YHC8,A0A1D8PMK0,A0A2G5B1D8,Q5BD61,A0A1C7M8P2,A0A4D8YSQ3,A0A158PJG6,J9JZ66,A0A0C2XG51,A0A158QZT6,A0A165QYQ9,T0SAU8,R7YY92,A0A3S1A0C3,A0A074YJ47,A0A2K1J482,A0A1Q3ENA6,O04379,A0A371I3C8,M8AEW7,A8P0D4,A0A2K3NY65,F4NYW7,A0A409Y6G2,A0A0L0HAB7,D8PZT7,A0A1D1W4K0,A7RQ46,W4YU94,A7BJS5,D8SNM6,A0A1J8PPA3,X1WG39,M5FQK2,Q69VD5,A0A2R6NSC2,A0A0D8XL16,A0A016WPN3,Q9QZ81,G5EES3,A0A0K0EFP6,Q8CJG0,A0A1D5NTU6,V2WTL2,A0A0V0YLH8,A0A139WDH0,A0A0R3W9Q7,H3DS31,A0A1Y1HWP2,G4T5G9,B7QCC4,A0A0B2UV00,M7BCJ9,E9GN30,Q7PZ41,A0A077Z361,R7U9I3,A0A1X7V1N5,A0A0K0JDP1,A0A0N4UKJ1,A0A498N3A3,A0A3M0IQP5,A0A0L8GBV4,Q32KD4,A0A1J1JBJ0,E0W4C3,A0A482XDA9,A0A3P7EJD6,J9K2Z4,A0A2J7Q8V4,T1IBM6,V3ZRX0,A0A210QKF7,A0A423TSS1,K1PT78,A0A267E8R7,A0A1D2N447,A0A226D7A9,F6YK55,T1KTE4,A0A2C9JGZ6,A0A1V9X9F0,K5X5Z7,A0A3Q0KUG5,T1FY40,1YVU,1Z26,3DLB,5AWH,6QZK,A0A328VKE4,Q11QW7,A0A0M2PXX3,K9TPA9,A0A1C0UUC4,A0A142XB92,B1XJG0,A0A1Q4R485,K9U8J6,K9RC91,A0A0D8ZUC0,A0A139XGN8,A0A1T4Y3A2,B6YTQ5,A0YYT3,A0A2T1EFY0,G6FTN0,A0A433NB65,A0A1Z4L0A1,K9UQR0,A0A2T1G8M7,K9VUN0,K9ZDE3,B0JXD6,A0A2T1LS63,A0A1Z4K1Y3,A0A0P4UVI8,A0A0V7ZCG4,A0A1J0AGK2,K9PFF9,A0A2G9DT08,K9UEV4,Q9L1X1,A0A496APJ8,A0A1V9G9U4,S7VLM7,A0A1A5X8H4,A0A1I2T6Q1,A0A1R3T9N6,H8KXJ0,A0A2D1U4H7,A0A0B7I4Z6,A0LL61,A0A139WY18,A0A1J1EK56,A0A2T1E1K4,A0A1Q8ZD62,A0A4Q6XKV6,A0A1Z3HNN4,A0A239JE83,A0A2N4XBY2,Q53W94,R5JEI2,A0A0Q0ZC47,A0A2T0XH18,A0A1V4CHV0,A0A1K1RQP7,A0A1N6LUI7,A0A0P0NGR6,A0A1X7IML5,A0A0A2LKJ7,K1L112,A0A0U3AL92,A0A1H3A054,E0UCX3,K9XZC6,Q31N05,A0A0C5JKF3,A5D4D9,Q2JI93,A0A142Y7A9,A0A432MEQ5,A0A372DKU2,C1F5Q7,A0A4R3EV39,A0A1P8WP90,A0A222F7P0,A0A1C9VH88,A0A2T2YMB1,A0A101R2A0,A0A1U9ND56,A0A4R7BQC4,E0TGY3,A0A259TUP4,F6EYI8,A0A2S9Q9J0,A0A4Q2UIU6,A0A1H0LH25,A0A318LG42,L0JS08,M0AF24,A0A1W2A082,M0D2X3,A0A2R5G167,A0A346PK63,M5RSF0,B7K585,F8D8G0,A0A343TL88,A0A3P3RGE5,A0A329TBQ3,A0A0W1S8B8,A0A1V4C8L7,L9VRQ2,E4NRV1,A0A1I6HGN0,A0A1I0NI68,,",366,37
"672","C.H4.1","C.H4.4",318,167,151,3.74299083951303,"4F1N,4F3T,4KRE,5GUH,5VM9,6KR6,6OON,7KX7,7SWF,A0A163JTZ6,A0A0N4X8S8,J9D5G4,C4LVV2,A0A2P6N8X7,A2DPV7,A0A0G4H2S4,T1H8B3,S4RWI0,D2VMG4,A0A0D1ZAJ4,Q1K660,F4PH46,A0A3M7S814,A0A164ZA52,Q54G64,S7WCF7,I0YVB2,A0A2C5Z0M1,A0CB11,R9ACY5,D3BMP8,A0A1Z5TVE5,W7XD45,A0A1U7LLR0,A0A4S2MWZ7,A0A158P1R9,V6R0U9,G4N9J3,E3KLI3,B7Q5I1,A0A1E3QC61,D5GGK8,S8ANP9,A0A139AUH8,L2GMR6,U4LBG4,O74957,A0A3N4IGK1,A6N7Y9,A0A0E9NDK5,T1KZ60,A0A2G8JLH3,L2GUF2,W2T741,A0A1W0E4B5,A0A2J7QB22,S4RYE2,A0A388KES6,A0A226EFL3,A0A3S3PD82,A0A0L0TEV1,A0A1S3J512,G0QTT2,A0A1J1HRI1,C4V9J2,Q9JMB7,A0A075AN09,Q5TW24,U5HIG6,A0A401PRI6,Q96J94,A0A2B4RHN2,G2QEV0,A0A397UU01,A0A2T7PFL8,K7ISV0,A0A024FT57,H3HCL6,A0A0G4IME3,A0A1S3CYL5,D7FQK3,A0A1Y1YHC8,T1GSU4,F4S231,A0A1D8PMK0,A0A2G5B1D8,Q5BD61,A0A1C7M8P2,A0A4D8YSQ3,A0A158PJG6,J9JZ66,A0A0C2XG51,A0A158QZT6,A0A165QYQ9,T0SAU8,R7YY92,A0A3S1A0C3,A0A074YJ47,A0A2K1J482,A0A1Q3ENA6,O04379,A0A371I3C8,M8AEW7,A8P0D4,A0A2K3NY65,F4NYW7,A0A409Y6G2,A0A0L0HAB7,D8PZT7,A0A1D1W4K0,A7RQ46,W4YU94,A7BJS5,D8SNM6,A0A1J8PPA3,X1WG39,M5FQK2,Q69VD5,A0A0D8XL16,A0A016WPN3,Q9QZ81,G5EES3,A0A0K0EFP6,Q8CJG0,A0A1D5NTU6,V2WTL2,A0A0V0YLH8,A0A139WDH0,A0A0R3W9Q7,H3DS31,A0A1Y1HWP2,G4T5G9,B7QCC4,A0A0B2UV00,M7BCJ9,E9GN30,Q7PZ41,A0A077Z361,R7U9I3,A0A1X7V1N5,A0A0K0JDP1,A0A0N4UKJ1,A0A498N3A3,A0A3M0IQP5,A0A0L8GBV4,Q32KD4,A0A1J1JBJ0,E0W4C3,A0A482XDA9,A0A3P7EJD6,J9K2Z4,A0A2J7Q8V4,T1IBM6,V3ZRX0,A0A210QKF7,A0A423TSS1,K1PT78,A0A267E8R7,A0A1D2N447,A0A226D7A9,F6YK55,T1KTE4,A0A2C9JGZ6,A0A1V9X9F0,K5X5Z7,A0A3Q0KUG5,T1FY40,1YVU,1Z26,5AWH,5G5T,5I4A,6QZK,E8N0K8,A0A1I7IXT4,A0A2W1JZ37,A0A2S7WBN3,A0A420DFE6,A0A4V1VDY2,A0A368P5I0,A0A4R1RMM2,A0A1Y2RDH8,Q11QW7,A0A1M5ZSR3,A0A0K8QX04,A0A0M2PXX3,K9TPA9,A0A1L3JHM3,A0A1W6MIP2,A0A1C0UUC4,A0A2U2J9E0,A0A326U7G5,A0A3D8L290,H1KXR6,A0A1Q4R485,K9U8J6,K9RC91,A0A0D8ZUC0,A0A139XGN8,A0A1T4Y3A2,A0YYT3,A0A2T1EFY0,G6FTN0,R6KUL9,A0A433NB65,A0A1Z4L0A1,K9UQR0,A0A2T1G8M7,K9VUN0,A0A0P6X5X2,K9ZDE3,B0JXD6,A0A2T1LS63,A0A1Z4K1Y3,A0A1N6SSK9,A0A0P4UVI8,A0A0V7ZCG4,A0A1J0AGK2,K9PFF9,A0A2G9DT08,K9UEV4,Q9L1X1,A0A060HNJ0,A0A235B542,R5XQK4,A0A1H3LE92,A0A496APJ8,A0A1V9G9U4,S7VLM7,A0A1A5X8H4,A0A1I2T6Q1,A0A1R3T9N6,A0A0Q2M2Z1,H8KXJ0,D3S0S6,A0A2D1U4H7,I3TE64,A0A0B7I4Z6,A0LL61,A0A139WY18,A0A2T1E1K4,A0A1Q8ZD62,A0A4Q6XKV6,A0A1Z3HNN4,A0A239JE83,A0A2N4XBY2,R5JEI2,A0A0Q0ZC47,A0A2T0XH18,A0A1V4CHV0,A0A1K1RQP7,A0A1N6LUI7,A0A0P0NGR6,A0A1X7IML5,A0A0A2LKJ7,K1L112,A0A0U3AL92,A0A1H3A054,B9LVW4,A0A0C5JKF3,R5NJJ8,A5D4D9,Q2JI93,A0A142Y7A9,A0A432MEQ5,A0A372DKU2,A0A3R7KLK4,C1F5Q7,A0A4R3EV39,A0A1P8WP90,A0A222F7P0,A0A1C9VH88,A0A2T2YMB1,A0A329TD61,A0A101R2A0,A0A1E3XF49,A0A1U9ND56,A0A4R7BQC4,A0A1H3DGN3,A0A1Q1FPH0,E0TGY3,A0A259TUP4,F6EYI8,A0A2S9Q9J0,A0A4Q2UIU6,A0A1H0LH25,A0A318LG42,H1YCU5,L0JS08,A0A1Q5ZS75,A0A345E7N0,M0AF24,A0A1W2A082,A0A1H3X247,A0A0C1XUA0,M0D2X3,A0A2R5G167,A0A346PK63,R7RTW6,A0A1H2RBI2,A0A1C3ZXN2,B9LVP8,M5RSF0,W0JW77,B7K585,F8D8G0,A0A343TL88,L0AJX6,A0A2A5QS34,A0A343JEE2,A0A3P3RGE5,A0A329TBQ3,A0A0W1S8B8,A0A1V4C8L7,L9VRQ2,E4NRV1,A0A1I6HGN0,A0A1I0NI68,,",366,37
"673","C.H9.12","C.H9.9",343,167,176,1.79639017419706,"4F1N,4F3T,4KRE,5GUH,5VM9,6KR6,6OON,7SWF,A0A163JTZ6,A0A0N4X8S8,A0A196SDB4,J9D5G4,Q389P5,C4LVV2,A0A2P6N8X7,A0A0G4H2S4,R1FDF0,D2VMG4,A0A074TLL7,F4PH46,A0A3M7S814,A0A164ZA52,A0A383WDW5,Q54G64,S7WCF7,I0YVB2,R7QGN7,C1DZY0,A0CB11,R9ACY5,D3BMP8,A0A1Z5TVE5,W7XD45,A0A4S2MWZ7,K1VVQ6,A0A158P1R9,G7DVX0,E3KLI3,B7Q5I1,D5GGK8,S8ANP9,A0A139AUH8,L2GMR6,U4LBG4,A0A177URI1,A6N7Y9,A0A0E9NDK5,T1KZ60,A0A250WXN5,A0A2G8JLH3,Q5KAT1,L2GUF2,W2T741,A0A1W0E4B5,A0A2J7QB22,S4RYE2,A0A2K3CW87,A0A388KES6,A0A226EFL3,A0A3S3PD82,A0A0L0TEV1,A0A1S3J512,G0QTT2,A0A1J1HRI1,C4V9J2,Q9JMB7,A0A075AN09,Q5TW24,U5HIG6,A0A401PRI6,Q96J94,A0A2B4RHN2,G2QEV0,A0A2T7PFL8,K7ISV0,A0A024FT57,H3HCL6,A0A0G4IME3,E9FUN9,A0A1S3CYL5,A0A1Y1YHC8,T1GSU4,F4S231,A0A1D8PMK0,A0A2G5B1D8,Q5BD61,A0A1C7M8P2,A0A4D8YSQ3,A0A158PJG6,J9JZ66,A0A0C2XG51,A0A158QZT6,A0A165QYQ9,T0SAU8,R7YY92,A0A3S1A0C3,A0A074YJ47,A0A2K1J482,A0A1Q3ENA6,O04379,A0A371I3C8,M8AEW7,A8P0D4,A0A2K3NY65,F4NYW7,A0A409Y6G2,A0A0L0HAB7,D8PZT7,A0A1D1W4K0,A7RQ46,W4YU94,A7BJS5,D8SNM6,A0A1J8PPA3,X1WG39,M5FQK2,Q69VD5,A0A2R6NSC2,A0A0D8XL16,A0A016WPN3,Q9QZ81,G5EES3,A0A0K0EFP6,Q8CJG0,A0A1D5NTU6,V2WTL2,A0A0V0YLH8,A0A139WDH0,A0A0R3W9Q7,H3DS31,A0A1Y1HWP2,G4T5G9,B7QCC4,A0A0B2UV00,M7BCJ9,E9GN30,Q7PZ41,A0A077Z361,R7U9I3,A0A1X7V1N5,A0A0K0JDP1,A0A0N4UKJ1,A0A498N3A3,A0A3M0IQP5,A0A0L8GBV4,Q32KD4,A0A1J1JBJ0,E0W4C3,A0A482XDA9,A0A3P7EJD6,J9K2Z4,A0A2J7Q8V4,T1IBM6,V3ZRX0,A0A210QKF7,A0A423TSS1,K1PT78,A0A267E8R7,A0A1D2N447,A0A226D7A9,F6YK55,T1KTE4,A0A2C9JGZ6,A0A1V9X9F0,K5X5Z7,A0A3Q0KUG5,T1FY40,1YVU,1Z26,3DLB,5AWH,5G5T,5I4A,6QZK,7R8K,A0A1I7IXT4,A0A2W1JZ37,A0A2S7WBN3,A0A328VKE4,E0ST67,A0A368P5I0,C4L1M1,A0A4R1RMM2,A0A1Y2RDH8,Q11QW7,A0A1M5ZSR3,A0A0K8QX04,A0A0M2PXX3,K9TPA9,A0A1L3JHM3,A0A1W6MIP2,A0A1C0UUC4,A0A2U2J9E0,A0A2Z6E1D5,A0A0F4NXW8,A0A142XB92,L8D0R3,B1XJG0,A0A326U7G5,H1KXR6,A0A1Q4R485,K9U8J6,A0A097QRL6,K9RC91,A0A0D8ZUC0,A0A139XGN8,A0A1T4Y3A2,Q5P0R2,B6YTQ5,A0A0B0H9B4,A0YYT3,A0A2T1EFY0,G6FTN0,R6KUL9,A0A433NB65,A0A1Z4L0A1,K9UQR0,A0A2T1G8M7,K9VUN0,B7GJX9,A0A0P6X5X2,K9ZDE3,B0JXD6,A0A2T1LS63,A0A1Z4K1Y3,A0A2Z6E0R7,A0A1N6SSK9,A0A0P4UVI8,A0A0V7ZCG4,A0A1J0AGK2,K9PFF9,A0A2G9DT08,K9UEV4,Q9L1X1,A0A235B542,R5XQK4,A0A496APJ8,A0A062U2W9,H0HWQ5,A0A1V9G9U4,A0A1I2ZGP1,A0A317EJY3,A0A1I2BD20,F8ERC7,S7VLM7,A0A1A5X8H4,A0A1I2T6Q1,A0A1R3T9N6,A0A0Q2M2Z1,H8KXJ0,D3S0S6,A0A2D1U4H7,I3TE64,A0A0B7I4Z6,A0LL61,Q8DKB1,A0A139WY18,A0A1J1EK56,A0A2T1E1K4,A0A1Q8ZD62,A0A4Q6XKV6,A0A1Z3HNN4,A0A239JE83,A0A2N4XBY2,Q53W94,R5JEI2,A0A0Q0ZC47,A0A2T0XH18,A0A1V4CHV0,A0A1K1RQP7,A0A2T1EKT1,A0A1N6LUI7,A0A0P0NGR6,A0A1X7IML5,A0A0A2LKJ7,K1L112,A0A0U3AL92,A0A1H3A054,E0UCX3,K9XZC6,B9LVW4,A0A0C1VHB4,Q31N05,A0A0C5JKF3,R5NJJ8,A5D4D9,Q2JI93,A0A142Y7A9,A0A432MEQ5,A0A372DKU2,A0A3R7KLK4,C1F5Q7,A0A4R3EV39,A0A1P8WP90,A0A222F7P0,A0A1C9VH88,A0A2T2YMB1,A0A329TD61,A0A101R2A0,A0A1E3XF49,A0A1U9ND56,A0A4R7BQC4,A0A1H3DGN3,A0A1Q1FPH0,E0TGY3,A0A259TUP4,F6EYI8,A0A2S9Q9J0,A0A4Q2UIU6,A0A1H0LH25,A0A318LG42,H1YCU5,L0JS08,A0A1Q5ZS75,A0A345E7N0,M0AF24,A0A1W2A082,A0A1H3X247,A0A0C1XUA0,M0D2X3,A0A2R5G167,A0A346PK63,R7RTW6,A0A1H2RBI2,A0A1C3ZXN2,B9LVP8,M5RSF0,W0JW77,B7K585,F8D8G0,A0A343TL88,L0AJX6,A0A2A5QS34,A0A343JEE2,A0A3P3RGE5,A0A329TBQ3,A0A285N2A8,A0A0W1S8B8,A0A1V4C8L7,L9VRQ2,E4NRV1,A0A1I6HGN0,A0A1I0NI68,,",366,37
"674","C.H9.2","C.H9.5",334,167,167,2.21556886227545,"4F1N,4F3T,4KRE,5GUH,5VM9,6KR6,6OON,7KX7,7SWF,A0A163JTZ6,A0A0N4X8S8,J9D5G4,Q389P5,A0A2P6N8X7,D2VMG4,A0A074TLL7,A0A0D1ZAJ4,Q1K660,F4PH46,A0A3M7S814,A0A164ZA52,Q54G64,R7QGN7,C1DZY0,A0A2C5Z0M1,A0CB11,D3BMP8,A0A1Z5TVE5,W7XD45,A0A1U7LLR0,A0A4S2MWZ7,K1VVQ6,A0A158P1R9,G7DVX0,V6R0U9,G4N9J3,E3KLI3,B7Q5I1,A0A1E3QC61,D5GGK8,S8ANP9,A0A139AUH8,L2GMR6,U4LBG4,A0A177URI1,O74957,A0A3N4IGK1,A6N7Y9,A0A0E9NDK5,T1KZ60,A0A250WXN5,A0A2G8JLH3,Q5KAT1,W2T741,A0A1W0E4B5,A0A2J7QB22,S4RYE2,A0A2K3CW87,A0A388KES6,A0A226EFL3,A0A3S3PD82,A0A1S3J512,G0QTT2,A0A1J1HRI1,C4V9J2,Q9JMB7,A0A075AN09,Q5TW24,U5HIG6,A0A401PRI6,Q96J94,A0A2B4RHN2,G2QEV0,A0A397UU01,A0A2T7PFL8,K7ISV0,A0A024FT57,H3HCL6,A0A0G4IME3,E9FUN9,A0A1S3CYL5,D7FQK3,T1GSU4,F4S231,A0A1D8PMK0,A0A2G5B1D8,Q5BD61,A0A1C7M8P2,A0A4D8YSQ3,A0A158PJG6,J9JZ66,A0A0C2XG51,A0A158QZT6,A0A165QYQ9,T0SAU8,R7YY92,A0A3S1A0C3,A0A074YJ47,A0A2K1J482,A0A1Q3ENA6,O04379,A0A371I3C8,M8AEW7,A8P0D4,A0A2K3NY65,A0A409Y6G2,A0A0L0HAB7,D8PZT7,A0A1D1W4K0,A7RQ46,W4YU94,A7BJS5,D8SNM6,A0A1J8PPA3,X1WG39,M5FQK2,Q69VD5,A0A2R6NSC2,A0A0D8XL16,A0A016WPN3,Q9QZ81,G5EES3,A0A0K0EFP6,Q8CJG0,A0A1D5NTU6,V2WTL2,A0A0V0YLH8,A0A139WDH0,A0A0R3W9Q7,H3DS31,A0A1Y1HWP2,G4T5G9,B7QCC4,A0A0B2UV00,M7BCJ9,E9GN30,Q7PZ41,A0A077Z361,R7U9I3,A0A1X7V1N5,A0A0K0JDP1,A0A0N4UKJ1,A0A498N3A3,A0A3M0IQP5,A0A0L8GBV4,Q32KD4,A0A1J1JBJ0,E0W4C3,A0A482XDA9,A0A3P7EJD6,J9K2Z4,A0A2J7Q8V4,T1IBM6,V3ZRX0,A0A210QKF7,A0A423TSS1,K1PT78,A0A267E8R7,A0A1D2N447,A0A226D7A9,F6YK55,T1KTE4,A0A2C9JGZ6,A0A1V9X9F0,K5X5Z7,A0A3Q0KUG5,T1FY40,1YVU,1Z26,3DLB,5AWH,5G5T,5I4A,6QZK,7R8K,A0A328VKE4,E0ST67,C4L1M1,Q11QW7,A0A0M2PXX3,K9TPA9,A0A1C0UUC4,A0A2Z6E1D5,A0A0F4NXW8,A0A142XB92,L8D0R3,B1XJG0,A0A326U7G5,A0A3D8L290,A0A1Q4R485,K9U8J6,A0A097QRL6,K9RC91,A0A0D8ZUC0,A0A139XGN8,A0A1T4Y3A2,Q5P0R2,B6YTQ5,A0A0B0H9B4,A0YYT3,A0A2T1EFY0,G6FTN0,R6KUL9,A0A433NB65,A0A1Z4L0A1,K9UQR0,A0A2T1G8M7,K9VUN0,B7GJX9,A0A0P6X5X2,K9ZDE3,B0JXD6,A0A2T1LS63,A0A1Z4K1Y3,A0A2Z6E0R7,A0A1N6SSK9,A0A0P4UVI8,A0A0V7ZCG4,A0A1J0AGK2,K9PFF9,A0A2G9DT08,K9UEV4,Q9L1X1,A0A060HNJ0,A0A235B542,R5XQK4,A0A1H3LE92,A0A496APJ8,A0A062U2W9,H0HWQ5,A0A1V9G9U4,A0A1I2ZGP1,A0A317EJY3,A0A1I2BD20,F8ERC7,S7VLM7,A0A1A5X8H4,A0A1I2T6Q1,A0A1R3T9N6,A0A0Q2M2Z1,H8KXJ0,D3S0S6,A0A2D1U4H7,I3TE64,A0A0B7I4Z6,A0LL61,Q8DKB1,A0A139WY18,A0A1J1EK56,A0A2T1E1K4,A0A1Q8ZD62,A0A4Q6XKV6,A0A1Z3HNN4,A0A239JE83,A0A2N4XBY2,Q53W94,R5JEI2,A0A0Q0ZC47,A0A2T0XH18,A0A1V4CHV0,A0A1K1RQP7,A0A2T1EKT1,A0A1N6LUI7,A0A0P0NGR6,A0A1X7IML5,A0A0A2LKJ7,K1L112,A0A0U3AL92,A0A1H3A054,E0UCX3,K9XZC6,B9LVW4,A0A0C1VHB4,Q31N05,A0A0C5JKF3,R5NJJ8,A5D4D9,Q2JI93,A0A142Y7A9,A0A432MEQ5,A0A372DKU2,A0A3R7KLK4,C1F5Q7,A0A4R3EV39,A0A1P8WP90,A0A222F7P0,A0A1C9VH88,A0A2T2YMB1,A0A329TD61,A0A101R2A0,A0A1E3XF49,A0A1U9ND56,A0A4R7BQC4,A0A1H3DGN3,A0A1Q1FPH0,E0TGY3,A0A259TUP4,F6EYI8,A0A2S9Q9J0,A0A4Q2UIU6,A0A1H0LH25,A0A318LG42,H1YCU5,L0JS08,A0A1Q5ZS75,A0A345E7N0,M0AF24,A0A1W2A082,A0A1H3X247,A0A0C1XUA0,M0D2X3,A0A2R5G167,A0A346PK63,R7RTW6,A0A1H2RBI2,A0A1C3ZXN2,B9LVP8,M5RSF0,W0JW77,B7K585,F8D8G0,A0A343TL88,L0AJX6,A0A2A5QS34,A0A343JEE2,A0A3P3RGE5,A0A329TBQ3,A0A285N2A8,A0A0W1S8B8,A0A1V4C8L7,L9VRQ2,E4NRV1,A0A1I6HGN0,A0A1I0NI68,,",366,37
"676","C.S13.2","N.S1.6",271,167,104,5.02380815292492,"4F1N,4F3T,4KRE,5GUH,5VM9,6KR6,6OON,7KX7,7SWF,C4LVV2,A0A0G4H2S4,T1H8B3,R1FDF0,S4RWI0,A0A074TLL7,A0A0D1ZAJ4,Q1K660,F4PH46,A0A164ZA52,A0A383WDW5,Q54G64,R7QGN7,C1DZY0,A0A2C5Z0M1,A0CB11,R9ACY5,D3BMP8,A0A1Z5TVE5,W7XD45,A0A1U7LLR0,A0A4S2MWZ7,A0A158P1R9,G7DVX0,V6R0U9,G4N9J3,E3KLI3,B7Q5I1,A0A1E3QC61,D5GGK8,S8ANP9,A0A139AUH8,L2GMR6,U4LBG4,A0A177URI1,O74957,A0A3N4IGK1,A6N7Y9,A0A0E9NDK5,T1KZ60,A0A250WXN5,A0A2G8JLH3,Q5KAT1,L2GUF2,A0A2J7QB22,S4RYE2,A0A2K3CW87,A0A388KES6,A0A226EFL3,A0A3S3PD82,A0A0L0TEV1,A0A1S3J512,G0QTT2,A0A1J1HRI1,Q9JMB7,A0A075AN09,Q5TW24,U5HIG6,A0A401PRI6,Q96J94,A0A2B4RHN2,G2QEV0,A0A397UU01,A0A2T7PFL8,K7ISV0,A0A024FT57,H3HCL6,A0A0G4IME3,E9FUN9,A0A1S3CYL5,D7FQK3,A0A1Y1YHC8,T1GSU4,F4S231,A0A1D8PMK0,A0A2G5B1D8,Q5BD61,A0A1C7M8P2,A0A4D8YSQ3,A0A158PJG6,J9JZ66,A0A0C2XG51,A0A158QZT6,A0A165QYQ9,T0SAU8,R7YY92,A0A3S1A0C3,A0A074YJ47,A0A2K1J482,A0A1Q3ENA6,O04379,A0A371I3C8,M8AEW7,A8P0D4,A0A2K3NY65,F4NYW7,A0A409Y6G2,A0A0L0HAB7,D8PZT7,A0A1D1W4K0,A7RQ46,W4YU94,A7BJS5,D8SNM6,A0A1J8PPA3,X1WG39,M5FQK2,Q69VD5,A0A2R6NSC2,A0A0D8XL16,A0A016WPN3,Q9QZ81,G5EES3,A0A0K0EFP6,Q8CJG0,A0A1D5NTU6,V2WTL2,A0A0V0YLH8,A0A139WDH0,A0A0R3W9Q7,H3DS31,A0A1Y1HWP2,G4T5G9,B7QCC4,A0A0B2UV00,M7BCJ9,E9GN30,Q7PZ41,A0A077Z361,R7U9I3,A0A1X7V1N5,A0A0K0JDP1,A0A0N4UKJ1,A0A498N3A3,A0A3M0IQP5,A0A0L8GBV4,Q32KD4,A0A1J1JBJ0,E0W4C3,A0A482XDA9,A0A3P7EJD6,J9K2Z4,A0A2J7Q8V4,T1IBM6,V3ZRX0,A0A210QKF7,A0A423TSS1,K1PT78,A0A267E8R7,A0A1D2N447,A0A226D7A9,F6YK55,T1KTE4,A0A2C9JGZ6,A0A1V9X9F0,K5X5Z7,A0A3Q0KUG5,T1FY40,1YVU,1Z26,3DLB,5AWH,5G5T,5I4A,6QZK,A0A1I7IXT4,A0A2W1JZ37,A0A2S7WBN3,A0A420DFE6,A0A4V1VDY2,A0A368P5I0,A0A1W6MIP2,A0A2U2J9E0,A0A0B0H9B4,G6FTN0,A0A433NB65,A0A1Z4L0A1,B7GJX9,K9ZDE3,K9PFF9,A0A1I2BD20,F8ERC7,S7VLM7,A0A0Q2M2Z1,H8KXJ0,D3S0S6,A0A2D1U4H7,A0A0B7I4Z6,A0LL61,A0A1J1EK56,A0A4Q6XKV6,A0A239JE83,A0A2N4XBY2,Q53W94,R5JEI2,A0A0Q0ZC47,A0A2T0XH18,A0A1V4CHV0,A0A1K1RQP7,A0A1N6LUI7,A0A0P0NGR6,A0A1X7IML5,A0A0A2LKJ7,K1L112,A0A0U3AL92,A0A1H3A054,A0A0C5JKF3,R5NJJ8,A5D4D9,A0A142Y7A9,A0A372DKU2,A0A3R7KLK4,C1F5Q7,A0A4R3EV39,A0A1P8WP90,A0A222F7P0,A0A1C9VH88,A0A2T2YMB1,A0A329TD61,A0A101R2A0,A0A1E3XF49,A0A1U9ND56,A0A4R7BQC4,A0A1H3DGN3,A0A1Q1FPH0,E0TGY3,A0A259TUP4,F6EYI8,A0A2S9Q9J0,A0A4Q2UIU6,A0A1H0LH25,A0A318LG42,H1YCU5,L0JS08,A0A1Q5ZS75,A0A345E7N0,M0AF24,A0A1H3X247,A0A0C1XUA0,M0D2X3,A0A2R5G167,A0A346PK63,R7RTW6,A0A1C3ZXN2,B9LVP8,M5RSF0,W0JW77,B7K585,F8D8G0,A0A343TL88,L0AJX6,A0A2A5QS34,A0A343JEE2,A0A3P3RGE5,A0A329TBQ3,A0A285N2A8,A0A0W1S8B8,A0A1V4C8L7,L9VRQ2,E4NRV1,A0A1I6HGN0,A0A1I0NI68,,",366,37
"685","N.S11.7","N.S12.6",317,167,150,2.48792415169661,"4F1N,4F3T,4KRE,5GUH,5VM9,6KR6,6OON,7SWF,A0A196SDB4,J9D5G4,C4LVV2,A0A2P6N8X7,A2DPV7,A0A0G4H2S4,T1H8B3,R1FDF0,S4RWI0,D2VMG4,A0A0D1ZAJ4,F4PH46,A0A3M7S814,A0A164ZA52,A0A383WDW5,Q54G64,S7WCF7,I0YVB2,R7QGN7,C1DZY0,A0A2C5Z0M1,A0CB11,R9ACY5,D3BMP8,A0A1Z5TVE5,W7XD45,K1VVQ6,A0A158P1R9,G7DVX0,V6R0U9,E3KLI3,B7Q5I1,A0A139AUH8,L2GMR6,U4LBG4,A0A177URI1,O74957,A6N7Y9,A0A250WXN5,A0A2G8JLH3,Q5KAT1,L2GUF2,W2T741,A0A1W0E4B5,A0A2J7QB22,S4RYE2,A0A2K3CW87,A0A388KES6,A0A226EFL3,A0A3S3PD82,A0A0L0TEV1,A0A1S3J512,G0QTT2,A0A1J1HRI1,C4V9J2,Q9JMB7,A0A075AN09,Q5TW24,U5HIG6,A0A401PRI6,Q96J94,A0A2B4RHN2,G2QEV0,A0A397UU01,A0A2T7PFL8,K7ISV0,A0A024FT57,H3HCL6,A0A0G4IME3,E9FUN9,A0A1S3CYL5,D7FQK3,A0A1Y1YHC8,T1GSU4,F4S231,A0A1D8PMK0,A0A2G5B1D8,Q5BD61,A0A1C7M8P2,A0A4D8YSQ3,A0A158PJG6,J9JZ66,A0A0C2XG51,A0A158QZT6,A0A165QYQ9,T0SAU8,R7YY92,A0A3S1A0C3,A0A074YJ47,A0A2K1J482,A0A1Q3ENA6,O04379,A0A371I3C8,M8AEW7,A8P0D4,A0A2K3NY65,F4NYW7,A0A409Y6G2,A0A0L0HAB7,D8PZT7,A0A1D1W4K0,A7RQ46,W4YU94,A7BJS5,D8SNM6,A0A1J8PPA3,X1WG39,M5FQK2,Q69VD5,A0A2R6NSC2,A0A0D8XL16,A0A016WPN3,Q9QZ81,G5EES3,A0A0K0EFP6,Q8CJG0,A0A1D5NTU6,V2WTL2,A0A0V0YLH8,A0A139WDH0,A0A0R3W9Q7,H3DS31,A0A1Y1HWP2,G4T5G9,B7QCC4,A0A0B2UV00,M7BCJ9,E9GN30,Q7PZ41,A0A077Z361,R7U9I3,A0A1X7V1N5,A0A0K0JDP1,A0A0N4UKJ1,A0A498N3A3,A0A3M0IQP5,A0A0L8GBV4,Q32KD4,A0A1J1JBJ0,E0W4C3,A0A482XDA9,A0A3P7EJD6,J9K2Z4,A0A2J7Q8V4,T1IBM6,V3ZRX0,A0A210QKF7,A0A423TSS1,K1PT78,A0A267E8R7,A0A1D2N447,A0A226D7A9,F6YK55,T1KTE4,A0A2C9JGZ6,A0A1V9X9F0,K5X5Z7,A0A3Q0KUG5,T1FY40,1YVU,1Z26,3DLB,5AWH,5G5T,5I4A,6QZK,7R8K,C4L1M1,A0A1I3LMA1,K9TPA9,B1XJG0,A0A326U7G5,A0A3D8L290,K9U8J6,A0A097QRL6,K9RC91,A0A0D8ZUC0,A0A139XGN8,A0A1T4Y3A2,A0A0B0H9B4,A0YYT3,A0A2T1EFY0,G6FTN0,R6KUL9,A0A433NB65,A0A1Z4L0A1,K9UQR0,A0A2T1G8M7,K9VUN0,B7GJX9,K9ZDE3,B0JXD6,A0A2T1LS63,A0A1Z4K1Y3,A0A1N6SSK9,A0A0P4UVI8,A0A0V7ZCG4,A0A1J0AGK2,K9PFF9,A0A2G9DT08,K9UEV4,Q9L1X1,A0A060HNJ0,A0A235B542,R5XQK4,A0A1H3LE92,A0A496APJ8,A0A062U2W9,H0HWQ5,A0A1V9G9U4,A0A1I2ZGP1,A0A317EJY3,A0A1I2BD20,F8ERC7,S7VLM7,A0A1A5X8H4,A0A1I2T6Q1,A0A1R3T9N6,A0A0Q2M2Z1,D3S0S6,A0A2D1U4H7,A0A0B7I4Z6,A0LL61,Q8DKB1,A0A139WY18,A0A1J1EK56,A0A2T1E1K4,A0A1Q8ZD62,A0A4Q6XKV6,A0A1Z3HNN4,A0A239JE83,A0A2N4XBY2,Q53W94,R5JEI2,A0A0Q0ZC47,A0A2T0XH18,A0A1V4CHV0,A0A1K1RQP7,A0A2T1EKT1,A0A1N6LUI7,A0A0P0NGR6,A0A1X7IML5,A0A0A2LKJ7,K1L112,A0A0U3AL92,A0A1H3A054,E0UCX3,K9XZC6,B9LVW4,A0A0C1VHB4,Q31N05,A0A0C5JKF3,A5D4D9,Q2JI93,A0A142Y7A9,A0A432MEQ5,A0A372DKU2,A0A3R7KLK4,C1F5Q7,A0A4R3EV39,A0A1P8WP90,A0A222F7P0,A0A1C9VH88,A0A2T2YMB1,A0A329TD61,A0A101R2A0,A0A1E3XF49,A0A1U9ND56,A0A4R7BQC4,A0A1H3DGN3,A0A1Q1FPH0,E0TGY3,A0A259TUP4,F6EYI8,A0A2S9Q9J0,A0A4Q2UIU6,A0A1H0LH25,A0A318LG42,H1YCU5,L0JS08,A0A1Q5ZS75,A0A345E7N0,M0AF24,A0A1W2A082,A0A1H3X247,A0A0C1XUA0,M0D2X3,A0A2R5G167,A0A346PK63,R7RTW6,A0A1H2RBI2,A0A1C3ZXN2,B9LVP8,M5RSF0,B7K585,F8D8G0,A0A343TL88,L0AJX6,A0A2A5QS34,A0A343JEE2,A0A3P3RGE5,A0A329TBQ3,A0A285N2A8,A0A0W1S8B8,A0A1V4C8L7,L9VRQ2,E4NRV1,A0A1I6HGN0,A0A1I0NI68,,",366,37
"686","N.S13.2","N.S14.1",237,167,70,2.4330624465355,"4F1N,4F3T,4KRE,5GUH,5VM9,6KR6,6OON,7SWF,A0A163JTZ6,A0A196SDB4,J9D5G4,C4LVV2,A2DPV7,T1H8B3,S4RWI0,D2VMG4,F4PH46,A0A3M7S814,A0A164ZA52,A0A383WDW5,Q54G64,S7WCF7,I0YVB2,R7QGN7,C1DZY0,A0A2C5Z0M1,A0CB11,R9ACY5,D3BMP8,W7XD45,A0A4S2MWZ7,A0A158P1R9,V6R0U9,G4N9J3,E3KLI3,B7Q5I1,A0A1E3QC61,D5GGK8,S8ANP9,L2GMR6,U4LBG4,A0A177URI1,O74957,A0A3N4IGK1,A6N7Y9,T1KZ60,A0A250WXN5,A0A2G8JLH3,Q5KAT1,L2GUF2,W2T741,A0A1W0E4B5,A0A2J7QB22,S4RYE2,A0A2K3CW87,A0A388KES6,A0A226EFL3,A0A3S3PD82,A0A0L0TEV1,A0A1S3J512,G0QTT2,A0A1J1HRI1,C4V9J2,Q9JMB7,A0A075AN09,Q5TW24,U5HIG6,A0A401PRI6,Q96J94,A0A2B4RHN2,G2QEV0,A0A397UU01,A0A2T7PFL8,K7ISV0,A0A024FT57,H3HCL6,A0A0G4IME3,E9FUN9,A0A1S3CYL5,D7FQK3,A0A1Y1YHC8,T1GSU4,F4S231,A0A1D8PMK0,A0A2G5B1D8,Q5BD61,A0A1C7M8P2,A0A4D8YSQ3,A0A158PJG6,J9JZ66,A0A0C2XG51,A0A158QZT6,A0A165QYQ9,T0SAU8,R7YY92,A0A3S1A0C3,A0A074YJ47,A0A2K1J482,A0A1Q3ENA6,O04379,A0A371I3C8,M8AEW7,A8P0D4,A0A2K3NY65,F4NYW7,A0A409Y6G2,A0A0L0HAB7,D8PZT7,A0A1D1W4K0,A7RQ46,W4YU94,A7BJS5,D8SNM6,A0A1J8PPA3,X1WG39,M5FQK2,Q69VD5,A0A2R6NSC2,A0A0D8XL16,A0A016WPN3,Q9QZ81,G5EES3,A0A0K0EFP6,Q8CJG0,A0A1D5NTU6,V2WTL2,A0A0V0YLH8,A0A139WDH0,A0A0R3W9Q7,H3DS31,A0A1Y1HWP2,G4T5G9,B7QCC4,A0A0B2UV00,M7BCJ9,E9GN30,Q7PZ41,A0A077Z361,R7U9I3,A0A1X7V1N5,A0A0K0JDP1,A0A0N4UKJ1,A0A498N3A3,A0A3M0IQP5,A0A0L8GBV4,Q32KD4,A0A1J1JBJ0,E0W4C3,A0A482XDA9,A0A3P7EJD6,J9K2Z4,A0A2J7Q8V4,T1IBM6,V3ZRX0,A0A210QKF7,A0A423TSS1,K1PT78,A0A267E8R7,A0A1D2N447,A0A226D7A9,F6YK55,T1KTE4,A0A2C9JGZ6,A0A1V9X9F0,K5X5Z7,A0A3Q0KUG5,T1FY40,1YVU,1Z26,3DLB,5AWH,5G5T,5I4A,C4L1M1,A0A1I3LMA1,B1XJG0,A0A0B0H9B4,R6KUL9,B7GJX9,A0A1N6SSK9,A0A235B542,R5XQK4,A0A1H3LE92,A0A496APJ8,A0A1V9G9U4,A0A0Q2M2Z1,Q8DKB1,A0A139WY18,A0A1J1EK56,A0A2T1E1K4,A0A1Q8ZD62,A0A1Z3HNN4,Q53W94,A0A2T1EKT1,E0UCX3,K9XZC6,B9LVW4,A0A0C1VHB4,Q31N05,R5NJJ8,Q2JI93,A0A142Y7A9,A0A432MEQ5,A0A1P8WP90,A0A1E3XF49,A0A4Q2UIU6,H1YCU5,L0JS08,A0A1Q5ZS75,M0AF24,A0A1W2A082,A0A1H3X247,A0A0C1XUA0,M0D2X3,A0A2R5G167,A0A346PK63,R7RTW6,A0A1H2RBI2,A0A1C3ZXN2,B9LVP8,M5RSF0,W0JW77,B7K585,F8D8G0,A0A343TL88,L0AJX6,A0A2A5QS34,A0A343JEE2,A0A3P3RGE5,A0A329TBQ3,A0A285N2A8,A0A0W1S8B8,A0A1V4C8L7,L9VRQ2,E4NRV1,A0A1I6HGN0,A0A1I0NI68,,",366,37
"694","C.H10.7","C.S8.5",256,168,88,1.92099567099567,"4F1N,4F3T,4KRE,5VM9,6OON,7KX7,A0A163JTZ6,A0A196SDB4,J9D5G4,C4LVV2,A0A2P6N8X7,A8BCK6,A2DPV7,A0A0G4H2S4,R1FDF0,D2VMG4,A0A0D1ZAJ4,Q1K660,F4PH46,A0A3M7S814,A0A383WDW5,Q54G64,S7WCF7,I0YVB2,R7QGN7,C1DZY0,A0A2C5Z0M1,A0CB11,R9ACY5,D3BMP8,W7XD45,A0A1U7LLR0,A0A4S2MWZ7,G7DVX0,V6R0U9,G4N9J3,E3KLI3,B7Q5I1,A0A1E3QC61,D5GGK8,S8ANP9,A0A139AUH8,U4LBG4,A0A177URI1,O74957,A0A3N4IGK1,A6N7Y9,A0A0E9NDK5,T1KZ60,A0A250WXN5,A0A2G8JLH3,Q5KAT1,L2GUF2,W2T741,A0A1W0E4B5,A0A2J7QB22,S4RYE2,A0A2K3CW87,A0A388KES6,A0A226EFL3,A0A3S3PD82,A0A0L0TEV1,A0A1S3J512,G0QTT2,A0A1J1HRI1,Q9JMB7,A0A075AN09,U5HIG6,A0A401PRI6,Q96J94,A0A2B4RHN2,G2QEV0,A0A397UU01,A0A2T7PFL8,K7ISV0,A0A024FT57,H3HCL6,A0A0G4IME3,E9FUN9,A0A1S3CYL5,D7FQK3,A0A1Y1YHC8,T1GSU4,F4S231,A0A1D8PMK0,A0A2G5B1D8,Q5BD61,A0A1C7M8P2,A0A4D8YSQ3,A0A158PJG6,J9JZ66,A0A0C2XG51,A0A158QZT6,A0A165QYQ9,T0SAU8,R7YY92,A0A3S1A0C3,A0A074YJ47,A0A2K1J482,A0A1Q3ENA6,O04379,A0A371I3C8,M8AEW7,A8P0D4,A0A2K3NY65,F4NYW7,A0A409Y6G2,A0A0L0HAB7,D8PZT7,A0A1D1W4K0,A7RQ46,W4YU94,A7BJS5,D8SNM6,A0A1J8PPA3,X1WG39,M5FQK2,Q69VD5,A0A2R6NSC2,A0A0D8XL16,A0A016WPN3,Q9QZ81,G5EES3,A0A0K0EFP6,Q8CJG0,A0A1D5NTU6,V2WTL2,A0A0V0YLH8,A0A139WDH0,A0A0R3W9Q7,H3DS31,A0A1Y1HWP2,G4T5G9,B7QCC4,A0A0B2UV00,M7BCJ9,E9GN30,Q7PZ41,A0A077Z361,R7U9I3,A0A1X7V1N5,A0A0K0JDP1,A0A0N4UKJ1,A0A498N3A3,A0A3M0IQP5,A0A0L8GBV4,Q32KD4,A0A1J1JBJ0,E0W4C3,A0A482XDA9,A0A3P7EJD6,J9K2Z4,A0A2J7Q8V4,T1IBM6,V3ZRX0,A0A210QKF7,A0A423TSS1,K1PT78,A0A267E8R7,A0A1D2N447,A0A226D7A9,F6YK55,T1KTE4,A0A2C9JGZ6,A0A1V9X9F0,K5X5Z7,A0A3Q0KUG5,T1FY40,1Z26,5AWH,7R8K,A0A1I7IXT4,A0A2W1JZ37,A0A2S7WBN3,A0A420DFE6,E0ST67,A0A4V1VDY2,A0A368P5I0,A0A4R1RMM2,Q11QW7,A0A1L3JHM3,A0A1W6MIP2,A0A1C0UUC4,A0A2U2J9E0,A0A142XB92,L8D0R3,A0A3D8L290,H1KXR6,A0A097QRL6,K9RC91,A0A1T4Y3A2,B6YTQ5,K9UQR0,B0JXD6,A0A2G9DT08,K9UEV4,Q9L1X1,A0A060HNJ0,A0A062U2W9,H0HWQ5,A0A1R3T9N6,A0A0Q2M2Z1,H8KXJ0,A0A2D1U4H7,A0LL61,R5JEI2,A0A1V4CHV0,A0A1N6LUI7,A0A0U3AL92,A0A1H3A054,A0A0C5JKF3,Q2JI93,A0A142Y7A9,A0A432MEQ5,A0A372DKU2,A0A3R7KLK4,C1F5Q7,A0A4R3EV39,A0A1P8WP90,A0A222F7P0,A0A1C9VH88,A0A329TD61,A0A101R2A0,A0A1E3XF49,A0A1U9ND56,A0A4R7BQC4,A0A1H3DGN3,A0A1Q1FPH0,E0TGY3,F6EYI8,A0A2S9Q9J0,A0A4Q2UIU6,A0A1H0LH25,A0A318LG42,A0A345E7N0,M0AF24,A0A1W2A082,A0A1H3X247,A0A346PK63,A0A1H2RBI2,A0A1C3ZXN2,B9LVP8,W0JW77,F8D8G0,A0A343TL88,L0AJX6,A0A2A5QS34,A0A3P3RGE5,A0A329TBQ3,A0A285N2A8,A0A0W1S8B8,A0A1V4C8L7,L9VRQ2,E4NRV1,A0A1I6HGN0,A0A1I0NI68,,",366,37
"695","C.H10.7","C.S9.4",221,168,53,2.12241689128482,"4F1N,4F3T,4KRE,5GUH,5VM9,6KR6,6OON,7SWF,A0A163JTZ6,A0A196SDB4,J9D5G4,A8BCK6,A2DPV7,A0A0G4H2S4,R1FDF0,D2VMG4,A0A074TLL7,A0A0D1ZAJ4,Q1K660,F4PH46,A0A3M7S814,A0A164ZA52,A0A383WDW5,Q54G64,S7WCF7,I0YVB2,R7QGN7,C1DZY0,A0A2C5Z0M1,A0CB11,R9ACY5,D3BMP8,A0A1Z5TVE5,W7XD45,A0A1U7LLR0,A0A4S2MWZ7,V6R0U9,G4N9J3,E3KLI3,B7Q5I1,A0A1E3QC61,D5GGK8,S8ANP9,A0A139AUH8,L2GMR6,U4LBG4,A0A177URI1,O74957,A0A3N4IGK1,A6N7Y9,A0A0E9NDK5,T1KZ60,A0A250WXN5,A0A2G8JLH3,Q5KAT1,L2GUF2,W2T741,A0A1W0E4B5,A0A2J7QB22,S4RYE2,A0A2K3CW87,A0A388KES6,A0A226EFL3,A0A3S3PD82,A0A0L0TEV1,A0A1S3J512,G0QTT2,A0A1J1HRI1,C4V9J2,Q9JMB7,A0A075AN09,Q5TW24,U5HIG6,A0A401PRI6,Q96J94,A0A2B4RHN2,A0A397UU01,A0A2T7PFL8,K7ISV0,A0A024FT57,H3HCL6,A0A0G4IME3,E9FUN9,A0A1S3CYL5,D7FQK3,A0A1Y1YHC8,T1GSU4,A0A1D8PMK0,A0A2G5B1D8,A0A1C7M8P2,A0A4D8YSQ3,A0A158PJG6,J9JZ66,A0A0C2XG51,A0A158QZT6,A0A165QYQ9,T0SAU8,A0A3S1A0C3,A0A2K1J482,A0A1Q3ENA6,O04379,A0A371I3C8,M8AEW7,A8P0D4,A0A2K3NY65,F4NYW7,A0A409Y6G2,A0A0L0HAB7,D8PZT7,A0A1D1W4K0,A7RQ46,W4YU94,A7BJS5,D8SNM6,A0A1J8PPA3,X1WG39,M5FQK2,Q69VD5,A0A2R6NSC2,A0A0D8XL16,A0A016WPN3,Q9QZ81,G5EES3,A0A0K0EFP6,Q8CJG0,A0A1D5NTU6,V2WTL2,A0A0V0YLH8,A0A139WDH0,A0A0R3W9Q7,H3DS31,A0A1Y1HWP2,G4T5G9,B7QCC4,A0A0B2UV00,M7BCJ9,E9GN30,Q7PZ41,A0A077Z361,R7U9I3,A0A1X7V1N5,A0A0K0JDP1,A0A0N4UKJ1,A0A498N3A3,A0A3M0IQP5,A0A0L8GBV4,Q32KD4,A0A1J1JBJ0,E0W4C3,A0A482XDA9,A0A3P7EJD6,J9K2Z4,A0A2J7Q8V4,T1IBM6,V3ZRX0,A0A210QKF7,A0A423TSS1,K1PT78,A0A267E8R7,A0A1D2N447,A0A226D7A9,F6YK55,T1KTE4,A0A2C9JGZ6,A0A1V9X9F0,K5X5Z7,A0A3Q0KUG5,T1FY40,1Z26,5AWH,5I4A,7R8K,A0A1M5ZSR3,A0A1W6MIP2,A0A2U2J9E0,B1XJG0,A0A097QRL6,K9RC91,A0A1T4Y3A2,B6YTQ5,K9UQR0,A0A1Z4K1Y3,K9UEV4,A0A496APJ8,A0A062U2W9,H0HWQ5,A0A1V9G9U4,A0A1I2ZGP1,A0A317EJY3,A0A1I2BD20,F8ERC7,A0A0Q2M2Z1,I3TE64,A0A139WY18,A0A2T1E1K4,A0A1Q8ZD62,A0A1Z3HNN4,E0UCX3,K9XZC6,A0A0C1VHB4,A0A329TD61,A0A1E3XF49,A0A1Q1FPH0,L0JS08,A0A345E7N0,M0AF24,A0A1W2A082,A0A1H3X247,A0A346PK63,A0A1H2RBI2,A0A1C3ZXN2,B9LVP8,A0A343TL88,A0A3P3RGE5,A0A329TBQ3,A0A285N2A8,A0A0W1S8B8,A0A1V4C8L7,L9VRQ2,E4NRV1,A0A1I6HGN0,,",366,37
"698","C.L11.2","C.L3.16",304,168,136,1.90668767507003,"4F1N,4F3T,4KRE,5GUH,6KR6,6OON,7KX7,A0A163JTZ6,J9D5G4,C4LVV2,A0A0G4H2S4,T1H8B3,R1FDF0,S4RWI0,D2VMG4,A0A074TLL7,A0A0D1ZAJ4,Q1K660,A0A3M7S814,A0A164ZA52,A0A383WDW5,I0YVB2,R7QGN7,A0A2C5Z0M1,A0CB11,R9ACY5,A0A1Z5TVE5,A0A1U7LLR0,A0A4S2MWZ7,K1VVQ6,A0A158P1R9,G7DVX0,V6R0U9,G4N9J3,E3KLI3,B7Q5I1,A0A1E3QC61,D5GGK8,S8ANP9,A0A139AUH8,L2GMR6,U4LBG4,A0A177URI1,O74957,A0A3N4IGK1,A6N7Y9,A0A0E9NDK5,T1KZ60,A0A250WXN5,A0A2G8JLH3,Q5KAT1,L2GUF2,W2T741,A0A1W0E4B5,A0A2J7QB22,S4RYE2,A0A2K3CW87,A0A388KES6,A0A226EFL3,A0A3S3PD82,A0A1S3J512,G0QTT2,A0A1J1HRI1,C4V9J2,Q9JMB7,A0A075AN09,Q5TW24,U5HIG6,A0A401PRI6,Q96J94,A0A2B4RHN2,G2QEV0,A0A397UU01,A0A2T7PFL8,K7ISV0,A0A024FT57,H3HCL6,A0A0G4IME3,E9FUN9,A0A1S3CYL5,D7FQK3,A0A1Y1YHC8,T1GSU4,F4S231,A0A1D8PMK0,A0A2G5B1D8,Q5BD61,A0A1C7M8P2,A0A4D8YSQ3,A0A158PJG6,J9JZ66,A0A0C2XG51,A0A158QZT6,A0A165QYQ9,T0SAU8,R7YY92,A0A3S1A0C3,A0A074YJ47,A0A2K1J482,A0A1Q3ENA6,O04379,A0A371I3C8,M8AEW7,A8P0D4,A0A2K3NY65,F4NYW7,A0A409Y6G2,A0A0L0HAB7,D8PZT7,A0A1D1W4K0,A7RQ46,W4YU94,A7BJS5,D8SNM6,A0A1J8PPA3,X1WG39,M5FQK2,Q69VD5,A0A2R6NSC2,A0A0D8XL16,A0A016WPN3,Q9QZ81,G5EES3,A0A0K0EFP6,Q8CJG0,A0A1D5NTU6,V2WTL2,A0A0V0YLH8,A0A139WDH0,A0A0R3W9Q7,H3DS31,A0A1Y1HWP2,G4T5G9,B7QCC4,A0A0B2UV00,M7BCJ9,E9GN30,Q7PZ41,A0A077Z361,R7U9I3,A0A1X7V1N5,A0A0K0JDP1,A0A0N4UKJ1,A0A498N3A3,A0A3M0IQP5,A0A0L8GBV4,Q32KD4,A0A1J1JBJ0,E0W4C3,A0A482XDA9,A0A3P7EJD6,J9K2Z4,A0A2J7Q8V4,T1IBM6,V3ZRX0,A0A210QKF7,A0A423TSS1,K1PT78,A0A267E8R7,A0A1D2N447,A0A226D7A9,F6YK55,T1KTE4,A0A2C9JGZ6,A0A1V9X9F0,K5X5Z7,A0A3Q0KUG5,T1FY40,1YVU,1Z26,3DLB,5AWH,5G5T,5I4A,6QZK,E8N0K8,A0A1I7IXT4,A0A2W1JZ37,A0A2S7WBN3,A0A328VKE4,A0A420DFE6,A0A4V1VDY2,A0A368P5I0,A0A4R1RMM2,A0A1Y2RDH8,A0A1M5ZSR3,A0A0K8QX04,K9TPA9,A0A1L3JHM3,A0A1W6MIP2,A0A2U2J9E0,A0A2Z6E1D5,A0A0F4NXW8,B1XJG0,A0A326U7G5,A0A3D8L290,A0A1Q4R485,K9U8J6,A0A097QRL6,K9RC91,A0A0D8ZUC0,A0A139XGN8,Q5P0R2,B6YTQ5,A0YYT3,A0A2T1EFY0,G6FTN0,A0A433NB65,A0A1Z4L0A1,K9UQR0,A0A2T1G8M7,K9VUN0,K9ZDE3,B0JXD6,A0A2T1LS63,A0A1Z4K1Y3,A0A0P4UVI8,A0A0V7ZCG4,A0A1J0AGK2,K9PFF9,A0A2G9DT08,K9UEV4,Q9L1X1,A0A1H3LE92,A0A1V9G9U4,S7VLM7,A0A1A5X8H4,A0A1I2T6Q1,A0A1R3T9N6,A0A0Q2M2Z1,H8KXJ0,D3S0S6,A0A2D1U4H7,I3TE64,A0A0B7I4Z6,Q8DKB1,A0A4Q6XKV6,A0A239JE83,A0A2N4XBY2,R5JEI2,A0A0Q0ZC47,A0A2T0XH18,A0A1V4CHV0,A0A1K1RQP7,A0A2T1EKT1,A0A1N6LUI7,A0A0P0NGR6,A0A1X7IML5,A0A0A2LKJ7,K1L112,A0A0U3AL92,A0A1H3A054,E0UCX3,K9XZC6,B9LVW4,A0A0C1VHB4,Q31N05,A0A0C5JKF3,R5NJJ8,A5D4D9,Q2JI93,A0A142Y7A9,A0A432MEQ5,A0A3R7KLK4,C1F5Q7,A0A4R3EV39,A0A1P8WP90,A0A222F7P0,A0A1C9VH88,A0A329TD61,A0A101R2A0,A0A1Q1FPH0,E0TGY3,A0A4Q2UIU6,A0A1H0LH25,A0A318LG42,L0JS08,A0A345E7N0,M0AF24,A0A1H3X247,A0A0C1XUA0,M0D2X3,A0A2R5G167,A0A346PK63,R7RTW6,A0A1H2RBI2,B9LVP8,M5RSF0,W0JW77,B7K585,F8D8G0,A0A343TL88,L0AJX6,A0A2A5QS34,A0A343JEE2,A0A3P3RGE5,A0A329TBQ3,A0A285N2A8,A0A0W1S8B8,A0A1V4C8L7,L9VRQ2,E4NRV1,A0A1I6HGN0,A0A1I0NI68,,",366,37
"710","C.H4.2","C.H4.4",320,169,151,1.71025510404013,"4F1N,4F3T,4KRE,5GUH,5VM9,6KR6,6OON,7KX7,7SWF,A0A163JTZ6,A0A0N4X8S8,A0A196SDB4,J9D5G4,C4LVV2,A0A2P6N8X7,A2DPV7,A0A0G4H2S4,T1H8B3,S4RWI0,D2VMG4,A0A0D1ZAJ4,Q1K660,F4PH46,A0A3M7S814,A0A164ZA52,Q54G64,S7WCF7,A0A2C5Z0M1,A0CB11,R9ACY5,D3BMP8,A0A1Z5TVE5,W7XD45,A0A1U7LLR0,A0A4S2MWZ7,K1VVQ6,A0A158P1R9,V6R0U9,G4N9J3,B7Q5I1,A0A1E3QC61,D5GGK8,S8ANP9,A0A139AUH8,L2GMR6,U4LBG4,A0A177URI1,O74957,A0A3N4IGK1,A6N7Y9,A0A0E9NDK5,T1KZ60,A0A2G8JLH3,Q5KAT1,L2GUF2,W2T741,A0A1W0E4B5,A0A2J7QB22,S4RYE2,A0A388KES6,A0A226EFL3,A0A3S3PD82,A0A0L0TEV1,A0A1S3J512,G0QTT2,A0A1J1HRI1,C4V9J2,Q9JMB7,A0A075AN09,Q5TW24,U5HIG6,A0A401PRI6,Q96J94,A0A2B4RHN2,G2QEV0,A0A397UU01,A0A2T7PFL8,K7ISV0,A0A024FT57,H3HCL6,A0A0G4IME3,A0A1S3CYL5,D7FQK3,A0A1Y1YHC8,T1GSU4,A0A1D8PMK0,A0A2G5B1D8,Q5BD61,A0A1C7M8P2,A0A4D8YSQ3,A0A158PJG6,J9JZ66,A0A0C2XG51,A0A158QZT6,A0A165QYQ9,T0SAU8,R7YY92,A0A3S1A0C3,A0A074YJ47,A0A2K1J482,A0A1Q3ENA6,O04379,A0A371I3C8,M8AEW7,A8P0D4,A0A2K3NY65,F4NYW7,A0A409Y6G2,A0A0L0HAB7,D8PZT7,A0A1D1W4K0,A7RQ46,W4YU94,A7BJS5,D8SNM6,A0A1J8PPA3,X1WG39,M5FQK2,Q69VD5,A0A2R6NSC2,A0A0D8XL16,A0A016WPN3,Q9QZ81,G5EES3,A0A0K0EFP6,Q8CJG0,A0A1D5NTU6,V2WTL2,A0A0V0YLH8,A0A139WDH0,A0A0R3W9Q7,H3DS31,A0A1Y1HWP2,G4T5G9,B7QCC4,A0A0B2UV00,M7BCJ9,E9GN30,Q7PZ41,A0A077Z361,R7U9I3,A0A1X7V1N5,A0A0K0JDP1,A0A0N4UKJ1,A0A498N3A3,A0A3M0IQP5,A0A0L8GBV4,Q32KD4,A0A1J1JBJ0,E0W4C3,A0A482XDA9,A0A3P7EJD6,J9K2Z4,A0A2J7Q8V4,T1IBM6,V3ZRX0,A0A210QKF7,A0A423TSS1,K1PT78,A0A267E8R7,A0A1D2N447,A0A226D7A9,F6YK55,T1KTE4,A0A2C9JGZ6,A0A1V9X9F0,K5X5Z7,A0A3Q0KUG5,T1FY40,1YVU,1Z26,5AWH,5G5T,5I4A,6QZK,E8N0K8,A0A1I7IXT4,A0A2W1JZ37,A0A2S7WBN3,A0A420DFE6,A0A4V1VDY2,A0A368P5I0,A0A4R1RMM2,A0A1Y2RDH8,Q11QW7,A0A1M5ZSR3,A0A0K8QX04,A0A0M2PXX3,K9TPA9,A0A1L3JHM3,A0A1W6MIP2,A0A1C0UUC4,A0A2U2J9E0,A0A326U7G5,A0A3D8L290,H1KXR6,A0A1Q4R485,K9U8J6,K9RC91,A0A0D8ZUC0,A0A139XGN8,A0A1T4Y3A2,A0YYT3,A0A2T1EFY0,G6FTN0,R6KUL9,A0A433NB65,A0A1Z4L0A1,K9UQR0,A0A2T1G8M7,K9VUN0,A0A0P6X5X2,K9ZDE3,B0JXD6,A0A2T1LS63,A0A1Z4K1Y3,A0A1N6SSK9,A0A0P4UVI8,A0A0V7ZCG4,A0A1J0AGK2,K9PFF9,A0A2G9DT08,K9UEV4,Q9L1X1,A0A060HNJ0,A0A235B542,R5XQK4,A0A1H3LE92,A0A496APJ8,A0A1V9G9U4,S7VLM7,A0A1A5X8H4,A0A1I2T6Q1,A0A1R3T9N6,A0A0Q2M2Z1,H8KXJ0,D3S0S6,A0A2D1U4H7,I3TE64,A0A0B7I4Z6,A0LL61,A0A139WY18,A0A2T1E1K4,A0A1Q8ZD62,A0A4Q6XKV6,A0A1Z3HNN4,A0A239JE83,A0A2N4XBY2,R5JEI2,A0A0Q0ZC47,A0A2T0XH18,A0A1V4CHV0,A0A1K1RQP7,A0A1N6LUI7,A0A0P0NGR6,A0A1X7IML5,A0A0A2LKJ7,K1L112,A0A0U3AL92,A0A1H3A054,B9LVW4,A0A0C5JKF3,R5NJJ8,A5D4D9,A0A142Y7A9,A0A432MEQ5,A0A372DKU2,A0A3R7KLK4,C1F5Q7,A0A4R3EV39,A0A1P8WP90,A0A222F7P0,A0A1C9VH88,A0A2T2YMB1,A0A329TD61,A0A101R2A0,A0A1E3XF49,A0A1U9ND56,A0A4R7BQC4,A0A1H3DGN3,A0A1Q1FPH0,E0TGY3,A0A259TUP4,F6EYI8,A0A2S9Q9J0,A0A4Q2UIU6,A0A1H0LH25,A0A318LG42,H1YCU5,L0JS08,A0A1Q5ZS75,A0A345E7N0,M0AF24,A0A1W2A082,A0A1H3X247,A0A0C1XUA0,M0D2X3,A0A2R5G167,A0A346PK63,R7RTW6,A0A1H2RBI2,A0A1C3ZXN2,B9LVP8,M5RSF0,W0JW77,B7K585,F8D8G0,A0A343TL88,L0AJX6,A0A2A5QS34,A0A343JEE2,A0A3P3RGE5,A0A329TBQ3,A0A285N2A8,A0A0W1S8B8,A0A1V4C8L7,L9VRQ2,E4NRV1,A0A1I6HGN0,A0A1I0NI68,,",366,37
"714","C.L20.1","C.L20.3",243,169,74,2.08911722373261,"4F3T,4KRE,5GUH,6KR6,6OON,7KX7,7SWF,A0A163JTZ6,A0A0N4X8S8,A0A196SDB4,J9D5G4,C4LVV2,A8BCK6,A0A0G4H2S4,S4RWI0,D2VMG4,A0A0D1ZAJ4,Q1K660,F4PH46,A0A3M7S814,A0A164ZA52,A0A383WDW5,Q54G64,S7WCF7,I0YVB2,R7QGN7,C1DZY0,A0A2C5Z0M1,A0CB11,R9ACY5,D3BMP8,A0A1Z5TVE5,W7XD45,A0A1U7LLR0,A0A4S2MWZ7,A0A158P1R9,G7DVX0,V6R0U9,G4N9J3,B7Q5I1,A0A1E3QC61,D5GGK8,S8ANP9,A0A139AUH8,L2GMR6,U4LBG4,A0A177URI1,O74957,A0A3N4IGK1,A6N7Y9,A0A0E9NDK5,T1KZ60,A0A250WXN5,A0A2G8JLH3,Q5KAT1,L2GUF2,W2T741,A0A1W0E4B5,A0A2J7QB22,A0A388KES6,A0A226EFL3,A0A3S3PD82,A0A0L0TEV1,A0A1S3J512,G0QTT2,A0A1J1HRI1,C4V9J2,Q9JMB7,A0A075AN09,Q5TW24,U5HIG6,A0A401PRI6,Q96J94,A0A2B4RHN2,G2QEV0,A0A397UU01,A0A2T7PFL8,K7ISV0,A0A024FT57,H3HCL6,A0A0G4IME3,E9FUN9,A0A1S3CYL5,D7FQK3,A0A1Y1YHC8,T1GSU4,F4S231,Q5BD61,A0A1C7M8P2,A0A4D8YSQ3,A0A158PJG6,J9JZ66,A0A0C2XG51,A0A158QZT6,A0A165QYQ9,T0SAU8,R7YY92,A0A3S1A0C3,A0A074YJ47,A0A2K1J482,A0A1Q3ENA6,O04379,A0A371I3C8,M8AEW7,A8P0D4,A0A2K3NY65,F4NYW7,A0A409Y6G2,A0A0L0HAB7,D8PZT7,A0A1D1W4K0,A7RQ46,W4YU94,A7BJS5,D8SNM6,A0A1J8PPA3,X1WG39,M5FQK2,Q69VD5,A0A2R6NSC2,A0A0D8XL16,A0A016WPN3,Q9QZ81,G5EES3,A0A0K0EFP6,Q8CJG0,A0A1D5NTU6,V2WTL2,A0A0V0YLH8,A0A139WDH0,A0A0R3W9Q7,H3DS31,A0A1Y1HWP2,G4T5G9,B7QCC4,A0A0B2UV00,M7BCJ9,E9GN30,Q7PZ41,A0A077Z361,R7U9I3,A0A1X7V1N5,A0A0K0JDP1,A0A0N4UKJ1,A0A498N3A3,A0A3M0IQP5,A0A0L8GBV4,Q32KD4,A0A1J1JBJ0,E0W4C3,A0A482XDA9,A0A3P7EJD6,J9K2Z4,A0A2J7Q8V4,T1IBM6,V3ZRX0,A0A210QKF7,A0A423TSS1,K1PT78,A0A267E8R7,A0A1D2N447,A0A226D7A9,F6YK55,T1KTE4,A0A2C9JGZ6,A0A1V9X9F0,K5X5Z7,A0A3Q0KUG5,T1FY40,1Z26,5AWH,5G5T,5I4A,6QZK,C4L1M1,Q11QW7,A0A0M2PXX3,A0A1I3LMA1,A0A1C0UUC4,A0A3D8L290,A0A097QRL6,A0A1T4Y3A2,A0A0B0H9B4,R6KUL9,B7GJX9,A0A1N6SSK9,A0A2G9DT08,Q9L1X1,R5XQK4,A0A496APJ8,A0A1V9G9U4,S7VLM7,A0A1I2T6Q1,A0A1R3T9N6,H8KXJ0,D3S0S6,A0A2D1U4H7,A0A0B7I4Z6,A0LL61,A0A139WY18,A0A2T1E1K4,A0A1Q8ZD62,A0A4Q6XKV6,A0A1Z3HNN4,A0A239JE83,A0A2N4XBY2,R5JEI2,A0A0Q0ZC47,A0A2T0XH18,A0A1V4CHV0,A0A1K1RQP7,A0A1N6LUI7,A0A0P0NGR6,A0A1X7IML5,A0A0A2LKJ7,K1L112,A0A0U3AL92,A0A1H3A054,A0A0C5JKF3,R5NJJ8,A5D4D9,A0A142Y7A9,A0A432MEQ5,A0A372DKU2,C1F5Q7,A0A4R3EV39,A0A1P8WP90,A0A222F7P0,A0A1C9VH88,A0A2T2YMB1,A0A101R2A0,A0A1H3DGN3,A0A259TUP4,F6EYI8,A0A2S9Q9J0,A0A4Q2UIU6,A0A1H0LH25,A0A318LG42,A0A2R5G167,M5RSF0,B7K585,L0AJX6,A0A343JEE2,,",366,37
"716","C.L21.16","N.S21.7",234,169,65,1.71952662721893,"4F1N,4F3T,4KRE,5VM9,6KR6,6OON,7KX7,A0A163JTZ6,A0A0N4X8S8,A0A196SDB4,J9D5G4,Q389P5,T1H8B3,R1FDF0,A0A074TLL7,A0A0D1ZAJ4,Q1K660,A0A3M7S814,A0A164ZA52,A0A383WDW5,Q54G64,S7WCF7,I0YVB2,R7QGN7,C1DZY0,A0A2C5Z0M1,A0CB11,R9ACY5,D3BMP8,A0A1Z5TVE5,W7XD45,A0A1U7LLR0,K1VVQ6,G7DVX0,V6R0U9,G4N9J3,E3KLI3,B7Q5I1,A0A1E3QC61,D5GGK8,S8ANP9,A0A139AUH8,L2GMR6,U4LBG4,A0A177URI1,O74957,A0A3N4IGK1,A6N7Y9,A0A0E9NDK5,T1KZ60,A0A250WXN5,A0A2G8JLH3,Q5KAT1,W2T741,A0A1W0E4B5,A0A2J7QB22,S4RYE2,A0A2K3CW87,A0A388KES6,A0A226EFL3,A0A3S3PD82,A0A0L0TEV1,A0A1S3J512,A0A1J1HRI1,C4V9J2,Q9JMB7,A0A075AN09,Q5TW24,U5HIG6,A0A401PRI6,Q96J94,A0A2B4RHN2,G2QEV0,A0A397UU01,A0A2T7PFL8,K7ISV0,A0A024FT57,H3HCL6,A0A0G4IME3,E9FUN9,A0A1S3CYL5,D7FQK3,A0A1Y1YHC8,T1GSU4,F4S231,A0A1D8PMK0,A0A2G5B1D8,Q5BD61,A0A1C7M8P2,A0A4D8YSQ3,A0A158PJG6,J9JZ66,A0A0C2XG51,A0A158QZT6,A0A165QYQ9,T0SAU8,R7YY92,A0A3S1A0C3,A0A074YJ47,A0A2K1J482,A0A1Q3ENA6,O04379,A0A371I3C8,M8AEW7,A8P0D4,A0A2K3NY65,F4NYW7,A0A409Y6G2,A0A0L0HAB7,D8PZT7,A0A1D1W4K0,A7RQ46,W4YU94,A7BJS5,D8SNM6,A0A1J8PPA3,X1WG39,M5FQK2,Q69VD5,A0A2R6NSC2,A0A0D8XL16,A0A016WPN3,Q9QZ81,G5EES3,A0A0K0EFP6,Q8CJG0,A0A1D5NTU6,V2WTL2,A0A0V0YLH8,A0A139WDH0,A0A0R3W9Q7,H3DS31,A0A1Y1HWP2,G4T5G9,B7QCC4,A0A0B2UV00,M7BCJ9,E9GN30,Q7PZ41,A0A077Z361,R7U9I3,A0A1X7V1N5,A0A0K0JDP1,A0A0N4UKJ1,A0A498N3A3,A0A3M0IQP5,A0A0L8GBV4,Q32KD4,A0A1J1JBJ0,E0W4C3,A0A482XDA9,A0A3P7EJD6,J9K2Z4,A0A2J7Q8V4,T1IBM6,V3ZRX0,A0A210QKF7,A0A423TSS1,K1PT78,A0A267E8R7,A0A1D2N447,A0A226D7A9,F6YK55,T1KTE4,A0A2C9JGZ6,A0A1V9X9F0,K5X5Z7,A0A3Q0KUG5,T1FY40,1YVU,5AWH,5G5T,6QZK,7R8K,A0A2Z6E1D5,A0A496APJ8,H0HWQ5,A0A1V9G9U4,A0A1I2ZGP1,A0A317EJY3,A0A1I2BD20,F8ERC7,A0A1A5X8H4,A0A1R3T9N6,A0LL61,A0A139WY18,A0A1J1EK56,A0A2T1E1K4,A0A1Q8ZD62,A0A1Z3HNN4,Q53W94,A0A1V4CHV0,A0A1N6LUI7,A0A0U3AL92,A0A1H3A054,A0A0C5JKF3,R5NJJ8,A5D4D9,A0A142Y7A9,A0A372DKU2,A0A3R7KLK4,C1F5Q7,A0A1P8WP90,A0A222F7P0,A0A1C9VH88,A0A2T2YMB1,A0A1E3XF49,A0A1U9ND56,A0A4R7BQC4,A0A1H3DGN3,A0A1Q1FPH0,E0TGY3,A0A4Q2UIU6,H1YCU5,L0JS08,A0A1Q5ZS75,M0AF24,A0A1W2A082,A0A0C1XUA0,M0D2X3,A0A346PK63,R7RTW6,A0A1H2RBI2,A0A1C3ZXN2,B7K585,A0A343TL88,A0A343JEE2,A0A3P3RGE5,A0A329TBQ3,A0A0W1S8B8,L9VRQ2,E4NRV1,A0A1I6HGN0,A0A1I0NI68,,",366,37
"717","C.L22.2","C.S14.3",274,169,105,1.75936883629191,"4F1N,4F3T,4KRE,5GUH,5VM9,6OON,7SWF,A0A163JTZ6,A0A0N4X8S8,A0A196SDB4,Q389P5,C4LVV2,A2DPV7,A0A0G4H2S4,D2VMG4,A0A0D1ZAJ4,Q1K660,F4PH46,A0A3M7S814,A0A164ZA52,A0A383WDW5,Q54G64,I0YVB2,R7QGN7,C1DZY0,A0A2C5Z0M1,A0CB11,D3BMP8,A0A1Z5TVE5,W7XD45,A0A1U7LLR0,A0A4S2MWZ7,K1VVQ6,A0A158P1R9,G7DVX0,V6R0U9,G4N9J3,E3KLI3,B7Q5I1,A0A1E3QC61,D5GGK8,S8ANP9,A0A139AUH8,U4LBG4,A0A177URI1,O74957,A0A3N4IGK1,A6N7Y9,A0A0E9NDK5,T1KZ60,A0A250WXN5,A0A2G8JLH3,Q5KAT1,L2GUF2,W2T741,A0A2J7QB22,S4RYE2,A0A2K3CW87,A0A388KES6,A0A226EFL3,A0A3S3PD82,A0A0L0TEV1,A0A1S3J512,G0QTT2,A0A1J1HRI1,Q9JMB7,A0A075AN09,Q5TW24,U5HIG6,A0A401PRI6,Q96J94,A0A2B4RHN2,G2QEV0,A0A397UU01,A0A2T7PFL8,K7ISV0,A0A024FT57,H3HCL6,A0A0G4IME3,E9FUN9,A0A1S3CYL5,D7FQK3,A0A1Y1YHC8,T1GSU4,F4S231,A0A1D8PMK0,A0A2G5B1D8,Q5BD61,A0A1C7M8P2,A0A4D8YSQ3,A0A158PJG6,J9JZ66,A0A0C2XG51,A0A158QZT6,A0A165QYQ9,T0SAU8,R7YY92,A0A3S1A0C3,A0A074YJ47,A0A2K1J482,A0A1Q3ENA6,O04379,A0A371I3C8,M8AEW7,A8P0D4,A0A2K3NY65,F4NYW7,A0A409Y6G2,A0A0L0HAB7,D8PZT7,A0A1D1W4K0,A7RQ46,W4YU94,A7BJS5,D8SNM6,A0A1J8PPA3,X1WG39,M5FQK2,Q69VD5,A0A2R6NSC2,A0A0D8XL16,A0A016WPN3,Q9QZ81,G5EES3,A0A0K0EFP6,Q8CJG0,A0A1D5NTU6,V2WTL2,A0A0V0YLH8,A0A139WDH0,A0A0R3W9Q7,H3DS31,A0A1Y1HWP2,G4T5G9,B7QCC4,A0A0B2UV00,M7BCJ9,E9GN30,Q7PZ41,A0A077Z361,R7U9I3,A0A1X7V1N5,A0A0K0JDP1,A0A0N4UKJ1,A0A498N3A3,A0A3M0IQP5,A0A0L8GBV4,Q32KD4,A0A1J1JBJ0,E0W4C3,A0A482XDA9,A0A3P7EJD6,J9K2Z4,A0A2J7Q8V4,T1IBM6,V3ZRX0,A0A210QKF7,A0A423TSS1,K1PT78,A0A267E8R7,A0A1D2N447,A0A226D7A9,F6YK55,T1KTE4,A0A2C9JGZ6,A0A1V9X9F0,K5X5Z7,A0A3Q0KUG5,T1FY40,3DLB,7R8K,E8N0K8,A0A1I7IXT4,A0A2W1JZ37,A0A2S7WBN3,A0A328VKE4,A0A420DFE6,E0ST67,A0A4V1VDY2,A0A368P5I0,A0A4R1RMM2,A0A1Y2RDH8,A0A1M5ZSR3,A0A0M2PXX3,K9TPA9,A0A1W6MIP2,A0A1C0UUC4,A0A2U2J9E0,A0A0F4NXW8,A0A142XB92,A0A326U7G5,A0A1Q4R485,K9U8J6,K9RC91,A0A0D8ZUC0,A0A139XGN8,A0A1T4Y3A2,Q5P0R2,A0YYT3,A0A2T1EFY0,G6FTN0,A0A433NB65,A0A1Z4L0A1,K9UQR0,A0A2T1G8M7,K9VUN0,A0A0P6X5X2,K9ZDE3,B0JXD6,A0A2T1LS63,A0A1Z4K1Y3,A0A0P4UVI8,A0A0V7ZCG4,A0A1J0AGK2,K9PFF9,A0A2G9DT08,K9UEV4,Q9L1X1,A0A496APJ8,A0A062U2W9,A0A1V9G9U4,F8ERC7,A0A1A5X8H4,A0A1I2T6Q1,A0A1R3T9N6,A0A0Q2M2Z1,H8KXJ0,A0A2D1U4H7,A0A0B7I4Z6,A0LL61,A0A139WY18,A0A1J1EK56,A0A4Q6XKV6,A0A1Z3HNN4,A0A2N4XBY2,Q53W94,R5JEI2,A0A0Q0ZC47,A0A1V4CHV0,A0A1K1RQP7,A0A1N6LUI7,A0A0P0NGR6,A0A0A2LKJ7,K1L112,A0A0U3AL92,A0A1H3A054,A0A0C5JKF3,A5D4D9,A0A142Y7A9,A0A372DKU2,C1F5Q7,A0A4R3EV39,A0A1P8WP90,A0A222F7P0,A0A1C9VH88,A0A2T2YMB1,A0A329TD61,A0A101R2A0,A0A1U9ND56,A0A4R7BQC4,A0A1H3DGN3,A0A1Q1FPH0,E0TGY3,A0A259TUP4,F6EYI8,A0A2S9Q9J0,A0A1H0LH25,A0A318LG42,A0A345E7N0,A0A1H3X247,A0A2R5G167,A0A1H2RBI2,A0A1C3ZXN2,B9LVP8,,",366,37
"719","C.S11.1","C.S12.1",348,169,179,3.22058774916532,"4F1N,4F3T,4KRE,5GUH,5VM9,6KR6,6OON,7KX7,A0A163JTZ6,A0A0N4X8S8,A0A196SDB4,J9D5G4,C4LVV2,A0A2P6N8X7,A8BCK6,A2DPV7,A0A0G4H2S4,T1H8B3,R1FDF0,S4RWI0,D2VMG4,A0A074TLL7,A0A0D1ZAJ4,Q1K660,F4PH46,A0A3M7S814,A0A164ZA52,A0A383WDW5,Q54G64,S7WCF7,R7QGN7,C1DZY0,A0A2C5Z0M1,A0CB11,R9ACY5,D3BMP8,W7XD45,A0A1U7LLR0,A0A4S2MWZ7,K1VVQ6,A0A158P1R9,G7DVX0,V6R0U9,G4N9J3,E3KLI3,B7Q5I1,A0A1E3QC61,D5GGK8,S8ANP9,A0A139AUH8,L2GMR6,U4LBG4,A0A177URI1,O74957,A0A3N4IGK1,A6N7Y9,A0A0E9NDK5,A0A250WXN5,A0A2G8JLH3,Q5KAT1,L2GUF2,W2T741,A0A1W0E4B5,A0A2J7QB22,A0A2K3CW87,A0A226EFL3,A0A3S3PD82,A0A0L0TEV1,A0A1S3J512,G0QTT2,A0A1J1HRI1,C4V9J2,Q9JMB7,A0A075AN09,Q5TW24,U5HIG6,A0A401PRI6,Q96J94,A0A2B4RHN2,G2QEV0,A0A397UU01,A0A2T7PFL8,K7ISV0,A0A024FT57,H3HCL6,A0A0G4IME3,A0A1S3CYL5,D7FQK3,A0A1Y1YHC8,T1GSU4,F4S231,A0A1D8PMK0,A0A2G5B1D8,Q5BD61,A0A1C7M8P2,A0A4D8YSQ3,A0A158PJG6,J9JZ66,A0A0C2XG51,A0A158QZT6,A0A165QYQ9,T0SAU8,R7YY92,A0A3S1A0C3,A0A074YJ47,A0A1Q3ENA6,A8P0D4,A0A2K3NY65,F4NYW7,A0A409Y6G2,A0A0L0HAB7,D8PZT7,A0A1D1W4K0,A7RQ46,W4YU94,A7BJS5,D8SNM6,A0A1J8PPA3,X1WG39,M5FQK2,A0A2R6NSC2,A0A0D8XL16,A0A016WPN3,Q9QZ81,G5EES3,A0A0K0EFP6,Q8CJG0,A0A1D5NTU6,V2WTL2,A0A0V0YLH8,A0A139WDH0,A0A0R3W9Q7,H3DS31,G4T5G9,B7QCC4,A0A0B2UV00,M7BCJ9,E9GN30,Q7PZ41,A0A077Z361,R7U9I3,A0A1X7V1N5,A0A0K0JDP1,A0A0N4UKJ1,A0A498N3A3,A0A3M0IQP5,A0A0L8GBV4,Q32KD4,A0A1J1JBJ0,E0W4C3,A0A482XDA9,A0A3P7EJD6,J9K2Z4,A0A2J7Q8V4,T1IBM6,V3ZRX0,A0A210QKF7,A0A423TSS1,K1PT78,A0A267E8R7,A0A1D2N447,A0A226D7A9,F6YK55,T1KTE4,A0A2C9JGZ6,A0A1V9X9F0,K5X5Z7,A0A3Q0KUG5,T1FY40,1YVU,1Z26,3DLB,5AWH,5G5T,5I4A,6QZK,7R8K,E8N0K8,A0A1I7IXT4,A0A2W1JZ37,A0A2S7WBN3,A0A328VKE4,A0A420DFE6,E0ST67,A0A4V1VDY2,A0A368P5I0,C4L1M1,A0A4R1RMM2,A0A1Y2RDH8,A0A1M5ZSR3,A0A0K8QX04,A0A0M2PXX3,A0A1I3LMA1,K9TPA9,A0A1L3JHM3,A0A1W6MIP2,A0A1C0UUC4,A0A2Z6E1D5,A0A0F4NXW8,A0A142XB92,L8D0R3,B1XJG0,A0A326U7G5,A0A3D8L290,H1KXR6,A0A1Q4R485,K9U8J6,A0A097QRL6,K9RC91,A0A0D8ZUC0,A0A139XGN8,A0A1T4Y3A2,Q5P0R2,B6YTQ5,A0A0B0H9B4,A0YYT3,A0A2T1EFY0,G6FTN0,R6KUL9,A0A433NB65,A0A1Z4L0A1,K9UQR0,A0A2T1G8M7,K9VUN0,B7GJX9,A0A0P6X5X2,K9ZDE3,B0JXD6,A0A2T1LS63,A0A1Z4K1Y3,A0A2Z6E0R7,A0A1N6SSK9,A0A0P4UVI8,A0A0V7ZCG4,A0A1J0AGK2,K9PFF9,A0A2G9DT08,K9UEV4,Q9L1X1,A0A060HNJ0,A0A235B542,R5XQK4,A0A1H3LE92,A0A496APJ8,A0A062U2W9,H0HWQ5,A0A1V9G9U4,A0A1I2BD20,F8ERC7,S7VLM7,A0A1A5X8H4,A0A1I2T6Q1,A0A1R3T9N6,A0A0Q2M2Z1,H8KXJ0,D3S0S6,A0A2D1U4H7,I3TE64,A0A0B7I4Z6,A0LL61,Q8DKB1,A0A139WY18,A0A1J1EK56,A0A2T1E1K4,A0A1Q8ZD62,A0A4Q6XKV6,A0A1Z3HNN4,A0A239JE83,A0A2N4XBY2,Q53W94,R5JEI2,A0A0Q0ZC47,A0A2T0XH18,A0A1V4CHV0,A0A1K1RQP7,A0A2T1EKT1,A0A1N6LUI7,A0A0P0NGR6,A0A1X7IML5,A0A0A2LKJ7,K1L112,A0A0U3AL92,A0A1H3A054,E0UCX3,K9XZC6,B9LVW4,A0A0C1VHB4,Q31N05,A0A0C5JKF3,R5NJJ8,A5D4D9,Q2JI93,A0A142Y7A9,A0A432MEQ5,A0A372DKU2,A0A3R7KLK4,C1F5Q7,A0A4R3EV39,A0A1P8WP90,A0A222F7P0,A0A1C9VH88,A0A2T2YMB1,A0A329TD61,A0A101R2A0,A0A1E3XF49,A0A1U9ND56,A0A4R7BQC4,A0A1H3DGN3,A0A1Q1FPH0,E0TGY3,A0A259TUP4,F6EYI8,A0A2S9Q9J0,A0A4Q2UIU6,A0A1H0LH25,A0A318LG42,H1YCU5,L0JS08,A0A1Q5ZS75,A0A345E7N0,M0AF24,A0A1W2A082,A0A1H3X247,A0A0C1XUA0,M0D2X3,A0A2R5G167,A0A346PK63,R7RTW6,A0A1H2RBI2,A0A1C3ZXN2,B9LVP8,M5RSF0,W0JW77,B7K585,F8D8G0,A0A343TL88,L0AJX6,A0A2A5QS34,A0A343JEE2,A0A3P3RGE5,A0A329TBQ3,A0A285N2A8,A0A0W1S8B8,A0A1V4C8L7,L9VRQ2,E4NRV1,A0A1I6HGN0,A0A1I0NI68,,",366,37
"721","C.S14.3","C.S15.2",328,169,159,2.81176733281233,"4F3T,4KRE,5GUH,6KR6,6OON,7KX7,A0A163JTZ6,A0A0N4X8S8,A0A196SDB4,Q389P5,C4LVV2,A2DPV7,A0A0G4H2S4,R1FDF0,D2VMG4,A0A074TLL7,A0A0D1ZAJ4,Q1K660,F4PH46,A0A3M7S814,A0A164ZA52,A0A383WDW5,Q54G64,I0YVB2,R7QGN7,C1DZY0,A0A2C5Z0M1,A0CB11,R9ACY5,D3BMP8,A0A1Z5TVE5,W7XD45,A0A1U7LLR0,A0A4S2MWZ7,K1VVQ6,A0A158P1R9,G7DVX0,V6R0U9,G4N9J3,E3KLI3,A0A1E3QC61,S8ANP9,A0A139AUH8,U4LBG4,A0A177URI1,O74957,A0A3N4IGK1,A6N7Y9,A0A0E9NDK5,T1KZ60,A0A250WXN5,A0A2G8JLH3,Q5KAT1,L2GUF2,W2T741,A0A2J7QB22,S4RYE2,A0A2K3CW87,A0A388KES6,A0A226EFL3,A0A3S3PD82,A0A0L0TEV1,A0A1S3J512,G0QTT2,A0A1J1HRI1,Q9JMB7,A0A075AN09,Q5TW24,U5HIG6,A0A401PRI6,Q96J94,A0A2B4RHN2,G2QEV0,A0A397UU01,A0A2T7PFL8,K7ISV0,A0A024FT57,H3HCL6,A0A0G4IME3,E9FUN9,A0A1S3CYL5,D7FQK3,A0A1Y1YHC8,T1GSU4,F4S231,A0A1D8PMK0,A0A2G5B1D8,Q5BD61,A0A1C7M8P2,A0A4D8YSQ3,A0A158PJG6,J9JZ66,A0A0C2XG51,A0A158QZT6,A0A165QYQ9,T0SAU8,R7YY92,A0A3S1A0C3,A0A074YJ47,A0A2K1J482,A0A1Q3ENA6,O04379,A0A371I3C8,M8AEW7,A8P0D4,A0A2K3NY65,F4NYW7,A0A409Y6G2,A0A0L0HAB7,D8PZT7,A0A1D1W4K0,A7RQ46,W4YU94,A7BJS5,D8SNM6,A0A1J8PPA3,X1WG39,M5FQK2,Q69VD5,A0A2R6NSC2,A0A0D8XL16,A0A016WPN3,Q9QZ81,G5EES3,A0A0K0EFP6,Q8CJG0,A0A1D5NTU6,V2WTL2,A0A0V0YLH8,A0A139WDH0,A0A0R3W9Q7,H3DS31,A0A1Y1HWP2,G4T5G9,B7QCC4,A0A0B2UV00,M7BCJ9,E9GN30,Q7PZ41,A0A077Z361,R7U9I3,A0A1X7V1N5,A0A0K0JDP1,A0A0N4UKJ1,A0A498N3A3,A0A3M0IQP5,A0A0L8GBV4,Q32KD4,A0A1J1JBJ0,E0W4C3,A0A482XDA9,A0A3P7EJD6,J9K2Z4,A0A2J7Q8V4,T1IBM6,V3ZRX0,A0A210QKF7,A0A423TSS1,K1PT78,A0A267E8R7,A0A1D2N447,A0A226D7A9,F6YK55,T1KTE4,A0A2C9JGZ6,A0A1V9X9F0,K5X5Z7,A0A3Q0KUG5,T1FY40,1YVU,1Z26,3DLB,5AWH,5G5T,5I4A,6QZK,7R8K,E8N0K8,A0A1I7IXT4,A0A2W1JZ37,A0A2S7WBN3,A0A328VKE4,A0A420DFE6,E0ST67,A0A4V1VDY2,A0A368P5I0,A0A4R1RMM2,A0A1Y2RDH8,Q11QW7,A0A1M5ZSR3,A0A0K8QX04,A0A0M2PXX3,K9TPA9,A0A1L3JHM3,A0A1W6MIP2,A0A1C0UUC4,A0A2U2J9E0,A0A142XB92,A0A326U7G5,A0A1Q4R485,K9U8J6,A0A097QRL6,K9RC91,A0A0D8ZUC0,A0A139XGN8,A0A1T4Y3A2,B6YTQ5,A0YYT3,A0A2T1EFY0,G6FTN0,R6KUL9,A0A433NB65,A0A1Z4L0A1,K9UQR0,A0A2T1G8M7,K9VUN0,A0A0P6X5X2,K9ZDE3,B0JXD6,A0A2T1LS63,A0A1Z4K1Y3,A0A0P4UVI8,A0A0V7ZCG4,A0A1J0AGK2,K9PFF9,A0A2G9DT08,K9UEV4,Q9L1X1,R5XQK4,A0A1H3LE92,A0A496APJ8,A0A062U2W9,H0HWQ5,A0A1V9G9U4,A0A1I2ZGP1,A0A317EJY3,A0A1I2BD20,F8ERC7,S7VLM7,A0A1A5X8H4,A0A1I2T6Q1,A0A1R3T9N6,A0A0Q2M2Z1,H8KXJ0,D3S0S6,A0A2D1U4H7,I3TE64,A0A0B7I4Z6,A0LL61,A0A139WY18,A0A1J1EK56,A0A2T1E1K4,A0A1Q8ZD62,A0A4Q6XKV6,A0A1Z3HNN4,A0A239JE83,A0A2N4XBY2,Q53W94,R5JEI2,A0A0Q0ZC47,A0A2T0XH18,A0A1V4CHV0,A0A1K1RQP7,A0A1N6LUI7,A0A0P0NGR6,A0A1X7IML5,A0A0A2LKJ7,K1L112,A0A0U3AL92,A0A1H3A054,B9LVW4,A0A0C5JKF3,R5NJJ8,A5D4D9,A0A142Y7A9,A0A432MEQ5,A0A372DKU2,C1F5Q7,A0A4R3EV39,A0A1P8WP90,A0A222F7P0,A0A1C9VH88,A0A2T2YMB1,A0A329TD61,A0A101R2A0,A0A1E3XF49,A0A1U9ND56,A0A4R7BQC4,A0A1Q1FPH0,E0TGY3,A0A259TUP4,F6EYI8,A0A2S9Q9J0,A0A4Q2UIU6,A0A1H0LH25,A0A318LG42,H1YCU5,L0JS08,A0A1Q5ZS75,A0A345E7N0,M0AF24,A0A1W2A082,A0A1H3X247,A0A0C1XUA0,M0D2X3,A0A2R5G167,A0A346PK63,R7RTW6,A0A1H2RBI2,A0A1C3ZXN2,B9LVP8,M5RSF0,W0JW77,B7K585,F8D8G0,A0A343TL88,L0AJX6,A0A2A5QS34,A0A343JEE2,A0A3P3RGE5,A0A329TBQ3,A0A285N2A8,A0A0W1S8B8,A0A1V4C8L7,L9VRQ2,E4NRV1,A0A1I6HGN0,A0A1I0NI68,,",366,37
"725","N.H5.12","N.L16.1",263,169,94,1.49376809769608,"4F1N,4F3T,4KRE,5GUH,5VM9,6KR6,6OON,7KX7,7SWF,A0A163JTZ6,A0A0N4X8S8,A0A196SDB4,J9D5G4,Q389P5,A0A2P6N8X7,A0A0G4H2S4,T1H8B3,S4RWI0,D2VMG4,Q1K660,F4PH46,A0A3M7S814,A0A164ZA52,Q54G64,S7WCF7,I0YVB2,R7QGN7,C1DZY0,A0A2C5Z0M1,A0CB11,R9ACY5,D3BMP8,A0A1Z5TVE5,W7XD45,A0A1U7LLR0,A0A4S2MWZ7,K1VVQ6,A0A158P1R9,G7DVX0,E3KLI3,A0A1E3QC61,D5GGK8,S8ANP9,A0A139AUH8,L2GMR6,U4LBG4,O74957,A0A3N4IGK1,A6N7Y9,A0A0E9NDK5,T1KZ60,A0A2G8JLH3,Q5KAT1,L2GUF2,W2T741,A0A1W0E4B5,A0A2J7QB22,S4RYE2,A0A388KES6,A0A226EFL3,A0A3S3PD82,A0A0L0TEV1,A0A1S3J512,A0A1J1HRI1,C4V9J2,Q9JMB7,A0A075AN09,Q5TW24,U5HIG6,A0A401PRI6,Q96J94,A0A2B4RHN2,G2QEV0,A0A397UU01,A0A2T7PFL8,K7ISV0,A0A024FT57,H3HCL6,A0A0G4IME3,E9FUN9,A0A1S3CYL5,D7FQK3,A0A1Y1YHC8,T1GSU4,F4S231,A0A1D8PMK0,A0A2G5B1D8,Q5BD61,A0A1C7M8P2,A0A4D8YSQ3,A0A158PJG6,J9JZ66,A0A0C2XG51,A0A158QZT6,A0A165QYQ9,T0SAU8,R7YY92,A0A3S1A0C3,A0A074YJ47,A0A2K1J482,A0A1Q3ENA6,O04379,A0A371I3C8,M8AEW7,A8P0D4,A0A2K3NY65,F4NYW7,A0A409Y6G2,A0A0L0HAB7,D8PZT7,A0A1D1W4K0,A7RQ46,W4YU94,A7BJS5,D8SNM6,A0A1J8PPA3,X1WG39,M5FQK2,Q69VD5,A0A2R6NSC2,A0A0D8XL16,A0A016WPN3,Q9QZ81,G5EES3,A0A0K0EFP6,Q8CJG0,A0A1D5NTU6,V2WTL2,A0A0V0YLH8,A0A139WDH0,A0A0R3W9Q7,H3DS31,A0A1Y1HWP2,G4T5G9,B7QCC4,A0A0B2UV00,M7BCJ9,E9GN30,Q7PZ41,A0A077Z361,R7U9I3,A0A1X7V1N5,A0A0K0JDP1,A0A0N4UKJ1,A0A498N3A3,A0A3M0IQP5,A0A0L8GBV4,Q32KD4,A0A1J1JBJ0,E0W4C3,A0A482XDA9,A0A3P7EJD6,J9K2Z4,A0A2J7Q8V4,T1IBM6,V3ZRX0,A0A210QKF7,A0A423TSS1,K1PT78,A0A267E8R7,A0A1D2N447,A0A226D7A9,F6YK55,T1KTE4,A0A2C9JGZ6,A0A1V9X9F0,K5X5Z7,A0A3Q0KUG5,T1FY40,1Z26,5AWH,5G5T,6QZK,7R8K,A0A0M2PXX3,A0A1C0UUC4,A0A142XB92,A0A326U7G5,A0A1T4Y3A2,A0A2G9DT08,Q9L1X1,A0A496APJ8,A0A062U2W9,H0HWQ5,A0A1V9G9U4,F8ERC7,S7VLM7,A0A1A5X8H4,A0A1I2T6Q1,A0A1R3T9N6,H8KXJ0,A0A2D1U4H7,A0A0B7I4Z6,A0LL61,A0A2T1E1K4,A0A1Q8ZD62,A0A4Q6XKV6,A0A1Z3HNN4,A0A239JE83,A0A2N4XBY2,R5JEI2,A0A0Q0ZC47,A0A2T0XH18,A0A1V4CHV0,A0A1K1RQP7,A0A1N6LUI7,A0A0P0NGR6,A0A1X7IML5,A0A0A2LKJ7,K1L112,A0A0U3AL92,A0A1H3A054,A0A0C5JKF3,R5NJJ8,A5D4D9,A0A142Y7A9,A0A432MEQ5,A0A372DKU2,C1F5Q7,A0A4R3EV39,A0A1P8WP90,A0A222F7P0,A0A1C9VH88,A0A2T2YMB1,A0A329TD61,A0A101R2A0,A0A1E3XF49,A0A1U9ND56,A0A4R7BQC4,A0A1Q1FPH0,E0TGY3,A0A259TUP4,F6EYI8,A0A2S9Q9J0,A0A4Q2UIU6,A0A1H0LH25,A0A318LG42,H1YCU5,A0A1Q5ZS75,A0A345E7N0,M0AF24,A0A1W2A082,A0A1H3X247,A0A0C1XUA0,M0D2X3,A0A2R5G167,A0A346PK63,R7RTW6,A0A1H2RBI2,A0A1C3ZXN2,B9LVP8,M5RSF0,B7K585,F8D8G0,A0A343TL88,A0A343JEE2,A0A3P3RGE5,A0A329TBQ3,A0A0W1S8B8,L9VRQ2,E4NRV1,A0A1I6HGN0,A0A1I0NI68,,",366,37
"730","N.L16.1","N.S14.4",277,169,108,1.91022901599825,"4F3T,4KRE,5GUH,5VM9,6KR6,6OON,7KX7,A0A163JTZ6,A0A196SDB4,Q389P5,C4LVV2,A0A2P6N8X7,A0A0G4H2S4,T1H8B3,S4RWI0,D2VMG4,Q1K660,F4PH46,A0A3M7S814,A0A164ZA52,A0A383WDW5,Q54G64,S7WCF7,I0YVB2,R7QGN7,C1DZY0,A0A2C5Z0M1,A0CB11,R9ACY5,D3BMP8,A0A1Z5TVE5,W7XD45,A0A1U7LLR0,A0A4S2MWZ7,K1VVQ6,A0A158P1R9,G7DVX0,V6R0U9,G4N9J3,E3KLI3,A0A1E3QC61,D5GGK8,S8ANP9,A0A139AUH8,L2GMR6,U4LBG4,O74957,A0A3N4IGK1,A6N7Y9,A0A0E9NDK5,T1KZ60,A0A250WXN5,A0A2G8JLH3,Q5KAT1,L2GUF2,W2T741,A0A1W0E4B5,A0A2J7QB22,S4RYE2,A0A2K3CW87,A0A388KES6,A0A226EFL3,A0A3S3PD82,A0A0L0TEV1,A0A1S3J512,A0A1J1HRI1,C4V9J2,Q9JMB7,A0A075AN09,Q5TW24,U5HIG6,A0A401PRI6,Q96J94,A0A2B4RHN2,G2QEV0,A0A397UU01,A0A2T7PFL8,K7ISV0,A0A024FT57,H3HCL6,A0A0G4IME3,E9FUN9,A0A1S3CYL5,D7FQK3,A0A1Y1YHC8,T1GSU4,F4S231,A0A1D8PMK0,Q5BD61,A0A1C7M8P2,A0A4D8YSQ3,A0A158PJG6,J9JZ66,A0A0C2XG51,A0A158QZT6,A0A165QYQ9,T0SAU8,R7YY92,A0A3S1A0C3,A0A074YJ47,A0A2K1J482,A0A1Q3ENA6,O04379,A0A371I3C8,M8AEW7,A8P0D4,A0A2K3NY65,F4NYW7,A0A409Y6G2,A0A0L0HAB7,D8PZT7,A0A1D1W4K0,A7RQ46,W4YU94,A7BJS5,D8SNM6,A0A1J8PPA3,X1WG39,Q69VD5,A0A2R6NSC2,A0A0D8XL16,A0A016WPN3,Q9QZ81,G5EES3,A0A0K0EFP6,Q8CJG0,A0A1D5NTU6,V2WTL2,A0A0V0YLH8,A0A139WDH0,A0A0R3W9Q7,H3DS31,A0A1Y1HWP2,G4T5G9,B7QCC4,A0A0B2UV00,M7BCJ9,E9GN30,Q7PZ41,A0A077Z361,R7U9I3,A0A1X7V1N5,A0A0K0JDP1,A0A0N4UKJ1,A0A498N3A3,A0A3M0IQP5,A0A0L8GBV4,Q32KD4,A0A1J1JBJ0,E0W4C3,A0A482XDA9,A0A3P7EJD6,J9K2Z4,A0A2J7Q8V4,T1IBM6,V3ZRX0,A0A210QKF7,A0A423TSS1,K1PT78,A0A267E8R7,A0A1D2N447,A0A226D7A9,F6YK55,T1KTE4,A0A2C9JGZ6,A0A1V9X9F0,K5X5Z7,A0A3Q0KUG5,T1FY40,1YVU,3DLB,5AWH,5G5T,7R8K,E0ST67,C4L1M1,A0A1I3LMA1,A0A326U7G5,A0A1T4Y3A2,A0A0B0H9B4,R6KUL9,B7GJX9,A0A1N6SSK9,A0A2G9DT08,Q9L1X1,A0A060HNJ0,A0A235B542,R5XQK4,A0A1H3LE92,A0A496APJ8,A0A062U2W9,H0HWQ5,A0A1V9G9U4,A0A1I2ZGP1,A0A317EJY3,S7VLM7,A0A1A5X8H4,A0A1I2T6Q1,A0A1R3T9N6,H8KXJ0,A0A2D1U4H7,A0A0B7I4Z6,A0LL61,A0A139WY18,A0A1J1EK56,A0A2T1E1K4,A0A1Q8ZD62,A0A4Q6XKV6,A0A1Z3HNN4,A0A239JE83,A0A2N4XBY2,Q53W94,R5JEI2,A0A0Q0ZC47,A0A2T0XH18,A0A1V4CHV0,A0A1K1RQP7,A0A1N6LUI7,A0A0P0NGR6,A0A1X7IML5,A0A0A2LKJ7,K1L112,A0A0U3AL92,A0A1H3A054,B9LVW4,A0A0C5JKF3,R5NJJ8,A5D4D9,A0A142Y7A9,A0A432MEQ5,A0A372DKU2,C1F5Q7,A0A4R3EV39,A0A1P8WP90,A0A222F7P0,A0A1C9VH88,A0A2T2YMB1,A0A101R2A0,A0A1E3XF49,A0A1U9ND56,A0A4R7BQC4,E0TGY3,A0A259TUP4,F6EYI8,A0A2S9Q9J0,A0A4Q2UIU6,A0A1H0LH25,A0A318LG42,H1YCU5,A0A1Q5ZS75,M0AF24,A0A1W2A082,A0A1H3X247,A0A0C1XUA0,M0D2X3,A0A2R5G167,A0A346PK63,R7RTW6,A0A1H2RBI2,A0A1C3ZXN2,B9LVP8,M5RSF0,W0JW77,B7K585,F8D8G0,A0A343TL88,L0AJX6,A0A2A5QS34,A0A343JEE2,A0A3P3RGE5,A0A329TBQ3,A0A285N2A8,A0A0W1S8B8,L9VRQ2,E4NRV1,A0A1I6HGN0,A0A1I0NI68,,",366,37
"731","N.S13.3","N.S19.1",284,169,115,2.08224852071006,"4F1N,4F3T,4KRE,5GUH,5VM9,6KR6,6OON,7KX7,7SWF,A0A163JTZ6,A0A0N4X8S8,A0A196SDB4,J9D5G4,C4LVV2,A0A2P6N8X7,A8BCK6,A2DPV7,A0A0G4H2S4,T1H8B3,S4RWI0,D2VMG4,A0A074TLL7,Q1K660,F4PH46,A0A3M7S814,A0A164ZA52,A0A383WDW5,Q54G64,S7WCF7,I0YVB2,R7QGN7,C1DZY0,A0A2C5Z0M1,A0CB11,R9ACY5,D3BMP8,A0A1Z5TVE5,W7XD45,A0A1U7LLR0,A0A4S2MWZ7,G7DVX0,V6R0U9,G4N9J3,E3KLI3,A0A139AUH8,L2GMR6,U4LBG4,A0A177URI1,O74957,A0A3N4IGK1,A6N7Y9,A0A0E9NDK5,T1KZ60,A0A250WXN5,A0A2G8JLH3,Q5KAT1,L2GUF2,W2T741,A0A1W0E4B5,A0A2J7QB22,A0A2K3CW87,A0A388KES6,A0A226EFL3,A0A3S3PD82,A0A0L0TEV1,A0A1S3J512,G0QTT2,A0A1J1HRI1,C4V9J2,Q9JMB7,A0A075AN09,Q5TW24,U5HIG6,A0A401PRI6,Q96J94,A0A2B4RHN2,G2QEV0,A0A397UU01,A0A2T7PFL8,K7ISV0,A0A024FT57,H3HCL6,A0A0G4IME3,E9FUN9,D7FQK3,A0A1Y1YHC8,T1GSU4,A0A1D8PMK0,A0A2G5B1D8,Q5BD61,A0A1C7M8P2,A0A4D8YSQ3,A0A158PJG6,J9JZ66,A0A0C2XG51,A0A158QZT6,A0A165QYQ9,T0SAU8,R7YY92,A0A3S1A0C3,A0A2K1J482,A0A1Q3ENA6,O04379,A0A371I3C8,M8AEW7,A8P0D4,A0A2K3NY65,F4NYW7,A0A0L0HAB7,D8PZT7,A0A1D1W4K0,A7RQ46,W4YU94,A7BJS5,D8SNM6,A0A1J8PPA3,X1WG39,M5FQK2,Q69VD5,A0A2R6NSC2,A0A0D8XL16,A0A016WPN3,Q9QZ81,G5EES3,A0A0K0EFP6,Q8CJG0,A0A1D5NTU6,V2WTL2,A0A0V0YLH8,A0A139WDH0,A0A0R3W9Q7,H3DS31,A0A1Y1HWP2,G4T5G9,B7QCC4,A0A0B2UV00,M7BCJ9,E9GN30,Q7PZ41,A0A077Z361,R7U9I3,A0A1X7V1N5,A0A0K0JDP1,A0A0N4UKJ1,A0A498N3A3,A0A3M0IQP5,A0A0L8GBV4,Q32KD4,A0A1J1JBJ0,E0W4C3,A0A482XDA9,A0A3P7EJD6,J9K2Z4,A0A2J7Q8V4,T1IBM6,V3ZRX0,A0A210QKF7,A0A423TSS1,K1PT78,A0A267E8R7,A0A1D2N447,A0A226D7A9,F6YK55,T1KTE4,A0A2C9JGZ6,A0A1V9X9F0,K5X5Z7,A0A3Q0KUG5,T1FY40,1Z26,3DLB,5AWH,5G5T,5I4A,7R8K,C4L1M1,A0A1I3LMA1,B1XJG0,A0A1T4Y3A2,A0A0B0H9B4,R6KUL9,B7GJX9,A0A1N6SSK9,A0A2G9DT08,Q9L1X1,A0A060HNJ0,A0A235B542,R5XQK4,A0A1H3LE92,A0A496APJ8,A0A062U2W9,H0HWQ5,A0A1V9G9U4,A0A1I2ZGP1,A0A317EJY3,A0A1I2BD20,F8ERC7,S7VLM7,A0A1A5X8H4,A0A1I2T6Q1,A0A1R3T9N6,A0A0Q2M2Z1,H8KXJ0,A0A2D1U4H7,A0A0B7I4Z6,A0LL61,Q8DKB1,A0A139WY18,A0A1J1EK56,A0A2T1E1K4,A0A1Q8ZD62,A0A4Q6XKV6,A0A1Z3HNN4,A0A239JE83,A0A2N4XBY2,Q53W94,R5JEI2,A0A0Q0ZC47,A0A2T0XH18,A0A1V4CHV0,A0A1K1RQP7,A0A2T1EKT1,A0A1N6LUI7,A0A0P0NGR6,A0A1X7IML5,A0A0A2LKJ7,K1L112,A0A0U3AL92,A0A1H3A054,E0UCX3,K9XZC6,A0A0C1VHB4,Q31N05,A0A0C5JKF3,R5NJJ8,A5D4D9,Q2JI93,A0A142Y7A9,A0A432MEQ5,A0A372DKU2,A0A4R3EV39,A0A1P8WP90,A0A222F7P0,A0A1C9VH88,A0A2T2YMB1,A0A101R2A0,A0A1E3XF49,A0A1U9ND56,A0A4R7BQC4,E0TGY3,A0A259TUP4,F6EYI8,A0A2S9Q9J0,A0A4Q2UIU6,A0A1H0LH25,A0A318LG42,H1YCU5,A0A1Q5ZS75,M0AF24,A0A1W2A082,A0A1H3X247,A0A2R5G167,A0A346PK63,R7RTW6,A0A1H2RBI2,A0A1C3ZXN2,B9LVP8,M5RSF0,W0JW77,B7K585,F8D8G0,A0A343TL88,L0AJX6,A0A2A5QS34,A0A343JEE2,A0A3P3RGE5,A0A329TBQ3,A0A285N2A8,A0A0W1S8B8,A0A1V4C8L7,L9VRQ2,E4NRV1,A0A1I6HGN0,A0A1I0NI68,,",366,37
"733","N.S14.4","N.S14.6",306,169,137,1.81091003325703,"4F3T,4KRE,5GUH,6KR6,6OON,7SWF,A0A196SDB4,J9D5G4,Q389P5,C4LVV2,A0A2P6N8X7,A8BCK6,A2DPV7,A0A0G4H2S4,T1H8B3,S4RWI0,D2VMG4,A0A074TLL7,Q1K660,F4PH46,A0A3M7S814,A0A383WDW5,Q54G64,S7WCF7,I0YVB2,R7QGN7,C1DZY0,A0A2C5Z0M1,A0CB11,R9ACY5,D3BMP8,W7XD45,A0A1U7LLR0,A0A4S2MWZ7,K1VVQ6,A0A158P1R9,V6R0U9,G4N9J3,E3KLI3,B7Q5I1,A0A1E3QC61,D5GGK8,S8ANP9,A0A139AUH8,L2GMR6,U4LBG4,A0A177URI1,O74957,A0A3N4IGK1,A6N7Y9,A0A0E9NDK5,T1KZ60,A0A250WXN5,A0A2G8JLH3,Q5KAT1,L2GUF2,W2T741,A0A1W0E4B5,A0A2J7QB22,S4RYE2,A0A2K3CW87,A0A388KES6,A0A226EFL3,A0A3S3PD82,A0A0L0TEV1,A0A1S3J512,G0QTT2,A0A1J1HRI1,C4V9J2,Q9JMB7,A0A075AN09,Q5TW24,U5HIG6,A0A401PRI6,Q96J94,A0A2B4RHN2,G2QEV0,A0A397UU01,A0A2T7PFL8,K7ISV0,A0A024FT57,H3HCL6,A0A0G4IME3,E9FUN9,A0A1S3CYL5,D7FQK3,T1GSU4,F4S231,A0A1D8PMK0,A0A2G5B1D8,Q5BD61,A0A1C7M8P2,A0A4D8YSQ3,A0A158PJG6,J9JZ66,A0A0C2XG51,A0A158QZT6,T0SAU8,R7YY92,A0A3S1A0C3,A0A074YJ47,A0A2K1J482,O04379,A0A371I3C8,M8AEW7,A8P0D4,A0A2K3NY65,F4NYW7,A0A409Y6G2,A0A0L0HAB7,D8PZT7,A0A1D1W4K0,A7RQ46,W4YU94,A7BJS5,D8SNM6,X1WG39,M5FQK2,Q69VD5,A0A2R6NSC2,A0A0D8XL16,A0A016WPN3,Q9QZ81,G5EES3,A0A0K0EFP6,Q8CJG0,A0A1D5NTU6,V2WTL2,A0A0V0YLH8,A0A139WDH0,A0A0R3W9Q7,H3DS31,A0A1Y1HWP2,G4T5G9,B7QCC4,A0A0B2UV00,M7BCJ9,E9GN30,Q7PZ41,A0A077Z361,R7U9I3,A0A1X7V1N5,A0A0K0JDP1,A0A0N4UKJ1,A0A498N3A3,A0A3M0IQP5,A0A0L8GBV4,Q32KD4,A0A1J1JBJ0,E0W4C3,A0A482XDA9,A0A3P7EJD6,J9K2Z4,A0A2J7Q8V4,T1IBM6,V3ZRX0,A0A210QKF7,A0A423TSS1,K1PT78,A0A267E8R7,A0A1D2N447,A0A226D7A9,F6YK55,T1KTE4,A0A2C9JGZ6,A0A1V9X9F0,K5X5Z7,A0A3Q0KUG5,T1FY40,3DLB,5I4A,E8N0K8,A0A1I7IXT4,A0A2W1JZ37,A0A2S7WBN3,A0A328VKE4,A0A420DFE6,E0ST67,A0A4V1VDY2,A0A368P5I0,C4L1M1,Q11QW7,A0A0M2PXX3,A0A1I3LMA1,K9TPA9,A0A1W6MIP2,A0A1C0UUC4,A0A2Z6E1D5,A0A0F4NXW8,L8D0R3,A0A326U7G5,H1KXR6,A0A1Q4R485,K9U8J6,A0A097QRL6,K9RC91,A0A0D8ZUC0,A0A139XGN8,A0A1T4Y3A2,Q5P0R2,B6YTQ5,A0A0B0H9B4,A0YYT3,A0A2T1EFY0,G6FTN0,R6KUL9,A0A433NB65,A0A1Z4L0A1,K9UQR0,A0A2T1G8M7,K9VUN0,B7GJX9,K9ZDE3,B0JXD6,A0A2T1LS63,A0A1Z4K1Y3,A0A2Z6E0R7,A0A1N6SSK9,A0A0P4UVI8,A0A0V7ZCG4,A0A1J0AGK2,K9PFF9,A0A2G9DT08,K9UEV4,Q9L1X1,A0A060HNJ0,A0A235B542,R5XQK4,A0A1H3LE92,A0A496APJ8,A0A062U2W9,H0HWQ5,A0A1V9G9U4,F8ERC7,S7VLM7,A0A1A5X8H4,A0A1I2T6Q1,A0A1R3T9N6,H8KXJ0,A0A2D1U4H7,A0A0B7I4Z6,A0LL61,A0A139WY18,A0A1J1EK56,A0A2T1E1K4,A0A1Q8ZD62,A0A4Q6XKV6,A0A1Z3HNN4,A0A239JE83,A0A2N4XBY2,Q53W94,R5JEI2,A0A1V4CHV0,A0A0P0NGR6,A0A1X7IML5,A0A0U3AL92,A0A1H3A054,A0A0C1VHB4,A0A0C5JKF3,R5NJJ8,A5D4D9,Q2JI93,A0A142Y7A9,A0A432MEQ5,A0A372DKU2,A0A3R7KLK4,A0A4R3EV39,A0A1P8WP90,A0A222F7P0,A0A1C9VH88,A0A2T2YMB1,A0A101R2A0,A0A1E3XF49,A0A1U9ND56,A0A4R7BQC4,A0A1H3DGN3,A0A259TUP4,F6EYI8,A0A2S9Q9J0,A0A4Q2UIU6,A0A1H0LH25,A0A318LG42,H1YCU5,L0JS08,A0A1Q5ZS75,M0AF24,A0A0C1XUA0,M0D2X3,A0A346PK63,R7RTW6,A0A1H2RBI2,A0A1C3ZXN2,M5RSF0,F8D8G0,A0A343TL88,L0AJX6,A0A2A5QS34,A0A343JEE2,A0A3P3RGE5,A0A329TBQ3,A0A0W1S8B8,A0A1V4C8L7,L9VRQ2,E4NRV1,A0A1I6HGN0,A0A1I0NI68,,",366,37
"734","N.S2.4","N.S20.1",270,169,101,2.22411974925303,"4F3T,4KRE,6KR6,6OON,7SWF,Q389P5,C4LVV2,A2DPV7,A0A0G4H2S4,T1H8B3,R1FDF0,S4RWI0,D2VMG4,A0A074TLL7,A0A0D1ZAJ4,Q1K660,F4PH46,A0A164ZA52,A0A383WDW5,Q54G64,S7WCF7,R7QGN7,C1DZY0,A0A2C5Z0M1,A0CB11,R9ACY5,D3BMP8,A0A1Z5TVE5,W7XD45,A0A1U7LLR0,A0A4S2MWZ7,K1VVQ6,A0A158P1R9,G7DVX0,V6R0U9,G4N9J3,E3KLI3,B7Q5I1,A0A1E3QC61,D5GGK8,S8ANP9,A0A139AUH8,L2GMR6,U4LBG4,O74957,A0A3N4IGK1,A6N7Y9,A0A0E9NDK5,T1KZ60,A0A250WXN5,A0A2G8JLH3,Q5KAT1,L2GUF2,A0A1W0E4B5,A0A2J7QB22,S4RYE2,A0A2K3CW87,A0A388KES6,A0A226EFL3,A0A3S3PD82,A0A0L0TEV1,A0A1S3J512,G0QTT2,A0A1J1HRI1,C4V9J2,Q9JMB7,A0A075AN09,Q5TW24,U5HIG6,A0A401PRI6,Q96J94,A0A2B4RHN2,G2QEV0,A0A397UU01,A0A2T7PFL8,K7ISV0,A0A024FT57,H3HCL6,A0A0G4IME3,E9FUN9,A0A1S3CYL5,D7FQK3,A0A1Y1YHC8,T1GSU4,F4S231,A0A1D8PMK0,A0A2G5B1D8,Q5BD61,A0A1C7M8P2,A0A4D8YSQ3,A0A158PJG6,J9JZ66,A0A0C2XG51,A0A158QZT6,A0A165QYQ9,T0SAU8,R7YY92,A0A3S1A0C3,A0A074YJ47,A0A2K1J482,A0A1Q3ENA6,O04379,A0A371I3C8,M8AEW7,A8P0D4,A0A2K3NY65,F4NYW7,A0A409Y6G2,A0A0L0HAB7,D8PZT7,A0A1D1W4K0,A7RQ46,W4YU94,A7BJS5,D8SNM6,A0A1J8PPA3,X1WG39,M5FQK2,Q69VD5,A0A2R6NSC2,A0A0D8XL16,A0A016WPN3,Q9QZ81,G5EES3,A0A0K0EFP6,Q8CJG0,A0A1D5NTU6,V2WTL2,A0A0V0YLH8,A0A139WDH0,A0A0R3W9Q7,H3DS31,A0A1Y1HWP2,G4T5G9,B7QCC4,A0A0B2UV00,M7BCJ9,E9GN30,Q7PZ41,A0A077Z361,R7U9I3,A0A1X7V1N5,A0A0K0JDP1,A0A0N4UKJ1,A0A498N3A3,A0A3M0IQP5,A0A0L8GBV4,Q32KD4,A0A1J1JBJ0,E0W4C3,A0A482XDA9,A0A3P7EJD6,J9K2Z4,A0A2J7Q8V4,T1IBM6,V3ZRX0,A0A210QKF7,A0A423TSS1,K1PT78,A0A267E8R7,A0A1D2N447,A0A226D7A9,F6YK55,T1KTE4,A0A2C9JGZ6,A0A1V9X9F0,K5X5Z7,A0A3Q0KUG5,T1FY40,1YVU,1Z26,5G5T,5I4A,6QZK,K9U8J6,K9RC91,A0A0D8ZUC0,A0A139XGN8,A0YYT3,A0A2T1EFY0,G6FTN0,A0A433NB65,A0A1Z4L0A1,K9UQR0,A0A2T1G8M7,K9VUN0,K9ZDE3,B0JXD6,A0A2T1LS63,A0A1Z4K1Y3,A0A0P4UVI8,A0A0V7ZCG4,A0A1J0AGK2,K9PFF9,K9UEV4,H0HWQ5,A0A317EJY3,A0A1I2BD20,F8ERC7,S7VLM7,A0A0Q2M2Z1,H8KXJ0,A0A2D1U4H7,A0A0B7I4Z6,A0LL61,A0A4Q6XKV6,A0A239JE83,A0A2N4XBY2,R5JEI2,A0A0Q0ZC47,A0A2T0XH18,A0A1V4CHV0,A0A1K1RQP7,A0A1N6LUI7,A0A0P0NGR6,A0A1X7IML5,A0A0A2LKJ7,K1L112,A0A0U3AL92,A0A1H3A054,E0UCX3,A0A0C5JKF3,R5NJJ8,A5D4D9,A0A142Y7A9,A0A372DKU2,C1F5Q7,A0A4R3EV39,A0A1P8WP90,A0A222F7P0,A0A1C9VH88,A0A2T2YMB1,A0A329TD61,A0A101R2A0,A0A1E3XF49,A0A1U9ND56,A0A4R7BQC4,A0A1Q1FPH0,E0TGY3,A0A259TUP4,F6EYI8,A0A2S9Q9J0,A0A4Q2UIU6,A0A1H0LH25,A0A318LG42,H1YCU5,L0JS08,A0A1Q5ZS75,A0A345E7N0,M0AF24,A0A1H3X247,A0A0C1XUA0,M0D2X3,A0A346PK63,R7RTW6,A0A1C3ZXN2,B9LVP8,M5RSF0,B7K585,F8D8G0,A0A343TL88,A0A343JEE2,A0A3P3RGE5,A0A329TBQ3,A0A0W1S8B8,A0A1V4C8L7,L9VRQ2,E4NRV1,A0A1I6HGN0,A0A1I0NI68,,",366,37
"735","N.S3.4","N.S5.2",262,169,93,2.25736463701724,"4F1N,4F3T,4KRE,5GUH,5VM9,6OON,7KX7,7SWF,A0A0N4X8S8,A0A196SDB4,Q389P5,A0A2P6N8X7,A2DPV7,T1H8B3,S4RWI0,D2VMG4,A0A0D1ZAJ4,Q1K660,F4PH46,A0A164ZA52,A0A383WDW5,Q54G64,S7WCF7,I0YVB2,R7QGN7,C1DZY0,A0A2C5Z0M1,R9ACY5,D3BMP8,A0A1Z5TVE5,W7XD45,A0A1U7LLR0,A0A4S2MWZ7,K1VVQ6,A0A158P1R9,G7DVX0,V6R0U9,G4N9J3,E3KLI3,B7Q5I1,A0A1E3QC61,D5GGK8,S8ANP9,A0A139AUH8,L2GMR6,U4LBG4,A0A177URI1,O74957,A0A3N4IGK1,A6N7Y9,A0A0E9NDK5,A0A250WXN5,A0A2G8JLH3,Q5KAT1,L2GUF2,A0A1W0E4B5,A0A2J7QB22,S4RYE2,A0A2K3CW87,A0A388KES6,A0A226EFL3,A0A3S3PD82,A0A0L0TEV1,A0A1S3J512,G0QTT2,A0A1J1HRI1,C4V9J2,Q9JMB7,A0A075AN09,Q5TW24,U5HIG6,A0A401PRI6,Q96J94,A0A2B4RHN2,G2QEV0,A0A397UU01,A0A2T7PFL8,K7ISV0,A0A024FT57,A0A0G4IME3,E9FUN9,A0A1S3CYL5,D7FQK3,A0A1Y1YHC8,T1GSU4,F4S231,A0A1D8PMK0,A0A2G5B1D8,Q5BD61,A0A4D8YSQ3,A0A158PJG6,J9JZ66,A0A0C2XG51,A0A158QZT6,A0A165QYQ9,T0SAU8,R7YY92,A0A3S1A0C3,A0A074YJ47,A0A2K1J482,A0A1Q3ENA6,O04379,A0A371I3C8,M8AEW7,A8P0D4,A0A2K3NY65,F4NYW7,A0A409Y6G2,A0A0L0HAB7,D8PZT7,A0A1D1W4K0,A7RQ46,W4YU94,A7BJS5,D8SNM6,A0A1J8PPA3,X1WG39,M5FQK2,Q69VD5,A0A2R6NSC2,A0A0D8XL16,A0A016WPN3,Q9QZ81,G5EES3,A0A0K0EFP6,Q8CJG0,A0A1D5NTU6,V2WTL2,A0A0V0YLH8,A0A139WDH0,A0A0R3W9Q7,H3DS31,A0A1Y1HWP2,G4T5G9,B7QCC4,A0A0B2UV00,M7BCJ9,E9GN30,Q7PZ41,A0A077Z361,R7U9I3,A0A1X7V1N5,A0A0K0JDP1,A0A0N4UKJ1,A0A498N3A3,A0A3M0IQP5,A0A0L8GBV4,Q32KD4,A0A1J1JBJ0,E0W4C3,A0A482XDA9,A0A3P7EJD6,J9K2Z4,A0A2J7Q8V4,T1IBM6,V3ZRX0,A0A210QKF7,A0A423TSS1,K1PT78,A0A267E8R7,A0A1D2N447,A0A226D7A9,F6YK55,T1KTE4,A0A2C9JGZ6,A0A1V9X9F0,K5X5Z7,A0A3Q0KUG5,T1FY40,1Z26,3DLB,5AWH,5G5T,5I4A,6QZK,7R8K,R6KUL9,B7GJX9,A0A1N6SSK9,A0A235B542,R5XQK4,S7VLM7,A0A0Q2M2Z1,H8KXJ0,D3S0S6,A0A2D1U4H7,I3TE64,A0A0B7I4Z6,A0LL61,Q8DKB1,A0A1J1EK56,A0A4Q6XKV6,A0A239JE83,A0A2N4XBY2,Q53W94,R5JEI2,A0A0Q0ZC47,A0A2T0XH18,A0A1V4CHV0,A0A1K1RQP7,A0A2T1EKT1,A0A1N6LUI7,A0A0P0NGR6,A0A1X7IML5,A0A0A2LKJ7,K1L112,A0A0U3AL92,A0A1H3A054,E0UCX3,K9XZC6,B9LVW4,A0A0C1VHB4,Q31N05,A0A0C5JKF3,R5NJJ8,A5D4D9,Q2JI93,A0A142Y7A9,A0A372DKU2,C1F5Q7,A0A4R3EV39,A0A1P8WP90,A0A222F7P0,A0A1C9VH88,A0A2T2YMB1,A0A329TD61,A0A101R2A0,A0A1U9ND56,A0A4R7BQC4,A0A1Q1FPH0,E0TGY3,A0A259TUP4,F6EYI8,A0A2S9Q9J0,A0A4Q2UIU6,A0A1H0LH25,A0A318LG42,L0JS08,A0A345E7N0,M0AF24,M0D2X3,A0A2R5G167,A0A346PK63,R7RTW6,B9LVP8,M5RSF0,W0JW77,B7K585,F8D8G0,A0A343TL88,L0AJX6,A0A2A5QS34,A0A343JEE2,A0A3P3RGE5,A0A329TBQ3,A0A285N2A8,A0A0W1S8B8,A0A1V4C8L7,L9VRQ2,E4NRV1,A0A1I6HGN0,A0A1I0NI68,,",366,37
"738","C.H10.11","C.H10.14",250,170,80,1.98419117647059,"4F1N,4F3T,4KRE,5GUH,6KR6,6OON,7KX7,7SWF,A0A163JTZ6,J9D5G4,A0A2P6N8X7,A2DPV7,A0A0G4H2S4,D2VMG4,A0A074TLL7,A0A0D1ZAJ4,Q1K660,A0A3M7S814,A0A164ZA52,S7WCF7,I0YVB2,R7QGN7,C1DZY0,A0A2C5Z0M1,R9ACY5,D3BMP8,A0A1Z5TVE5,W7XD45,A0A1U7LLR0,A0A4S2MWZ7,K1VVQ6,A0A158P1R9,G7DVX0,V6R0U9,G4N9J3,E3KLI3,B7Q5I1,A0A1E3QC61,D5GGK8,S8ANP9,A0A139AUH8,L2GMR6,U4LBG4,A0A177URI1,O74957,A0A3N4IGK1,A6N7Y9,A0A0E9NDK5,T1KZ60,A0A250WXN5,A0A2G8JLH3,Q5KAT1,L2GUF2,W2T741,A0A1W0E4B5,A0A2J7QB22,S4RYE2,A0A2K3CW87,A0A388KES6,A0A226EFL3,A0A3S3PD82,A0A0L0TEV1,A0A1S3J512,G0QTT2,A0A1J1HRI1,C4V9J2,Q9JMB7,A0A075AN09,Q5TW24,U5HIG6,A0A401PRI6,Q96J94,A0A2B4RHN2,G2QEV0,A0A397UU01,A0A2T7PFL8,K7ISV0,A0A024FT57,H3HCL6,A0A0G4IME3,E9FUN9,A0A1S3CYL5,D7FQK3,A0A1Y1YHC8,T1GSU4,F4S231,A0A1D8PMK0,A0A2G5B1D8,Q5BD61,A0A1C7M8P2,A0A4D8YSQ3,A0A158PJG6,J9JZ66,A0A0C2XG51,A0A158QZT6,A0A165QYQ9,T0SAU8,R7YY92,A0A3S1A0C3,A0A074YJ47,A0A2K1J482,A0A1Q3ENA6,O04379,A0A371I3C8,M8AEW7,A8P0D4,A0A2K3NY65,F4NYW7,A0A409Y6G2,A0A0L0HAB7,D8PZT7,A0A1D1W4K0,A7RQ46,W4YU94,A7BJS5,D8SNM6,A0A1J8PPA3,X1WG39,M5FQK2,Q69VD5,A0A2R6NSC2,A0A0D8XL16,A0A016WPN3,Q9QZ81,G5EES3,A0A0K0EFP6,Q8CJG0,A0A1D5NTU6,V2WTL2,A0A0V0YLH8,A0A139WDH0,A0A0R3W9Q7,H3DS31,A0A1Y1HWP2,G4T5G9,B7QCC4,A0A0B2UV00,M7BCJ9,E9GN30,Q7PZ41,A0A077Z361,R7U9I3,A0A1X7V1N5,A0A0K0JDP1,A0A0N4UKJ1,A0A498N3A3,A0A3M0IQP5,A0A0L8GBV4,Q32KD4,A0A1J1JBJ0,E0W4C3,A0A482XDA9,A0A3P7EJD6,J9K2Z4,A0A2J7Q8V4,T1IBM6,V3ZRX0,A0A210QKF7,A0A423TSS1,K1PT78,A0A267E8R7,A0A1D2N447,A0A226D7A9,F6YK55,T1KTE4,A0A2C9JGZ6,A0A1V9X9F0,K5X5Z7,A0A3Q0KUG5,T1FY40,1YVU,5G5T,6QZK,E0ST67,C4L1M1,Q11QW7,A0A1M5ZSR3,A0A0K8QX04,B1XJG0,H1KXR6,A0A1T4Y3A2,B6YTQ5,A0A0B0H9B4,R6KUL9,B7GJX9,A0A1N6SSK9,A0A2G9DT08,Q9L1X1,A0A060HNJ0,A0A235B542,A0A496APJ8,A0A1V9G9U4,A0A1A5X8H4,A0A1I2T6Q1,A0A0Q2M2Z1,H8KXJ0,A0A2D1U4H7,I3TE64,A0A0B7I4Z6,A0A139WY18,A0A1J1EK56,A0A2T1E1K4,A0A1Q8ZD62,A0A4Q6XKV6,A0A1Z3HNN4,A0A239JE83,A0A2N4XBY2,Q53W94,R5JEI2,A0A2T0XH18,A0A1V4CHV0,A0A1K1RQP7,A0A1N6LUI7,A0A0P0NGR6,A0A1X7IML5,A0A0A2LKJ7,K1L112,A0A0U3AL92,E0UCX3,K9XZC6,A0A0C1VHB4,A5D4D9,A0A142Y7A9,A0A432MEQ5,C1F5Q7,A0A1P8WP90,A0A2T2YMB1,A0A101R2A0,A0A1U9ND56,A0A4R7BQC4,A0A259TUP4,A0A4Q2UIU6,A0A1H0LH25,A0A318LG42,A0A2R5G167,A0A346PK63,M5RSF0,W0JW77,B7K585,F8D8G0,A0A343TL88,L0AJX6,A0A3P3RGE5,A0A329TBQ3,A0A285N2A8,A0A0W1S8B8,A0A1V4C8L7,L9VRQ2,E4NRV1,A0A1I6HGN0,,",366,37
"739","C.L20.6","C.L23.10",280,170,110,7.4048128342246,"4F1N,4KRE,5VM9,6KR6,6OON,7SWF,A0A163JTZ6,A0A0N4X8S8,A0A196SDB4,J9D5G4,A0A2P6N8X7,A0A0G4H2S4,R1FDF0,D2VMG4,A0A074TLL7,A0A0D1ZAJ4,Q1K660,F4PH46,A0A3M7S814,A0A164ZA52,A0A383WDW5,Q54G64,S7WCF7,I0YVB2,R7QGN7,C1DZY0,A0A2C5Z0M1,A0CB11,R9ACY5,D3BMP8,A0A1Z5TVE5,W7XD45,A0A1U7LLR0,A0A4S2MWZ7,A0A158P1R9,G7DVX0,V6R0U9,G4N9J3,B7Q5I1,A0A1E3QC61,D5GGK8,A0A139AUH8,L2GMR6,U4LBG4,A0A177URI1,O74957,A0A3N4IGK1,A6N7Y9,A0A0E9NDK5,T1KZ60,A0A250WXN5,A0A2G8JLH3,Q5KAT1,L2GUF2,W2T741,A0A2J7QB22,S4RYE2,A0A2K3CW87,A0A388KES6,A0A226EFL3,A0A3S3PD82,A0A0L0TEV1,A0A1S3J512,G0QTT2,A0A1J1HRI1,C4V9J2,Q9JMB7,A0A075AN09,Q5TW24,U5HIG6,A0A401PRI6,Q96J94,A0A2B4RHN2,G2QEV0,A0A397UU01,A0A2T7PFL8,K7ISV0,A0A024FT57,H3HCL6,A0A0G4IME3,E9FUN9,A0A1S3CYL5,D7FQK3,A0A1Y1YHC8,T1GSU4,F4S231,A0A1D8PMK0,A0A2G5B1D8,Q5BD61,A0A1C7M8P2,A0A4D8YSQ3,A0A158PJG6,J9JZ66,A0A0C2XG51,A0A158QZT6,A0A165QYQ9,T0SAU8,R7YY92,A0A3S1A0C3,A0A074YJ47,A0A2K1J482,A0A1Q3ENA6,O04379,A0A371I3C8,M8AEW7,A8P0D4,A0A2K3NY65,F4NYW7,A0A409Y6G2,A0A0L0HAB7,D8PZT7,A0A1D1W4K0,A7RQ46,W4YU94,A7BJS5,D8SNM6,A0A1J8PPA3,X1WG39,M5FQK2,Q69VD5,A0A2R6NSC2,A0A0D8XL16,A0A016WPN3,Q9QZ81,G5EES3,A0A0K0EFP6,Q8CJG0,A0A1D5NTU6,V2WTL2,A0A0V0YLH8,A0A139WDH0,A0A0R3W9Q7,H3DS31,A0A1Y1HWP2,G4T5G9,B7QCC4,A0A0B2UV00,M7BCJ9,E9GN30,Q7PZ41,A0A077Z361,R7U9I3,A0A1X7V1N5,A0A0K0JDP1,A0A0N4UKJ1,A0A498N3A3,A0A3M0IQP5,A0A0L8GBV4,Q32KD4,A0A1J1JBJ0,E0W4C3,A0A482XDA9,A0A3P7EJD6,J9K2Z4,A0A2J7Q8V4,T1IBM6,V3ZRX0,A0A210QKF7,A0A423TSS1,K1PT78,A0A267E8R7,A0A1D2N447,A0A226D7A9,F6YK55,T1KTE4,A0A2C9JGZ6,A0A1V9X9F0,K5X5Z7,A0A3Q0KUG5,T1FY40,1Z26,3DLB,6QZK,A0A328VKE4,E0ST67,C4L1M1,K9TPA9,A0A1C0UUC4,A0A2Z6E1D5,A0A142XB92,B1XJG0,A0A326U7G5,H1KXR6,A0A1Q4R485,K9U8J6,A0A097QRL6,K9RC91,A0A0D8ZUC0,A0A139XGN8,A0A1T4Y3A2,A0A0B0H9B4,A0YYT3,G6FTN0,R6KUL9,A0A433NB65,A0A1Z4L0A1,K9UQR0,A0A2T1G8M7,K9VUN0,B7GJX9,B0JXD6,A0A2T1LS63,A0A1Z4K1Y3,A0A1N6SSK9,A0A0P4UVI8,A0A0V7ZCG4,K9PFF9,K9UEV4,A0A060HNJ0,A0A235B542,R5XQK4,A0A1H3LE92,A0A496APJ8,H0HWQ5,A0A1V9G9U4,F8ERC7,S7VLM7,I3TE64,A0A0B7I4Z6,A0LL61,Q8DKB1,A0A139WY18,A0A1J1EK56,A0A2T1E1K4,A0A1Q8ZD62,A0A4Q6XKV6,A0A1Z3HNN4,A0A239JE83,A0A2N4XBY2,Q53W94,R5JEI2,A0A0Q0ZC47,A0A1V4CHV0,A0A1N6LUI7,A0A1X7IML5,E0UCX3,K9XZC6,A0A0C1VHB4,Q31N05,A0A0C5JKF3,A5D4D9,Q2JI93,A0A432MEQ5,A0A372DKU2,A0A3R7KLK4,C1F5Q7,A0A4R3EV39,A0A1P8WP90,A0A222F7P0,A0A1C9VH88,A0A329TD61,A0A1U9ND56,A0A4R7BQC4,A0A1H3DGN3,A0A1Q1FPH0,A0A259TUP4,A0A4Q2UIU6,A0A1H0LH25,A0A318LG42,L0JS08,A0A345E7N0,M0AF24,A0A1H3X247,M0D2X3,A0A346PK63,B9LVP8,W0JW77,F8D8G0,A0A343TL88,L0AJX6,A0A343JEE2,A0A3P3RGE5,A0A329TBQ3,A0A285N2A8,A0A0W1S8B8,A0A1V4C8L7,L9VRQ2,E4NRV1,A0A1I6HGN0,A0A1I0NI68,,",366,37
"746","N.H8.13","N.H8.9",305,170,135,2.50239651416122,"4F1N,4F3T,4KRE,5GUH,5VM9,6KR6,6OON,7KX7,A0A163JTZ6,J9D5G4,Q389P5,C4LVV2,A2DPV7,A0A0G4H2S4,T1H8B3,R1FDF0,S4RWI0,A0A074TLL7,A0A0D1ZAJ4,Q1K660,F4PH46,A0A3M7S814,A0A164ZA52,Q54G64,S7WCF7,I0YVB2,R7QGN7,C1DZY0,A0A2C5Z0M1,A0CB11,R9ACY5,D3BMP8,A0A1Z5TVE5,W7XD45,A0A1U7LLR0,A0A4S2MWZ7,K1VVQ6,A0A158P1R9,V6R0U9,G4N9J3,E3KLI3,B7Q5I1,A0A1E3QC61,D5GGK8,S8ANP9,A0A139AUH8,L2GMR6,U4LBG4,A0A177URI1,O74957,A0A3N4IGK1,A0A0E9NDK5,T1KZ60,A0A250WXN5,A0A2G8JLH3,Q5KAT1,L2GUF2,W2T741,A0A1W0E4B5,A0A2J7QB22,S4RYE2,A0A388KES6,A0A226EFL3,A0A3S3PD82,A0A0L0TEV1,A0A1S3J512,G0QTT2,A0A1J1HRI1,C4V9J2,Q9JMB7,A0A075AN09,Q5TW24,U5HIG6,A0A401PRI6,A0A2B4RHN2,G2QEV0,A0A397UU01,A0A2T7PFL8,K7ISV0,A0A024FT57,H3HCL6,A0A0G4IME3,E9FUN9,A0A1S3CYL5,D7FQK3,A0A1Y1YHC8,T1GSU4,F4S231,A0A1D8PMK0,A0A2G5B1D8,Q5BD61,A0A1C7M8P2,A0A4D8YSQ3,A0A158PJG6,J9JZ66,A0A0C2XG51,A0A158QZT6,A0A165QYQ9,T0SAU8,R7YY92,A0A3S1A0C3,A0A074YJ47,A0A2K1J482,A0A1Q3ENA6,O04379,A0A371I3C8,M8AEW7,A8P0D4,A0A2K3NY65,F4NYW7,A0A409Y6G2,A0A0L0HAB7,D8PZT7,A0A1D1W4K0,A7RQ46,W4YU94,A7BJS5,D8SNM6,A0A1J8PPA3,X1WG39,Q69VD5,A0A2R6NSC2,A0A0D8XL16,A0A016WPN3,Q9QZ81,G5EES3,A0A0K0EFP6,Q8CJG0,A0A1D5NTU6,V2WTL2,A0A0V0YLH8,A0A139WDH0,A0A0R3W9Q7,H3DS31,A0A1Y1HWP2,B7QCC4,A0A0B2UV00,M7BCJ9,E9GN30,Q7PZ41,A0A077Z361,R7U9I3,A0A1X7V1N5,A0A0K0JDP1,A0A0N4UKJ1,A0A498N3A3,A0A3M0IQP5,A0A0L8GBV4,Q32KD4,A0A1J1JBJ0,E0W4C3,A0A482XDA9,A0A3P7EJD6,J9K2Z4,A0A2J7Q8V4,T1IBM6,V3ZRX0,A0A210QKF7,A0A423TSS1,K1PT78,A0A267E8R7,A0A1D2N447,A0A226D7A9,F6YK55,T1KTE4,A0A2C9JGZ6,A0A1V9X9F0,K5X5Z7,A0A3Q0KUG5,T1FY40,1YVU,1Z26,3DLB,5AWH,5G5T,6QZK,7R8K,A0A1I7IXT4,A0A2W1JZ37,A0A2S7WBN3,A0A420DFE6,E0ST67,A0A4V1VDY2,A0A368P5I0,A0A4R1RMM2,A0A1Y2RDH8,Q11QW7,A0A1L3JHM3,A0A1W6MIP2,A0A2U2J9E0,A0A142XB92,B1XJG0,H1KXR6,A0A1T4Y3A2,A0A0P6X5X2,A0A2G9DT08,Q9L1X1,A0A1H3LE92,A0A496APJ8,A0A062U2W9,H0HWQ5,A0A1V9G9U4,A0A1I2ZGP1,A0A317EJY3,A0A1I2BD20,F8ERC7,S7VLM7,A0A1A5X8H4,A0A1I2T6Q1,A0A1R3T9N6,A0A0Q2M2Z1,H8KXJ0,D3S0S6,A0A2D1U4H7,I3TE64,A0A0B7I4Z6,A0LL61,Q8DKB1,A0A139WY18,A0A1J1EK56,A0A2T1E1K4,A0A1Q8ZD62,A0A4Q6XKV6,A0A1Z3HNN4,A0A239JE83,A0A2N4XBY2,Q53W94,R5JEI2,A0A0Q0ZC47,A0A2T0XH18,A0A1V4CHV0,A0A1K1RQP7,A0A2T1EKT1,A0A1N6LUI7,A0A0P0NGR6,A0A1X7IML5,A0A0A2LKJ7,K1L112,A0A0U3AL92,A0A1H3A054,E0UCX3,K9XZC6,B9LVW4,A0A0C1VHB4,Q31N05,A0A0C5JKF3,R5NJJ8,A5D4D9,Q2JI93,A0A142Y7A9,A0A432MEQ5,A0A372DKU2,A0A3R7KLK4,C1F5Q7,A0A4R3EV39,A0A1P8WP90,A0A222F7P0,A0A1C9VH88,A0A2T2YMB1,A0A329TD61,A0A101R2A0,A0A1E3XF49,A0A1U9ND56,A0A4R7BQC4,A0A1H3DGN3,A0A1Q1FPH0,E0TGY3,A0A259TUP4,F6EYI8,A0A2S9Q9J0,A0A4Q2UIU6,A0A1H0LH25,A0A318LG42,H1YCU5,L0JS08,A0A1Q5ZS75,A0A345E7N0,M0AF24,A0A1W2A082,A0A1H3X247,A0A0C1XUA0,M0D2X3,A0A2R5G167,A0A346PK63,R7RTW6,A0A1H2RBI2,A0A1C3ZXN2,B9LVP8,M5RSF0,W0JW77,B7K585,F8D8G0,A0A343TL88,L0AJX6,A0A2A5QS34,A0A343JEE2,A0A3P3RGE5,A0A329TBQ3,A0A285N2A8,A0A0W1S8B8,A0A1V4C8L7,L9VRQ2,E4NRV1,A0A1I6HGN0,A0A1I0NI68,,",366,37
"748","N.H8.24","N.L25.2",211,170,41,3.63694404591105,"4F3T,4KRE,5GUH,5VM9,6KR6,6OON,7KX7,A0A163JTZ6,J9D5G4,Q389P5,C4LVV2,A2DPV7,A0A0G4H2S4,T1H8B3,S4RWI0,D2VMG4,A0A074TLL7,A0A0D1ZAJ4,Q1K660,F4PH46,A0A3M7S814,A0A164ZA52,A0A383WDW5,Q54G64,S7WCF7,I0YVB2,R7QGN7,C1DZY0,A0A2C5Z0M1,R9ACY5,D3BMP8,A0A1Z5TVE5,A0A1U7LLR0,A0A4S2MWZ7,K1VVQ6,A0A158P1R9,G7DVX0,V6R0U9,G4N9J3,E3KLI3,B7Q5I1,A0A1E3QC61,D5GGK8,S8ANP9,A0A139AUH8,L2GMR6,U4LBG4,A0A177URI1,O74957,A0A3N4IGK1,A6N7Y9,A0A0E9NDK5,T1KZ60,A0A2G8JLH3,Q5KAT1,L2GUF2,W2T741,A0A1W0E4B5,A0A2J7QB22,S4RYE2,A0A388KES6,A0A226EFL3,A0A3S3PD82,A0A0L0TEV1,A0A1S3J512,A0A1J1HRI1,C4V9J2,Q9JMB7,A0A075AN09,Q5TW24,U5HIG6,A0A401PRI6,Q96J94,A0A2B4RHN2,G2QEV0,A0A397UU01,A0A2T7PFL8,K7ISV0,A0A024FT57,H3HCL6,A0A0G4IME3,E9FUN9,A0A1S3CYL5,D7FQK3,A0A1Y1YHC8,T1GSU4,F4S231,A0A2G5B1D8,Q5BD61,A0A1C7M8P2,A0A4D8YSQ3,A0A158PJG6,J9JZ66,A0A0C2XG51,A0A158QZT6,A0A165QYQ9,T0SAU8,R7YY92,A0A3S1A0C3,A0A074YJ47,A0A2K1J482,A0A1Q3ENA6,O04379,A0A371I3C8,M8AEW7,A8P0D4,A0A2K3NY65,F4NYW7,A0A409Y6G2,A0A0L0HAB7,D8PZT7,A0A1D1W4K0,A7RQ46,W4YU94,A7BJS5,D8SNM6,A0A1J8PPA3,X1WG39,M5FQK2,Q69VD5,A0A2R6NSC2,A0A0D8XL16,A0A016WPN3,Q9QZ81,G5EES3,A0A0K0EFP6,Q8CJG0,A0A1D5NTU6,V2WTL2,A0A0V0YLH8,A0A139WDH0,A0A0R3W9Q7,H3DS31,A0A1Y1HWP2,G4T5G9,B7QCC4,A0A0B2UV00,M7BCJ9,E9GN30,Q7PZ41,A0A077Z361,R7U9I3,A0A1X7V1N5,A0A0K0JDP1,A0A0N4UKJ1,A0A498N3A3,A0A3M0IQP5,A0A0L8GBV4,Q32KD4,A0A1J1JBJ0,E0W4C3,A0A482XDA9,A0A3P7EJD6,J9K2Z4,A0A2J7Q8V4,T1IBM6,V3ZRX0,A0A210QKF7,A0A423TSS1,K1PT78,A0A267E8R7,A0A1D2N447,A0A226D7A9,F6YK55,T1KTE4,A0A2C9JGZ6,A0A1V9X9F0,K5X5Z7,A0A3Q0KUG5,T1FY40,1YVU,6QZK,7R8K,A0A142XB92,A0A496APJ8,A0A062U2W9,H0HWQ5,A0A1V9G9U4,A0A1I2ZGP1,A0A317EJY3,A0A1I2BD20,F8ERC7,A0A139WY18,A0A2T1E1K4,A0A1Q8ZD62,A0A1Z3HNN4,R5NJJ8,A0A329TD61,A0A1Q1FPH0,F6EYI8,A0A2S9Q9J0,L0JS08,A0A345E7N0,M0AF24,A0A1H3X247,M0D2X3,A0A346PK63,R7RTW6,B9LVP8,F8D8G0,A0A343TL88,A0A2A5QS34,A0A343JEE2,A0A3P3RGE5,A0A329TBQ3,A0A0W1S8B8,A0A1V4C8L7,L9VRQ2,E4NRV1,A0A1I6HGN0,A0A1I0NI68,,",366,37
"749","N.S3.3","N.S3.5",226,170,56,3.21943277310924,"4F1N,4F3T,4KRE,5GUH,5VM9,6OON,A0A0N4X8S8,A0A196SDB4,Q389P5,C4LVV2,A0A2P6N8X7,A8BCK6,A2DPV7,A0A0G4H2S4,T1H8B3,S4RWI0,D2VMG4,A0A0D1ZAJ4,Q1K660,F4PH46,A0A164ZA52,A0A383WDW5,Q54G64,S7WCF7,I0YVB2,R7QGN7,C1DZY0,A0A2C5Z0M1,R9ACY5,D3BMP8,A0A1Z5TVE5,W7XD45,A0A1U7LLR0,A0A4S2MWZ7,K1VVQ6,A0A158P1R9,G7DVX0,V6R0U9,G4N9J3,E3KLI3,B7Q5I1,A0A1E3QC61,D5GGK8,S8ANP9,A0A139AUH8,L2GMR6,U4LBG4,A0A177URI1,O74957,A0A3N4IGK1,A6N7Y9,A0A0E9NDK5,T1KZ60,A0A250WXN5,A0A2G8JLH3,Q5KAT1,L2GUF2,A0A1W0E4B5,A0A2J7QB22,S4RYE2,A0A226EFL3,A0A3S3PD82,A0A0L0TEV1,A0A1S3J512,G0QTT2,A0A1J1HRI1,C4V9J2,Q9JMB7,A0A075AN09,Q5TW24,U5HIG6,A0A401PRI6,Q96J94,A0A2B4RHN2,A0A397UU01,A0A2T7PFL8,K7ISV0,A0A024FT57,H3HCL6,A0A0G4IME3,E9FUN9,A0A1S3CYL5,D7FQK3,A0A1Y1YHC8,T1GSU4,F4S231,A0A1D8PMK0,A0A2G5B1D8,Q5BD61,A0A1C7M8P2,A0A4D8YSQ3,A0A158PJG6,J9JZ66,A0A0C2XG51,A0A158QZT6,A0A165QYQ9,T0SAU8,R7YY92,A0A3S1A0C3,A0A074YJ47,A0A2K1J482,A0A1Q3ENA6,O04379,A0A371I3C8,M8AEW7,A8P0D4,A0A2K3NY65,F4NYW7,A0A409Y6G2,A0A0L0HAB7,D8PZT7,A0A1D1W4K0,A7RQ46,W4YU94,A7BJS5,D8SNM6,A0A1J8PPA3,X1WG39,M5FQK2,Q69VD5,A0A2R6NSC2,A0A0D8XL16,A0A016WPN3,Q9QZ81,G5EES3,A0A0K0EFP6,Q8CJG0,A0A1D5NTU6,V2WTL2,A0A0V0YLH8,A0A139WDH0,A0A0R3W9Q7,H3DS31,A0A1Y1HWP2,G4T5G9,B7QCC4,A0A0B2UV00,M7BCJ9,E9GN30,Q7PZ41,A0A077Z361,R7U9I3,A0A1X7V1N5,A0A0K0JDP1,A0A0N4UKJ1,A0A498N3A3,A0A3M0IQP5,A0A0L8GBV4,Q32KD4,A0A1J1JBJ0,E0W4C3,A0A482XDA9,A0A3P7EJD6,J9K2Z4,A0A2J7Q8V4,T1IBM6,V3ZRX0,A0A210QKF7,A0A423TSS1,K1PT78,A0A267E8R7,A0A1D2N447,A0A226D7A9,F6YK55,T1KTE4,A0A2C9JGZ6,A0A1V9X9F0,K5X5Z7,A0A3Q0KUG5,T1FY40,1YVU,1Z26,5G5T,5I4A,7R8K,E0ST67,A0A1M5ZSR3,A0A1I3LMA1,A0A0F4NXW8,H1KXR6,A0A0B0H9B4,R6KUL9,B7GJX9,A0A1N6SSK9,A0A235B542,R5XQK4,A0A062U2W9,H0HWQ5,A0A1I2BD20,A0A0Q2M2Z1,D3S0S6,I3TE64,Q8DKB1,A0A2T1EKT1,E0UCX3,K9XZC6,B9LVW4,A0A0C1VHB4,Q31N05,R5NJJ8,Q2JI93,A0A1P8WP90,A0A1Q1FPH0,L0JS08,A0A345E7N0,M0AF24,A0A1H3X247,M0D2X3,A0A346PK63,R7RTW6,B9LVP8,W0JW77,F8D8G0,A0A343TL88,L0AJX6,A0A2A5QS34,A0A343JEE2,A0A3P3RGE5,A0A329TBQ3,A0A285N2A8,A0A0W1S8B8,A0A1V4C8L7,L9VRQ2,E4NRV1,A0A1I6HGN0,A0A1I0NI68,,",366,37
"753","C.H7.13","C.L17.3",214,171,43,4.36386508907929,"4F1N,4F3T,4KRE,5GUH,5VM9,6KR6,6OON,7KX7,7SWF,A0A163JTZ6,A0A0N4X8S8,A0A196SDB4,J9D5G4,C4LVV2,A2DPV7,T1H8B3,R1FDF0,S4RWI0,D2VMG4,A0A0D1ZAJ4,Q1K660,F4PH46,A0A3M7S814,A0A164ZA52,Q54G64,S7WCF7,I0YVB2,R7QGN7,C1DZY0,A0A2C5Z0M1,A0CB11,R9ACY5,D3BMP8,A0A1Z5TVE5,W7XD45,A0A1U7LLR0,A0A4S2MWZ7,K1VVQ6,A0A158P1R9,V6R0U9,G4N9J3,E3KLI3,B7Q5I1,A0A1E3QC61,D5GGK8,S8ANP9,A0A139AUH8,L2GMR6,U4LBG4,A0A177URI1,O74957,A0A3N4IGK1,A6N7Y9,A0A0E9NDK5,T1KZ60,A0A250WXN5,A0A2G8JLH3,Q5KAT1,L2GUF2,W2T741,A0A1W0E4B5,A0A2J7QB22,A0A2K3CW87,A0A226EFL3,A0A3S3PD82,A0A0L0TEV1,A0A1S3J512,G0QTT2,A0A1J1HRI1,C4V9J2,Q9JMB7,A0A075AN09,Q5TW24,U5HIG6,A0A401PRI6,Q96J94,A0A2B4RHN2,G2QEV0,A0A397UU01,A0A2T7PFL8,K7ISV0,A0A024FT57,H3HCL6,A0A0G4IME3,E9FUN9,A0A1S3CYL5,D7FQK3,A0A1Y1YHC8,T1GSU4,F4S231,A0A1D8PMK0,A0A2G5B1D8,Q5BD61,A0A1C7M8P2,A0A4D8YSQ3,A0A158PJG6,J9JZ66,A0A158QZT6,A0A165QYQ9,T0SAU8,R7YY92,A0A3S1A0C3,A0A074YJ47,A0A2K1J482,A0A1Q3ENA6,O04379,A0A371I3C8,M8AEW7,A8P0D4,A0A2K3NY65,F4NYW7,A0A409Y6G2,A0A0L0HAB7,D8PZT7,A0A1D1W4K0,A7RQ46,W4YU94,A7BJS5,D8SNM6,A0A1J8PPA3,X1WG39,Q69VD5,A0A2R6NSC2,A0A0D8XL16,A0A016WPN3,Q9QZ81,G5EES3,A0A0K0EFP6,Q8CJG0,A0A1D5NTU6,V2WTL2,A0A0V0YLH8,A0A139WDH0,A0A0R3W9Q7,H3DS31,A0A1Y1HWP2,B7QCC4,A0A0B2UV00,M7BCJ9,E9GN30,Q7PZ41,A0A077Z361,R7U9I3,A0A1X7V1N5,A0A0K0JDP1,A0A0N4UKJ1,A0A498N3A3,A0A3M0IQP5,A0A0L8GBV4,Q32KD4,A0A1J1JBJ0,E0W4C3,A0A482XDA9,A0A3P7EJD6,J9K2Z4,A0A2J7Q8V4,T1IBM6,V3ZRX0,A0A210QKF7,A0A423TSS1,K1PT78,A0A267E8R7,A0A1D2N447,A0A226D7A9,F6YK55,T1KTE4,A0A2C9JGZ6,A0A1V9X9F0,K5X5Z7,A0A3Q0KUG5,T1FY40,3DLB,5I4A,6QZK,C4L1M1,A0A1I3LMA1,A0A1W6MIP2,A0A2U2J9E0,B1XJG0,A0A0B0H9B4,R6KUL9,B7GJX9,A0A1N6SSK9,A0A060HNJ0,A0A235B542,A0A1H3LE92,Q8DKB1,A0A1J1EK56,Q53W94,A0A2T1EKT1,E0UCX3,K9XZC6,B9LVW4,A0A0C1VHB4,Q31N05,R5NJJ8,Q2JI93,L0JS08,M0AF24,M0D2X3,A0A346PK63,R7RTW6,W0JW77,A0A343TL88,L0AJX6,A0A2A5QS34,A0A343JEE2,A0A3P3RGE5,A0A329TBQ3,A0A285N2A8,A0A0W1S8B8,L9VRQ2,E4NRV1,A0A1I6HGN0,,",366,37
"755","C.H9.10","C.L21.16",323,171,152,3.17324561403509,"4F3T,4KRE,5GUH,5VM9,6KR6,6OON,7KX7,7SWF,A0A163JTZ6,A0A0N4X8S8,A0A196SDB4,J9D5G4,Q389P5,C4LVV2,A2DPV7,D2VMG4,A0A074TLL7,A0A0D1ZAJ4,Q1K660,F4PH46,A0A3M7S814,A0A164ZA52,A0A383WDW5,Q54G64,S7WCF7,I0YVB2,R7QGN7,C1DZY0,A0A2C5Z0M1,A0CB11,R9ACY5,D3BMP8,A0A1Z5TVE5,W7XD45,A0A1U7LLR0,A0A4S2MWZ7,K1VVQ6,A0A158P1R9,G7DVX0,V6R0U9,G4N9J3,E3KLI3,B7Q5I1,A0A1E3QC61,D5GGK8,S8ANP9,A0A139AUH8,L2GMR6,U4LBG4,A0A177URI1,O74957,A0A3N4IGK1,A6N7Y9,A0A0E9NDK5,T1KZ60,A0A250WXN5,A0A2G8JLH3,Q5KAT1,L2GUF2,W2T741,A0A1W0E4B5,A0A2J7QB22,S4RYE2,A0A2K3CW87,A0A388KES6,A0A226EFL3,A0A3S3PD82,A0A0L0TEV1,A0A1S3J512,G0QTT2,A0A1J1HRI1,C4V9J2,Q9JMB7,A0A075AN09,U5HIG6,A0A401PRI6,Q96J94,A0A2B4RHN2,G2QEV0,A0A397UU01,A0A2T7PFL8,K7ISV0,A0A024FT57,H3HCL6,A0A0G4IME3,E9FUN9,A0A1S3CYL5,D7FQK3,A0A1Y1YHC8,T1GSU4,F4S231,A0A1D8PMK0,A0A2G5B1D8,Q5BD61,A0A1C7M8P2,A0A4D8YSQ3,A0A158PJG6,J9JZ66,A0A0C2XG51,A0A158QZT6,A0A165QYQ9,T0SAU8,R7YY92,A0A3S1A0C3,A0A074YJ47,A0A2K1J482,A0A1Q3ENA6,O04379,A0A371I3C8,M8AEW7,A0A2K3NY65,F4NYW7,A0A409Y6G2,A0A0L0HAB7,A0A1D1W4K0,A7RQ46,W4YU94,A7BJS5,D8SNM6,A0A1J8PPA3,X1WG39,M5FQK2,Q69VD5,A0A0D8XL16,A0A016WPN3,Q9QZ81,G5EES3,A0A0K0EFP6,Q8CJG0,A0A1D5NTU6,A0A0V0YLH8,A0A139WDH0,A0A0R3W9Q7,H3DS31,A0A1Y1HWP2,G4T5G9,B7QCC4,A0A0B2UV00,M7BCJ9,E9GN30,Q7PZ41,A0A077Z361,R7U9I3,A0A1X7V1N5,A0A0K0JDP1,A0A0N4UKJ1,A0A498N3A3,A0A3M0IQP5,A0A0L8GBV4,Q32KD4,A0A1J1JBJ0,E0W4C3,A0A482XDA9,A0A3P7EJD6,J9K2Z4,A0A2J7Q8V4,T1IBM6,V3ZRX0,A0A210QKF7,A0A423TSS1,K1PT78,A0A267E8R7,A0A1D2N447,A0A226D7A9,F6YK55,T1KTE4,A0A2C9JGZ6,A0A1V9X9F0,K5X5Z7,A0A3Q0KUG5,T1FY40,1YVU,3DLB,5AWH,5G5T,5I4A,6QZK,A0A1I7IXT4,A0A2W1JZ37,A0A2S7WBN3,A0A328VKE4,A0A420DFE6,E0ST67,A0A4V1VDY2,A0A368P5I0,C4L1M1,A0A4R1RMM2,A0A1Y2RDH8,Q11QW7,A0A1M5ZSR3,A0A0K8QX04,A0A0M2PXX3,K9TPA9,A0A1L3JHM3,A0A1W6MIP2,A0A1C0UUC4,A0A2Z6E1D5,A0A326U7G5,A0A3D8L290,K9U8J6,K9RC91,A0A0D8ZUC0,A0A139XGN8,A0A1T4Y3A2,A0YYT3,A0A2T1EFY0,G6FTN0,R6KUL9,A0A433NB65,A0A1Z4L0A1,K9UQR0,K9VUN0,B7GJX9,A0A0P6X5X2,K9ZDE3,B0JXD6,A0A2T1LS63,A0A1Z4K1Y3,A0A2Z6E0R7,A0A1N6SSK9,A0A0P4UVI8,A0A0V7ZCG4,A0A1J0AGK2,K9PFF9,A0A2G9DT08,K9UEV4,Q9L1X1,A0A060HNJ0,A0A235B542,A0A1H3LE92,A0A496APJ8,A0A062U2W9,H0HWQ5,A0A1V9G9U4,A0A1I2ZGP1,A0A317EJY3,A0A1I2BD20,F8ERC7,S7VLM7,A0A1A5X8H4,A0A1R3T9N6,H8KXJ0,A0A2D1U4H7,A0A0B7I4Z6,A0LL61,A0A139WY18,A0A1J1EK56,A0A2T1E1K4,A0A1Q8ZD62,A0A4Q6XKV6,A0A1Z3HNN4,A0A239JE83,A0A2N4XBY2,Q53W94,R5JEI2,A0A0Q0ZC47,A0A2T0XH18,A0A1V4CHV0,A0A1K1RQP7,A0A1N6LUI7,A0A0P0NGR6,A0A1X7IML5,A0A0A2LKJ7,K1L112,A0A1H3A054,A0A0C5JKF3,R5NJJ8,A5D4D9,A0A142Y7A9,A0A432MEQ5,A0A372DKU2,A0A3R7KLK4,C1F5Q7,A0A4R3EV39,A0A1P8WP90,A0A222F7P0,A0A1C9VH88,A0A2T2YMB1,A0A329TD61,A0A101R2A0,A0A1E3XF49,A0A1U9ND56,A0A4R7BQC4,A0A1H3DGN3,A0A1Q1FPH0,E0TGY3,A0A259TUP4,F6EYI8,A0A2S9Q9J0,A0A1H0LH25,A0A318LG42,H1YCU5,L0JS08,A0A1Q5ZS75,A0A345E7N0,M0AF24,A0A1W2A082,A0A1H3X247,A0A0C1XUA0,M0D2X3,A0A2R5G167,A0A346PK63,R7RTW6,A0A1H2RBI2,A0A1C3ZXN2,B9LVP8,M5RSF0,W0JW77,B7K585,F8D8G0,A0A343TL88,L0AJX6,A0A2A5QS34,A0A343JEE2,A0A3P3RGE5,A0A329TBQ3,A0A285N2A8,A0A0W1S8B8,A0A1V4C8L7,L9VRQ2,E4NRV1,A0A1I6HGN0,A0A1I0NI68,,",366,37
"758","C.L20.4","C.L20.6",242,171,71,1.9159459682069,"4F3T,4KRE,5GUH,5VM9,6OON,A0A163JTZ6,A0A0N4X8S8,A0A196SDB4,J9D5G4,Q389P5,C4LVV2,A0A2P6N8X7,A8BCK6,A0A0G4H2S4,T1H8B3,S4RWI0,D2VMG4,A0A074TLL7,A0A0D1ZAJ4,F4PH46,A0A3M7S814,A0A164ZA52,A0A383WDW5,Q54G64,S7WCF7,I0YVB2,R7QGN7,C1DZY0,A0CB11,R9ACY5,D3BMP8,W7XD45,A0A1U7LLR0,A0A4S2MWZ7,A0A158P1R9,G7DVX0,V6R0U9,G4N9J3,E3KLI3,B7Q5I1,A0A1E3QC61,D5GGK8,S8ANP9,A0A139AUH8,L2GMR6,U4LBG4,A0A177URI1,O74957,A0A3N4IGK1,A6N7Y9,A0A0E9NDK5,T1KZ60,A0A250WXN5,A0A2G8JLH3,Q5KAT1,L2GUF2,W2T741,A0A1W0E4B5,A0A2J7QB22,S4RYE2,A0A2K3CW87,A0A388KES6,A0A226EFL3,A0A3S3PD82,A0A0L0TEV1,A0A1S3J512,G0QTT2,A0A1J1HRI1,C4V9J2,Q9JMB7,A0A075AN09,Q5TW24,U5HIG6,A0A401PRI6,Q96J94,A0A2B4RHN2,G2QEV0,A0A397UU01,A0A2T7PFL8,K7ISV0,A0A024FT57,H3HCL6,A0A0G4IME3,E9FUN9,A0A1S3CYL5,D7FQK3,A0A1Y1YHC8,T1GSU4,A0A1D8PMK0,A0A2G5B1D8,Q5BD61,A0A1C7M8P2,A0A4D8YSQ3,A0A158PJG6,A0A0C2XG51,A0A158QZT6,A0A165QYQ9,T0SAU8,R7YY92,A0A3S1A0C3,A0A074YJ47,A0A2K1J482,A0A1Q3ENA6,O04379,A0A371I3C8,M8AEW7,A8P0D4,A0A2K3NY65,F4NYW7,A0A409Y6G2,A0A0L0HAB7,D8PZT7,A0A1D1W4K0,A7RQ46,W4YU94,A7BJS5,D8SNM6,A0A1J8PPA3,X1WG39,M5FQK2,Q69VD5,A0A2R6NSC2,A0A0D8XL16,A0A016WPN3,Q9QZ81,G5EES3,A0A0K0EFP6,Q8CJG0,A0A1D5NTU6,V2WTL2,A0A0V0YLH8,A0A139WDH0,A0A0R3W9Q7,H3DS31,A0A1Y1HWP2,G4T5G9,B7QCC4,A0A0B2UV00,M7BCJ9,E9GN30,Q7PZ41,A0A077Z361,R7U9I3,A0A1X7V1N5,A0A0K0JDP1,A0A0N4UKJ1,A0A498N3A3,A0A3M0IQP5,A0A0L8GBV4,Q32KD4,A0A1J1JBJ0,E0W4C3,A0A482XDA9,A0A3P7EJD6,J9K2Z4,A0A2J7Q8V4,T1IBM6,V3ZRX0,A0A210QKF7,A0A423TSS1,K1PT78,A0A267E8R7,A0A1D2N447,A0A226D7A9,F6YK55,T1KTE4,A0A2C9JGZ6,A0A1V9X9F0,K5X5Z7,A0A3Q0KUG5,T1FY40,1YVU,1Z26,5I4A,6QZK,7R8K,A0A328VKE4,A0A4R1RMM2,A0A1Y2RDH8,A0A0M2PXX3,K9TPA9,A0A1C0UUC4,A0A142XB92,A0A3D8L290,H1KXR6,A0A097QRL6,A0A1T4Y3A2,B0JXD6,A0A1Z4K1Y3,A0A2Z6E0R7,A0A2G9DT08,Q9L1X1,A0A060HNJ0,A0A1V9G9U4,A0A1I2ZGP1,A0A1I2BD20,A0A1A5X8H4,A0A1R3T9N6,A0A0Q2M2Z1,D3S0S6,A0A2D1U4H7,I3TE64,A0A0B7I4Z6,A0LL61,A0A139WY18,A0A1Q8ZD62,A0A4Q6XKV6,A0A2N4XBY2,A0A0Q0ZC47,A0A2T0XH18,A0A1K1RQP7,A0A1N6LUI7,A0A0P0NGR6,A0A1X7IML5,A0A0A2LKJ7,K1L112,A0A0U3AL92,A0A1H3A054,A0A0C5JKF3,A5D4D9,A0A142Y7A9,A0A372DKU2,C1F5Q7,A0A4R3EV39,A0A1P8WP90,A0A222F7P0,A0A1C9VH88,A0A2T2YMB1,A0A101R2A0,E0TGY3,A0A259TUP4,F6EYI8,A0A2S9Q9J0,A0A1H0LH25,A0A318LG42,H1YCU5,A0A1Q5ZS75,A0A1W2A082,A0A1H2RBI2,A0A1C3ZXN2,M5RSF0,B7K585,,",366,37
"759","C.L21.12","C.L23.8",239,171,68,1.97643618851049,"4F1N,4F3T,4KRE,5GUH,5VM9,6OON,7KX7,A0A163JTZ6,A0A0N4X8S8,J9D5G4,C4LVV2,A2DPV7,A0A0G4H2S4,R1FDF0,D2VMG4,A0A074TLL7,A0A0D1ZAJ4,Q1K660,F4PH46,A0A3M7S814,A0A164ZA52,A0A383WDW5,Q54G64,S7WCF7,R7QGN7,A0A2C5Z0M1,A0CB11,R9ACY5,D3BMP8,A0A1Z5TVE5,W7XD45,A0A1U7LLR0,A0A4S2MWZ7,K1VVQ6,A0A158P1R9,G7DVX0,V6R0U9,G4N9J3,E3KLI3,B7Q5I1,A0A1E3QC61,D5GGK8,S8ANP9,A0A139AUH8,L2GMR6,U4LBG4,A0A177URI1,O74957,A0A3N4IGK1,A6N7Y9,A0A0E9NDK5,T1KZ60,A0A250WXN5,A0A2G8JLH3,Q5KAT1,W2T741,A0A1W0E4B5,A0A2J7QB22,S4RYE2,A0A2K3CW87,A0A388KES6,A0A226EFL3,A0A3S3PD82,A0A0L0TEV1,A0A1S3J512,G0QTT2,A0A1J1HRI1,C4V9J2,Q9JMB7,A0A075AN09,Q5TW24,U5HIG6,A0A401PRI6,Q96J94,A0A2B4RHN2,A0A397UU01,A0A2T7PFL8,K7ISV0,A0A024FT57,H3HCL6,A0A0G4IME3,E9FUN9,A0A1S3CYL5,D7FQK3,A0A1Y1YHC8,T1GSU4,F4S231,A0A1D8PMK0,A0A2G5B1D8,Q5BD61,A0A1C7M8P2,A0A4D8YSQ3,A0A158PJG6,J9JZ66,A0A0C2XG51,A0A158QZT6,A0A165QYQ9,T0SAU8,R7YY92,A0A3S1A0C3,A0A074YJ47,A0A2K1J482,A0A1Q3ENA6,O04379,A0A371I3C8,M8AEW7,A8P0D4,A0A2K3NY65,F4NYW7,A0A409Y6G2,A0A0L0HAB7,D8PZT7,A0A1D1W4K0,A7RQ46,W4YU94,A7BJS5,D8SNM6,A0A1J8PPA3,X1WG39,M5FQK2,Q69VD5,A0A2R6NSC2,A0A0D8XL16,A0A016WPN3,Q9QZ81,G5EES3,A0A0K0EFP6,Q8CJG0,A0A1D5NTU6,V2WTL2,A0A0V0YLH8,A0A139WDH0,A0A0R3W9Q7,H3DS31,A0A1Y1HWP2,G4T5G9,B7QCC4,A0A0B2UV00,M7BCJ9,E9GN30,Q7PZ41,A0A077Z361,R7U9I3,A0A1X7V1N5,A0A0K0JDP1,A0A0N4UKJ1,A0A498N3A3,A0A3M0IQP5,A0A0L8GBV4,Q32KD4,A0A1J1JBJ0,E0W4C3,A0A482XDA9,A0A3P7EJD6,J9K2Z4,A0A2J7Q8V4,T1IBM6,V3ZRX0,A0A210QKF7,A0A423TSS1,K1PT78,A0A267E8R7,A0A1D2N447,A0A226D7A9,F6YK55,T1KTE4,A0A2C9JGZ6,A0A1V9X9F0,K5X5Z7,A0A3Q0KUG5,T1FY40,5AWH,6QZK,7R8K,E0ST67,A0A1Y2RDH8,A0A0K8QX04,A0A0M2PXX3,K9TPA9,A0A1L3JHM3,A0A1W6MIP2,A0A1C0UUC4,A0A2U2J9E0,A0A0F4NXW8,A0A142XB92,L8D0R3,K9RC91,A0A0D8ZUC0,A0A139XGN8,A0A1T4Y3A2,Q5P0R2,A0YYT3,A0A2T1EFY0,G6FTN0,A0A2T1G8M7,K9ZDE3,A0A1Z4K1Y3,A0A2Z6E0R7,A0A0V7ZCG4,A0A1J0AGK2,A0A062U2W9,H0HWQ5,A0A1I2ZGP1,A0A317EJY3,A0A1I2BD20,F8ERC7,A0A1A5X8H4,A0A1I2T6Q1,A0A1R3T9N6,A0A0B7I4Z6,A0A4Q6XKV6,A0A2N4XBY2,R5JEI2,A0A1N6LUI7,A0A1X7IML5,A0A0U3AL92,A0A1H3A054,A0A0C5JKF3,A5D4D9,A0A432MEQ5,A0A372DKU2,A0A3R7KLK4,A0A4R3EV39,A0A222F7P0,A0A1C9VH88,A0A2T2YMB1,A0A1E3XF49,A0A1U9ND56,A0A4R7BQC4,A0A1H3DGN3,A0A4Q2UIU6,H1YCU5,A0A1Q5ZS75,A0A1W2A082,A0A0C1XUA0,A0A2R5G167,A0A1H2RBI2,A0A1C3ZXN2,M5RSF0,,",366,37
"760","C.L22.10","C.S16.5",301,171,130,5.53484030589294,"4F1N,4F3T,4KRE,5GUH,5VM9,6KR6,6OON,7SWF,A0A163JTZ6,J9D5G4,C4LVV2,A0A0G4H2S4,R1FDF0,D2VMG4,A0A074TLL7,A0A0D1ZAJ4,Q1K660,F4PH46,A0A3M7S814,A0A164ZA52,A0A383WDW5,Q54G64,I0YVB2,R7QGN7,C1DZY0,A0A2C5Z0M1,A0CB11,R9ACY5,D3BMP8,A0A1Z5TVE5,W7XD45,A0A1U7LLR0,A0A4S2MWZ7,K1VVQ6,A0A158P1R9,G7DVX0,V6R0U9,G4N9J3,E3KLI3,A0A1E3QC61,D5GGK8,S8ANP9,A0A139AUH8,L2GMR6,U4LBG4,A0A177URI1,O74957,A0A3N4IGK1,A6N7Y9,A0A0E9NDK5,T1KZ60,A0A250WXN5,A0A2G8JLH3,Q5KAT1,L2GUF2,W2T741,A0A2J7QB22,S4RYE2,A0A2K3CW87,A0A388KES6,A0A226EFL3,A0A3S3PD82,A0A0L0TEV1,A0A1S3J512,G0QTT2,A0A1J1HRI1,C4V9J2,Q9JMB7,A0A075AN09,Q5TW24,U5HIG6,A0A401PRI6,Q96J94,A0A2B4RHN2,G2QEV0,A0A397UU01,A0A2T7PFL8,K7ISV0,A0A024FT57,H3HCL6,A0A0G4IME3,E9FUN9,A0A1S3CYL5,D7FQK3,A0A1Y1YHC8,T1GSU4,F4S231,A0A1D8PMK0,A0A2G5B1D8,Q5BD61,A0A1C7M8P2,A0A4D8YSQ3,A0A158PJG6,J9JZ66,A0A0C2XG51,A0A158QZT6,A0A165QYQ9,T0SAU8,R7YY92,A0A3S1A0C3,A0A074YJ47,A0A2K1J482,A0A1Q3ENA6,O04379,A0A371I3C8,M8AEW7,A8P0D4,A0A2K3NY65,F4NYW7,A0A409Y6G2,A0A0L0HAB7,D8PZT7,A0A1D1W4K0,A7RQ46,W4YU94,A7BJS5,D8SNM6,A0A1J8PPA3,X1WG39,M5FQK2,Q69VD5,A0A2R6NSC2,A0A0D8XL16,A0A016WPN3,Q9QZ81,G5EES3,A0A0K0EFP6,Q8CJG0,A0A1D5NTU6,V2WTL2,A0A0V0YLH8,A0A139WDH0,A0A0R3W9Q7,H3DS31,A0A1Y1HWP2,G4T5G9,B7QCC4,A0A0B2UV00,M7BCJ9,E9GN30,Q7PZ41,A0A077Z361,R7U9I3,A0A1X7V1N5,A0A0K0JDP1,A0A0N4UKJ1,A0A498N3A3,A0A3M0IQP5,A0A0L8GBV4,Q32KD4,A0A1J1JBJ0,E0W4C3,A0A482XDA9,A0A3P7EJD6,J9K2Z4,A0A2J7Q8V4,T1IBM6,V3ZRX0,A0A210QKF7,A0A423TSS1,K1PT78,A0A267E8R7,A0A1D2N447,A0A226D7A9,F6YK55,T1KTE4,A0A2C9JGZ6,A0A1V9X9F0,K5X5Z7,A0A3Q0KUG5,T1FY40,1YVU,3DLB,5AWH,5I4A,6QZK,A0A1I7IXT4,A0A2W1JZ37,A0A2S7WBN3,A0A420DFE6,A0A4V1VDY2,A0A368P5I0,A0A1W6MIP2,B1XJG0,K9U8J6,K9RC91,A0A0D8ZUC0,A0A139XGN8,A0A1T4Y3A2,A0A2T1EFY0,G6FTN0,A0A433NB65,A0A1Z4L0A1,K9UQR0,K9VUN0,K9ZDE3,B0JXD6,A0A2T1LS63,A0A1Z4K1Y3,A0A0P4UVI8,A0A0V7ZCG4,A0A1J0AGK2,K9PFF9,A0A2G9DT08,K9UEV4,Q9L1X1,A0A1H3LE92,A0A496APJ8,A0A1V9G9U4,S7VLM7,A0A1A5X8H4,A0A1I2T6Q1,A0A1R3T9N6,H8KXJ0,A0A2D1U4H7,A0A0B7I4Z6,A0LL61,Q8DKB1,A0A139WY18,A0A1J1EK56,A0A2T1E1K4,A0A1Q8ZD62,A0A4Q6XKV6,A0A1Z3HNN4,A0A239JE83,A0A2N4XBY2,Q53W94,R5JEI2,A0A0Q0ZC47,A0A2T0XH18,A0A1V4CHV0,A0A1K1RQP7,A0A2T1EKT1,A0A1N6LUI7,A0A0P0NGR6,A0A1X7IML5,A0A0A2LKJ7,K1L112,A0A0U3AL92,A0A1H3A054,E0UCX3,K9XZC6,A0A0C1VHB4,Q31N05,A0A0C5JKF3,R5NJJ8,A5D4D9,Q2JI93,A0A142Y7A9,A0A432MEQ5,A0A372DKU2,C1F5Q7,A0A4R3EV39,A0A1P8WP90,A0A222F7P0,A0A1C9VH88,A0A2T2YMB1,A0A329TD61,A0A101R2A0,A0A1E3XF49,A0A1U9ND56,A0A4R7BQC4,A0A1Q1FPH0,E0TGY3,A0A259TUP4,F6EYI8,A0A2S9Q9J0,A0A4Q2UIU6,A0A1H0LH25,A0A318LG42,H1YCU5,L0JS08,A0A1Q5ZS75,A0A345E7N0,M0AF24,A0A1W2A082,A0A1H3X247,A0A0C1XUA0,M0D2X3,A0A2R5G167,A0A346PK63,A0A1H2RBI2,A0A1C3ZXN2,B9LVP8,M5RSF0,W0JW77,B7K585,F8D8G0,A0A343TL88,L0AJX6,A0A2A5QS34,A0A343JEE2,A0A3P3RGE5,A0A329TBQ3,A0A285N2A8,A0A0W1S8B8,A0A1V4C8L7,L9VRQ2,E4NRV1,A0A1I6HGN0,A0A1I0NI68,,",366,37
"761","C.L23.8","N.H8.5",234,171,63,3.11445279866332,"4F1N,4F3T,4KRE,5GUH,5VM9,6KR6,6OON,A0A163JTZ6,A0A0N4X8S8,J9D5G4,C4LVV2,A0A2P6N8X7,A8BCK6,A2DPV7,A0A0G4H2S4,R1FDF0,D2VMG4,A0A0D1ZAJ4,Q1K660,F4PH46,A0A3M7S814,A0A164ZA52,A0A383WDW5,Q54G64,S7WCF7,I0YVB2,R7QGN7,C1DZY0,A0A2C5Z0M1,A0CB11,R9ACY5,D3BMP8,A0A1Z5TVE5,W7XD45,A0A1U7LLR0,A0A4S2MWZ7,K1VVQ6,G7DVX0,V6R0U9,G4N9J3,E3KLI3,B7Q5I1,A0A1E3QC61,D5GGK8,S8ANP9,A0A139AUH8,L2GMR6,U4LBG4,A0A177URI1,O74957,A0A3N4IGK1,A6N7Y9,A0A0E9NDK5,T1KZ60,Q5KAT1,L2GUF2,W2T741,A0A1W0E4B5,A0A2J7QB22,S4RYE2,A0A388KES6,A0A226EFL3,A0A3S3PD82,A0A0L0TEV1,A0A1S3J512,G0QTT2,A0A1J1HRI1,C4V9J2,Q9JMB7,A0A075AN09,Q5TW24,U5HIG6,A0A401PRI6,Q96J94,A0A2B4RHN2,G2QEV0,A0A397UU01,A0A2T7PFL8,K7ISV0,A0A024FT57,H3HCL6,A0A0G4IME3,E9FUN9,A0A1S3CYL5,D7FQK3,A0A1Y1YHC8,T1GSU4,F4S231,A0A1D8PMK0,A0A2G5B1D8,Q5BD61,A0A1C7M8P2,A0A4D8YSQ3,A0A158PJG6,A0A0C2XG51,A0A158QZT6,A0A165QYQ9,T0SAU8,R7YY92,A0A3S1A0C3,A0A074YJ47,A0A2K1J482,A0A1Q3ENA6,O04379,A0A371I3C8,M8AEW7,A8P0D4,A0A2K3NY65,F4NYW7,A0A409Y6G2,A0A0L0HAB7,D8PZT7,A0A1D1W4K0,A7RQ46,W4YU94,A7BJS5,D8SNM6,A0A1J8PPA3,X1WG39,M5FQK2,Q69VD5,A0A2R6NSC2,A0A0D8XL16,A0A016WPN3,Q9QZ81,G5EES3,A0A0K0EFP6,Q8CJG0,A0A1D5NTU6,V2WTL2,A0A0V0YLH8,A0A139WDH0,A0A0R3W9Q7,H3DS31,A0A1Y1HWP2,G4T5G9,B7QCC4,A0A0B2UV00,M7BCJ9,E9GN30,Q7PZ41,A0A077Z361,R7U9I3,A0A1X7V1N5,A0A0K0JDP1,A0A0N4UKJ1,A0A498N3A3,A0A3M0IQP5,A0A0L8GBV4,Q32KD4,A0A1J1JBJ0,E0W4C3,A0A482XDA9,A0A3P7EJD6,J9K2Z4,A0A2J7Q8V4,T1IBM6,V3ZRX0,A0A210QKF7,A0A423TSS1,K1PT78,A0A267E8R7,A0A1D2N447,A0A226D7A9,F6YK55,T1KTE4,A0A2C9JGZ6,A0A1V9X9F0,K5X5Z7,A0A3Q0KUG5,T1FY40,1Z26,3DLB,5AWH,7R8K,E0ST67,C4L1M1,A0A142XB92,A0A3D8L290,A0A0B0H9B4,R6KUL9,B7GJX9,A0A1N6SSK9,A0A235B542,R5XQK4,A0A1H3LE92,A0A496APJ8,H0HWQ5,A0A1V9G9U4,A0A1I2ZGP1,A0A317EJY3,A0A1I2BD20,F8ERC7,A0A1R3T9N6,A0A0Q2M2Z1,H8KXJ0,A0LL61,A0A139WY18,A0A2T1E1K4,A0A1Q8ZD62,A0A1Z3HNN4,A0A239JE83,A0A1V4CHV0,K9XZC6,B9LVW4,A5D4D9,A0A3R7KLK4,A0A1P8WP90,A0A329TD61,A0A1E3XF49,A0A1H3DGN3,A0A1Q1FPH0,A0A259TUP4,H1YCU5,L0JS08,A0A1Q5ZS75,A0A345E7N0,M0AF24,A0A1W2A082,A0A1H3X247,A0A0C1XUA0,M0D2X3,A0A346PK63,A0A1H2RBI2,A0A1C3ZXN2,W0JW77,A0A343TL88,A0A3P3RGE5,A0A329TBQ3,A0A0W1S8B8,L9VRQ2,E4NRV1,A0A1I6HGN0,A0A1I0NI68,,",366,37
"765","N.H4.4","N.H4.7",297,171,126,2.96992481203007,"4F1N,4F3T,4KRE,5VM9,6KR6,6OON,7KX7,7SWF,A0A163JTZ6,J9D5G4,A8BCK6,A2DPV7,A0A0G4H2S4,T1H8B3,S4RWI0,D2VMG4,A0A0D1ZAJ4,Q1K660,F4PH46,A0A3M7S814,A0A164ZA52,A0A383WDW5,Q54G64,S7WCF7,A0A2C5Z0M1,A0CB11,R9ACY5,D3BMP8,A0A1Z5TVE5,A0A1U7LLR0,A0A4S2MWZ7,K1VVQ6,A0A158P1R9,G7DVX0,V6R0U9,G4N9J3,E3KLI3,B7Q5I1,A0A1E3QC61,D5GGK8,S8ANP9,A0A139AUH8,L2GMR6,U4LBG4,A0A177URI1,O74957,A0A3N4IGK1,A6N7Y9,A0A0E9NDK5,T1KZ60,A0A250WXN5,A0A2G8JLH3,Q5KAT1,L2GUF2,W2T741,A0A1W0E4B5,A0A2J7QB22,S4RYE2,A0A2K3CW87,A0A388KES6,A0A226EFL3,A0A3S3PD82,A0A0L0TEV1,A0A1S3J512,G0QTT2,A0A1J1HRI1,C4V9J2,Q9JMB7,A0A075AN09,Q5TW24,U5HIG6,A0A401PRI6,Q96J94,A0A2B4RHN2,G2QEV0,A0A397UU01,A0A2T7PFL8,K7ISV0,A0A024FT57,H3HCL6,A0A0G4IME3,E9FUN9,A0A1S3CYL5,D7FQK3,A0A1Y1YHC8,T1GSU4,F4S231,A0A1D8PMK0,A0A2G5B1D8,Q5BD61,A0A1C7M8P2,A0A4D8YSQ3,A0A158PJG6,J9JZ66,A0A0C2XG51,A0A158QZT6,A0A165QYQ9,T0SAU8,R7YY92,A0A3S1A0C3,A0A074YJ47,A0A2K1J482,A0A1Q3ENA6,O04379,A0A371I3C8,M8AEW7,A8P0D4,A0A2K3NY65,F4NYW7,A0A409Y6G2,A0A0L0HAB7,D8PZT7,A0A1D1W4K0,A7RQ46,W4YU94,A7BJS5,D8SNM6,A0A1J8PPA3,X1WG39,M5FQK2,Q69VD5,A0A2R6NSC2,A0A0D8XL16,A0A016WPN3,Q9QZ81,G5EES3,A0A0K0EFP6,Q8CJG0,A0A1D5NTU6,V2WTL2,A0A0V0YLH8,A0A139WDH0,A0A0R3W9Q7,H3DS31,A0A1Y1HWP2,G4T5G9,B7QCC4,A0A0B2UV00,M7BCJ9,E9GN30,Q7PZ41,A0A077Z361,R7U9I3,A0A1X7V1N5,A0A0K0JDP1,A0A0N4UKJ1,A0A498N3A3,A0A3M0IQP5,A0A0L8GBV4,Q32KD4,A0A1J1JBJ0,E0W4C3,A0A482XDA9,A0A3P7EJD6,J9K2Z4,A0A2J7Q8V4,T1IBM6,V3ZRX0,A0A210QKF7,A0A423TSS1,K1PT78,A0A267E8R7,A0A1D2N447,A0A226D7A9,F6YK55,T1KTE4,A0A2C9JGZ6,A0A1V9X9F0,K5X5Z7,A0A3Q0KUG5,T1FY40,1YVU,1Z26,3DLB,5AWH,5G5T,6QZK,E8N0K8,A0A328VKE4,K9TPA9,A0A142XB92,B1XJG0,H1KXR6,A0A1Q4R485,K9U8J6,A0A097QRL6,K9RC91,A0A0D8ZUC0,A0A139XGN8,A0A1T4Y3A2,B6YTQ5,A0YYT3,A0A2T1EFY0,G6FTN0,A0A433NB65,A0A1Z4L0A1,K9UQR0,A0A2T1G8M7,K9VUN0,K9ZDE3,B0JXD6,A0A2T1LS63,A0A1Z4K1Y3,A0A0P4UVI8,A0A0V7ZCG4,A0A1J0AGK2,K9PFF9,A0A2G9DT08,K9UEV4,Q9L1X1,A0A496APJ8,A0A1V9G9U4,S7VLM7,A0A1A5X8H4,A0A1I2T6Q1,A0A1R3T9N6,A0A0Q2M2Z1,H8KXJ0,D3S0S6,A0A2D1U4H7,I3TE64,A0A0B7I4Z6,A0LL61,Q8DKB1,A0A139WY18,A0A1J1EK56,A0A2T1E1K4,A0A1Q8ZD62,A0A4Q6XKV6,A0A1Z3HNN4,A0A239JE83,A0A2N4XBY2,Q53W94,R5JEI2,A0A0Q0ZC47,A0A2T0XH18,A0A1V4CHV0,A0A1K1RQP7,A0A2T1EKT1,A0A1N6LUI7,A0A0P0NGR6,A0A1X7IML5,A0A0A2LKJ7,K1L112,A0A0U3AL92,A0A1H3A054,E0UCX3,K9XZC6,A0A0C1VHB4,Q31N05,A0A0C5JKF3,R5NJJ8,A5D4D9,Q2JI93,A0A142Y7A9,A0A432MEQ5,A0A372DKU2,A0A3R7KLK4,C1F5Q7,A0A4R3EV39,A0A1P8WP90,A0A222F7P0,A0A1C9VH88,A0A2T2YMB1,A0A329TD61,A0A101R2A0,A0A1U9ND56,A0A4R7BQC4,A0A1H3DGN3,A0A1Q1FPH0,E0TGY3,A0A259TUP4,F6EYI8,A0A2S9Q9J0,A0A4Q2UIU6,A0A1H0LH25,A0A318LG42,A0A345E7N0,A0A1W2A082,A0A1H3X247,A0A0C1XUA0,M0D2X3,A0A2R5G167,A0A346PK63,R7RTW6,A0A1H2RBI2,B9LVP8,M5RSF0,B7K585,A0A343TL88,A0A343JEE2,A0A3P3RGE5,A0A329TBQ3,A0A0W1S8B8,L9VRQ2,E4NRV1,A0A1I6HGN0,,",366,37
"766","N.H4.4","N.H4.8",284,171,113,3.04732701961393,"4F1N,4F3T,4KRE,5GUH,5VM9,6KR6,6OON,7KX7,7SWF,A0A163JTZ6,J9D5G4,Q389P5,A0A0G4H2S4,T1H8B3,S4RWI0,D2VMG4,A0A0D1ZAJ4,Q1K660,F4PH46,A0A3M7S814,A0A164ZA52,A0A383WDW5,Q54G64,S7WCF7,I0YVB2,A0A2C5Z0M1,A0CB11,R9ACY5,D3BMP8,A0A1Z5TVE5,A0A1U7LLR0,A0A4S2MWZ7,K1VVQ6,A0A158P1R9,G7DVX0,V6R0U9,G4N9J3,E3KLI3,B7Q5I1,A0A1E3QC61,D5GGK8,S8ANP9,A0A139AUH8,L2GMR6,U4LBG4,A0A177URI1,O74957,A0A3N4IGK1,A6N7Y9,A0A0E9NDK5,T1KZ60,A0A250WXN5,A0A2G8JLH3,L2GUF2,W2T741,A0A1W0E4B5,A0A2J7QB22,S4RYE2,A0A2K3CW87,A0A388KES6,A0A226EFL3,A0A3S3PD82,A0A0L0TEV1,A0A1S3J512,G0QTT2,A0A1J1HRI1,C4V9J2,Q9JMB7,A0A075AN09,Q5TW24,U5HIG6,A0A401PRI6,Q96J94,A0A2B4RHN2,G2QEV0,A0A397UU01,A0A2T7PFL8,K7ISV0,A0A024FT57,H3HCL6,A0A0G4IME3,E9FUN9,A0A1S3CYL5,D7FQK3,A0A1Y1YHC8,T1GSU4,F4S231,A0A1D8PMK0,A0A2G5B1D8,Q5BD61,A0A1C7M8P2,A0A4D8YSQ3,A0A158PJG6,J9JZ66,A0A0C2XG51,A0A158QZT6,A0A165QYQ9,T0SAU8,R7YY92,A0A3S1A0C3,A0A074YJ47,A0A2K1J482,A0A1Q3ENA6,O04379,A0A371I3C8,M8AEW7,A8P0D4,A0A2K3NY65,F4NYW7,A0A409Y6G2,A0A0L0HAB7,D8PZT7,A0A1D1W4K0,A7RQ46,W4YU94,A7BJS5,D8SNM6,A0A1J8PPA3,X1WG39,M5FQK2,Q69VD5,A0A2R6NSC2,A0A0D8XL16,A0A016WPN3,Q9QZ81,G5EES3,A0A0K0EFP6,Q8CJG0,A0A1D5NTU6,V2WTL2,A0A0V0YLH8,A0A139WDH0,A0A0R3W9Q7,H3DS31,A0A1Y1HWP2,G4T5G9,B7QCC4,A0A0B2UV00,M7BCJ9,E9GN30,Q7PZ41,A0A077Z361,R7U9I3,A0A1X7V1N5,A0A0K0JDP1,A0A0N4UKJ1,A0A498N3A3,A0A3M0IQP5,A0A0L8GBV4,Q32KD4,A0A1J1JBJ0,E0W4C3,A0A482XDA9,A0A3P7EJD6,J9K2Z4,A0A2J7Q8V4,T1IBM6,V3ZRX0,A0A210QKF7,A0A423TSS1,K1PT78,A0A267E8R7,A0A1D2N447,A0A226D7A9,F6YK55,T1KTE4,A0A2C9JGZ6,A0A1V9X9F0,K5X5Z7,A0A3Q0KUG5,T1FY40,1YVU,3DLB,5AWH,6QZK,E8N0K8,A0A328VKE4,K9TPA9,A0A142XB92,B1XJG0,H1KXR6,K9U8J6,K9RC91,A0A0D8ZUC0,A0A139XGN8,A0A1T4Y3A2,A0YYT3,A0A2T1EFY0,G6FTN0,A0A433NB65,A0A1Z4L0A1,K9UQR0,A0A2T1G8M7,K9VUN0,K9ZDE3,B0JXD6,A0A2T1LS63,A0A1Z4K1Y3,A0A0P4UVI8,A0A0V7ZCG4,A0A1J0AGK2,K9PFF9,A0A2G9DT08,K9UEV4,Q9L1X1,A0A1V9G9U4,S7VLM7,A0A1A5X8H4,A0A1I2T6Q1,A0A1R3T9N6,H8KXJ0,A0A2D1U4H7,A0A0B7I4Z6,A0LL61,Q8DKB1,A0A1J1EK56,A0A2T1E1K4,A0A1Q8ZD62,A0A4Q6XKV6,A0A1Z3HNN4,A0A239JE83,A0A2N4XBY2,Q53W94,R5JEI2,A0A0Q0ZC47,A0A2T0XH18,A0A1V4CHV0,A0A1K1RQP7,A0A2T1EKT1,A0A1N6LUI7,A0A0P0NGR6,A0A1X7IML5,A0A0A2LKJ7,K1L112,A0A0U3AL92,A0A1H3A054,E0UCX3,K9XZC6,A0A0C1VHB4,Q31N05,A0A0C5JKF3,R5NJJ8,A5D4D9,Q2JI93,A0A142Y7A9,A0A432MEQ5,A0A372DKU2,A0A3R7KLK4,C1F5Q7,A0A4R3EV39,A0A1P8WP90,A0A222F7P0,A0A1C9VH88,A0A2T2YMB1,A0A329TD61,A0A101R2A0,A0A1U9ND56,A0A4R7BQC4,A0A1H3DGN3,A0A1Q1FPH0,E0TGY3,A0A259TUP4,F6EYI8,A0A2S9Q9J0,A0A4Q2UIU6,A0A1H0LH25,A0A318LG42,A0A345E7N0,A0A1H3X247,M0D2X3,A0A2R5G167,A0A346PK63,R7RTW6,B9LVP8,M5RSF0,B7K585,A0A343TL88,A0A343JEE2,A0A3P3RGE5,A0A329TBQ3,A0A0W1S8B8,L9VRQ2,E4NRV1,A0A1I6HGN0,,",366,37
"769","N.H6.4","N.H6.8",227,171,56,5.83824143692565,"4F1N,4F3T,4KRE,5GUH,5VM9,6KR6,6OON,7KX7,A0A163JTZ6,A0A0N4X8S8,J9D5G4,Q389P5,C4LVV2,A0A2P6N8X7,A2DPV7,T1H8B3,R1FDF0,S4RWI0,D2VMG4,A0A074TLL7,A0A0D1ZAJ4,Q1K660,F4PH46,A0A3M7S814,A0A164ZA52,A0A383WDW5,Q54G64,S7WCF7,I0YVB2,R7QGN7,A0A2C5Z0M1,A0CB11,R9ACY5,D3BMP8,A0A1Z5TVE5,A0A1U7LLR0,A0A4S2MWZ7,K1VVQ6,A0A158P1R9,G7DVX0,V6R0U9,G4N9J3,E3KLI3,A0A1E3QC61,D5GGK8,S8ANP9,A0A139AUH8,L2GMR6,U4LBG4,A0A177URI1,O74957,A0A3N4IGK1,A6N7Y9,A0A0E9NDK5,T1KZ60,A0A250WXN5,A0A2G8JLH3,Q5KAT1,L2GUF2,W2T741,A0A1W0E4B5,A0A2J7QB22,S4RYE2,A0A2K3CW87,A0A388KES6,A0A226EFL3,A0A3S3PD82,A0A0L0TEV1,A0A1S3J512,A0A1J1HRI1,C4V9J2,Q9JMB7,A0A075AN09,Q5TW24,U5HIG6,A0A401PRI6,Q96J94,A0A2B4RHN2,G2QEV0,A0A397UU01,A0A2T7PFL8,K7ISV0,A0A024FT57,H3HCL6,A0A0G4IME3,E9FUN9,A0A1S3CYL5,D7FQK3,A0A1Y1YHC8,T1GSU4,F4S231,A0A1D8PMK0,A0A2G5B1D8,Q5BD61,A0A1C7M8P2,A0A4D8YSQ3,A0A158PJG6,J9JZ66,A0A158QZT6,T0SAU8,R7YY92,A0A3S1A0C3,A0A074YJ47,A0A2K1J482,A0A1Q3ENA6,O04379,A0A371I3C8,M8AEW7,A8P0D4,A0A2K3NY65,F4NYW7,A0A0L0HAB7,D8PZT7,A0A1D1W4K0,A7RQ46,A7BJS5,D8SNM6,A0A1J8PPA3,X1WG39,M5FQK2,Q69VD5,A0A2R6NSC2,A0A0D8XL16,A0A016WPN3,Q9QZ81,G5EES3,A0A0K0EFP6,Q8CJG0,A0A1D5NTU6,V2WTL2,A0A0V0YLH8,A0A139WDH0,A0A0R3W9Q7,H3DS31,A0A1Y1HWP2,G4T5G9,B7QCC4,A0A0B2UV00,M7BCJ9,E9GN30,Q7PZ41,A0A077Z361,R7U9I3,A0A1X7V1N5,A0A0K0JDP1,A0A0N4UKJ1,A0A498N3A3,A0A3M0IQP5,A0A0L8GBV4,Q32KD4,A0A1J1JBJ0,E0W4C3,A0A482XDA9,A0A3P7EJD6,J9K2Z4,A0A2J7Q8V4,T1IBM6,V3ZRX0,A0A210QKF7,A0A423TSS1,K1PT78,A0A267E8R7,A0A1D2N447,A0A226D7A9,F6YK55,T1KTE4,A0A2C9JGZ6,A0A1V9X9F0,K5X5Z7,A0A3Q0KUG5,T1FY40,1Z26,3DLB,5G5T,6QZK,7R8K,C4L1M1,A0A0M2PXX3,A0A1I3LMA1,A0A1C0UUC4,B1XJG0,A0A097QRL6,B6YTQ5,A0A0B0H9B4,R6KUL9,B7GJX9,A0A1N6SSK9,A0A235B542,R5XQK4,A0A062U2W9,H0HWQ5,A0A1I2ZGP1,A0A317EJY3,A0A1I2BD20,F8ERC7,A0A0Q2M2Z1,D3S0S6,I3TE64,Q8DKB1,A0A1J1EK56,Q53W94,A0A2T1EKT1,E0UCX3,K9XZC6,Q31N05,Q2JI93,A0A3R7KLK4,A0A1E3XF49,A0A1H3DGN3,H1YCU5,L0JS08,A0A1Q5ZS75,M0AF24,A0A1W2A082,A0A0C1XUA0,M0D2X3,R7RTW6,A0A1H2RBI2,A0A1C3ZXN2,F8D8G0,A0A343TL88,A0A343JEE2,A0A3P3RGE5,A0A329TBQ3,L9VRQ2,E4NRV1,A0A1I6HGN0,,",366,37
"771","N.S12.1","N.S2.4",301,171,130,3.9895861448493,"4F1N,4F3T,4KRE,5GUH,5VM9,6KR6,6OON,7KX7,7SWF,Q389P5,C4LVV2,A0A2P6N8X7,A8BCK6,A0A0G4H2S4,T1H8B3,R1FDF0,S4RWI0,D2VMG4,A0A0D1ZAJ4,Q1K660,F4PH46,A0A164ZA52,A0A383WDW5,Q54G64,S7WCF7,R7QGN7,C1DZY0,A0A2C5Z0M1,A0CB11,R9ACY5,D3BMP8,A0A1Z5TVE5,W7XD45,A0A4S2MWZ7,K1VVQ6,A0A158P1R9,G7DVX0,V6R0U9,G4N9J3,E3KLI3,B7Q5I1,A0A1E3QC61,D5GGK8,S8ANP9,A0A139AUH8,L2GMR6,U4LBG4,O74957,A0A3N4IGK1,A6N7Y9,A0A0E9NDK5,T1KZ60,A0A250WXN5,A0A2G8JLH3,Q5KAT1,L2GUF2,A0A1W0E4B5,A0A2J7QB22,S4RYE2,A0A2K3CW87,A0A388KES6,A0A226EFL3,A0A3S3PD82,A0A0L0TEV1,A0A1S3J512,G0QTT2,A0A1J1HRI1,C4V9J2,Q9JMB7,A0A075AN09,Q5TW24,U5HIG6,A0A401PRI6,Q96J94,A0A2B4RHN2,G2QEV0,A0A397UU01,A0A2T7PFL8,K7ISV0,A0A024FT57,H3HCL6,A0A0G4IME3,E9FUN9,A0A1S3CYL5,D7FQK3,A0A1Y1YHC8,T1GSU4,F4S231,A0A1D8PMK0,A0A2G5B1D8,Q5BD61,A0A1C7M8P2,A0A4D8YSQ3,A0A158PJG6,J9JZ66,A0A158QZT6,A0A165QYQ9,T0SAU8,R7YY92,A0A3S1A0C3,A0A074YJ47,A0A2K1J482,A0A1Q3ENA6,O04379,A0A371I3C8,M8AEW7,A8P0D4,A0A2K3NY65,F4NYW7,A0A409Y6G2,A0A0L0HAB7,D8PZT7,A0A1D1W4K0,A7RQ46,W4YU94,A7BJS5,D8SNM6,A0A1J8PPA3,X1WG39,M5FQK2,Q69VD5,A0A2R6NSC2,A0A0D8XL16,A0A016WPN3,Q9QZ81,G5EES3,A0A0K0EFP6,Q8CJG0,A0A1D5NTU6,V2WTL2,A0A0V0YLH8,A0A139WDH0,A0A0R3W9Q7,H3DS31,A0A1Y1HWP2,G4T5G9,B7QCC4,A0A0B2UV00,M7BCJ9,E9GN30,Q7PZ41,A0A077Z361,R7U9I3,A0A1X7V1N5,A0A0K0JDP1,A0A0N4UKJ1,A0A498N3A3,A0A3M0IQP5,A0A0L8GBV4,Q32KD4,A0A1J1JBJ0,E0W4C3,A0A482XDA9,A0A3P7EJD6,J9K2Z4,A0A2J7Q8V4,T1IBM6,V3ZRX0,A0A210QKF7,A0A423TSS1,K1PT78,A0A267E8R7,A0A1D2N447,A0A226D7A9,F6YK55,T1KTE4,A0A2C9JGZ6,A0A1V9X9F0,K5X5Z7,A0A3Q0KUG5,T1FY40,1YVU,1Z26,3DLB,5AWH,5G5T,5I4A,6QZK,7R8K,A0A1I3LMA1,A0A326U7G5,A0A3D8L290,A0A1Q4R485,K9U8J6,K9RC91,A0A0D8ZUC0,A0A139XGN8,A0A0B0H9B4,A0YYT3,A0A2T1EFY0,G6FTN0,R6KUL9,A0A433NB65,A0A1Z4L0A1,K9UQR0,A0A2T1G8M7,K9VUN0,B7GJX9,K9ZDE3,B0JXD6,A0A2T1LS63,A0A1Z4K1Y3,A0A1N6SSK9,A0A0P4UVI8,A0A0V7ZCG4,A0A1J0AGK2,K9PFF9,K9UEV4,A0A060HNJ0,A0A235B542,R5XQK4,H0HWQ5,A0A317EJY3,A0A1I2BD20,F8ERC7,S7VLM7,A0A0Q2M2Z1,H8KXJ0,D3S0S6,A0A2D1U4H7,A0A0B7I4Z6,A0LL61,Q8DKB1,A0A1J1EK56,A0A4Q6XKV6,A0A239JE83,A0A2N4XBY2,Q53W94,R5JEI2,A0A0Q0ZC47,A0A2T0XH18,A0A1V4CHV0,A0A1K1RQP7,A0A2T1EKT1,A0A1N6LUI7,A0A0P0NGR6,A0A1X7IML5,A0A0A2LKJ7,K1L112,A0A0U3AL92,A0A1H3A054,E0UCX3,K9XZC6,A0A0C1VHB4,Q31N05,A0A0C5JKF3,R5NJJ8,A5D4D9,Q2JI93,A0A142Y7A9,A0A372DKU2,A0A3R7KLK4,C1F5Q7,A0A4R3EV39,A0A1P8WP90,A0A222F7P0,A0A1C9VH88,A0A329TD61,A0A101R2A0,A0A1E3XF49,A0A1U9ND56,A0A4R7BQC4,A0A1H3DGN3,A0A1Q1FPH0,E0TGY3,A0A259TUP4,F6EYI8,A0A2S9Q9J0,A0A4Q2UIU6,A0A1H0LH25,A0A318LG42,H1YCU5,L0JS08,A0A1Q5ZS75,A0A345E7N0,M0AF24,A0A1H3X247,A0A0C1XUA0,M0D2X3,A0A2R5G167,A0A346PK63,R7RTW6,A0A1C3ZXN2,B9LVP8,M5RSF0,W0JW77,B7K585,F8D8G0,A0A343TL88,L0AJX6,A0A2A5QS34,A0A343JEE2,A0A3P3RGE5,A0A329TBQ3,A0A285N2A8,A0A0W1S8B8,A0A1V4C8L7,L9VRQ2,E4NRV1,A0A1I6HGN0,A0A1I0NI68,,",366,37
"773","N.S12.3","N.S2.1",293,171,122,1.9918272457099,"4F1N,4F3T,4KRE,5GUH,6KR6,6OON,7KX7,Q389P5,C4LVV2,A0A2P6N8X7,A8BCK6,A2DPV7,T1H8B3,R1FDF0,S4RWI0,D2VMG4,A0A0D1ZAJ4,Q1K660,F4PH46,A0A164ZA52,A0A383WDW5,S7WCF7,R7QGN7,C1DZY0,A0A2C5Z0M1,A0CB11,R9ACY5,D3BMP8,A0A1Z5TVE5,W7XD45,A0A1U7LLR0,A0A4S2MWZ7,K1VVQ6,A0A158P1R9,G7DVX0,V6R0U9,G4N9J3,E3KLI3,B7Q5I1,A0A1E3QC61,D5GGK8,S8ANP9,A0A139AUH8,L2GMR6,U4LBG4,A0A177URI1,O74957,A0A3N4IGK1,A6N7Y9,A0A0E9NDK5,T1KZ60,A0A250WXN5,A0A2G8JLH3,Q5KAT1,L2GUF2,A0A1W0E4B5,A0A2J7QB22,S4RYE2,A0A2K3CW87,A0A388KES6,A0A226EFL3,A0A3S3PD82,A0A0L0TEV1,A0A1S3J512,G0QTT2,A0A1J1HRI1,C4V9J2,Q9JMB7,A0A075AN09,Q5TW24,U5HIG6,A0A401PRI6,Q96J94,A0A2B4RHN2,G2QEV0,A0A397UU01,A0A2T7PFL8,K7ISV0,A0A024FT57,H3HCL6,A0A0G4IME3,E9FUN9,A0A1S3CYL5,D7FQK3,A0A1Y1YHC8,T1GSU4,F4S231,A0A1D8PMK0,A0A2G5B1D8,Q5BD61,A0A1C7M8P2,A0A4D8YSQ3,A0A158PJG6,J9JZ66,A0A0C2XG51,A0A158QZT6,A0A165QYQ9,T0SAU8,R7YY92,A0A3S1A0C3,A0A074YJ47,A0A2K1J482,A0A1Q3ENA6,O04379,A0A371I3C8,M8AEW7,A8P0D4,A0A2K3NY65,F4NYW7,A0A409Y6G2,A0A0L0HAB7,D8PZT7,A0A1D1W4K0,A7RQ46,W4YU94,A7BJS5,D8SNM6,A0A1J8PPA3,X1WG39,M5FQK2,Q69VD5,A0A2R6NSC2,A0A0D8XL16,A0A016WPN3,Q9QZ81,G5EES3,A0A0K0EFP6,Q8CJG0,A0A1D5NTU6,V2WTL2,A0A0V0YLH8,A0A139WDH0,A0A0R3W9Q7,H3DS31,A0A1Y1HWP2,G4T5G9,B7QCC4,A0A0B2UV00,M7BCJ9,E9GN30,Q7PZ41,A0A077Z361,R7U9I3,A0A1X7V1N5,A0A0K0JDP1,A0A0N4UKJ1,A0A498N3A3,A0A3M0IQP5,A0A0L8GBV4,Q32KD4,A0A1J1JBJ0,E0W4C3,A0A482XDA9,A0A3P7EJD6,J9K2Z4,A0A2J7Q8V4,T1IBM6,V3ZRX0,A0A210QKF7,A0A423TSS1,K1PT78,A0A267E8R7,A0A1D2N447,A0A226D7A9,F6YK55,T1KTE4,A0A2C9JGZ6,A0A1V9X9F0,K5X5Z7,A0A3Q0KUG5,T1FY40,1YVU,1Z26,3DLB,5AWH,5G5T,5I4A,6QZK,7R8K,A0A1W6MIP2,A0A326U7G5,A0A3D8L290,A0A1Q4R485,K9U8J6,A0A139XGN8,A0YYT3,A0A2T1EFY0,G6FTN0,A0A433NB65,A0A1Z4L0A1,K9UQR0,A0A2T1G8M7,K9VUN0,K9ZDE3,B0JXD6,A0A2T1LS63,A0A1Z4K1Y3,A0A0P4UVI8,A0A0V7ZCG4,A0A1J0AGK2,K9PFF9,K9UEV4,H0HWQ5,A0A317EJY3,A0A1I2BD20,F8ERC7,S7VLM7,A0A0Q2M2Z1,H8KXJ0,D3S0S6,A0A2D1U4H7,A0A0B7I4Z6,A0LL61,Q8DKB1,A0A1J1EK56,A0A4Q6XKV6,A0A239JE83,A0A2N4XBY2,Q53W94,R5JEI2,A0A0Q0ZC47,A0A2T0XH18,A0A1V4CHV0,A0A1K1RQP7,A0A2T1EKT1,A0A1N6LUI7,A0A0P0NGR6,A0A1X7IML5,A0A0A2LKJ7,K1L112,A0A0U3AL92,A0A1H3A054,E0UCX3,K9XZC6,A0A0C1VHB4,Q31N05,A0A0C5JKF3,R5NJJ8,A5D4D9,Q2JI93,A0A142Y7A9,A0A372DKU2,A0A3R7KLK4,C1F5Q7,A0A4R3EV39,A0A1P8WP90,A0A222F7P0,A0A1C9VH88,A0A2T2YMB1,A0A329TD61,A0A101R2A0,A0A1E3XF49,A0A1U9ND56,A0A4R7BQC4,A0A1H3DGN3,A0A1Q1FPH0,E0TGY3,A0A259TUP4,F6EYI8,A0A2S9Q9J0,A0A4Q2UIU6,A0A1H0LH25,A0A318LG42,H1YCU5,L0JS08,A0A1Q5ZS75,A0A345E7N0,M0AF24,A0A1H3X247,A0A0C1XUA0,M0D2X3,A0A2R5G167,A0A346PK63,R7RTW6,A0A1C3ZXN2,B9LVP8,M5RSF0,W0JW77,B7K585,F8D8G0,A0A343TL88,L0AJX6,A0A2A5QS34,A0A343JEE2,A0A3P3RGE5,A0A329TBQ3,A0A285N2A8,A0A0W1S8B8,A0A1V4C8L7,L9VRQ2,E4NRV1,A0A1I6HGN0,A0A1I0NI68,,",366,37
"779","C.H10.6","C.L25.4",272,172,100,2.75813953488372,"4F1N,4F3T,4KRE,5GUH,5VM9,6KR6,6OON,7KX7,7SWF,A0A163JTZ6,J9D5G4,A0A0G4H2S4,D2VMG4,A0A074TLL7,A0A0D1ZAJ4,Q1K660,F4PH46,A0A3M7S814,A0A164ZA52,A0A383WDW5,S7WCF7,I0YVB2,R7QGN7,C1DZY0,A0A2C5Z0M1,A0CB11,R9ACY5,D3BMP8,A0A1Z5TVE5,W7XD45,A0A1U7LLR0,A0A4S2MWZ7,K1VVQ6,A0A158P1R9,G7DVX0,V6R0U9,G4N9J3,E3KLI3,B7Q5I1,A0A1E3QC61,D5GGK8,S8ANP9,A0A139AUH8,L2GMR6,U4LBG4,A0A177URI1,O74957,A0A3N4IGK1,A6N7Y9,A0A0E9NDK5,T1KZ60,A0A250WXN5,A0A2G8JLH3,Q5KAT1,L2GUF2,W2T741,A0A1W0E4B5,A0A2J7QB22,S4RYE2,A0A2K3CW87,A0A388KES6,A0A226EFL3,A0A3S3PD82,A0A0L0TEV1,A0A1S3J512,G0QTT2,A0A1J1HRI1,C4V9J2,Q9JMB7,A0A075AN09,Q5TW24,U5HIG6,A0A401PRI6,Q96J94,A0A2B4RHN2,G2QEV0,A0A397UU01,A0A2T7PFL8,K7ISV0,A0A024FT57,H3HCL6,A0A0G4IME3,E9FUN9,A0A1S3CYL5,D7FQK3,A0A1Y1YHC8,T1GSU4,F4S231,A0A1D8PMK0,A0A2G5B1D8,Q5BD61,A0A1C7M8P2,A0A4D8YSQ3,A0A158PJG6,J9JZ66,A0A0C2XG51,A0A158QZT6,A0A165QYQ9,T0SAU8,R7YY92,A0A3S1A0C3,A0A074YJ47,A0A2K1J482,A0A1Q3ENA6,O04379,A0A371I3C8,M8AEW7,A8P0D4,A0A2K3NY65,F4NYW7,A0A409Y6G2,A0A0L0HAB7,D8PZT7,A0A1D1W4K0,A7RQ46,W4YU94,A7BJS5,D8SNM6,A0A1J8PPA3,X1WG39,M5FQK2,Q69VD5,A0A2R6NSC2,A0A0D8XL16,A0A016WPN3,Q9QZ81,G5EES3,A0A0K0EFP6,Q8CJG0,A0A1D5NTU6,V2WTL2,A0A0V0YLH8,A0A139WDH0,A0A0R3W9Q7,H3DS31,A0A1Y1HWP2,G4T5G9,B7QCC4,A0A0B2UV00,M7BCJ9,E9GN30,Q7PZ41,A0A077Z361,R7U9I3,A0A1X7V1N5,A0A0K0JDP1,A0A0N4UKJ1,A0A498N3A3,A0A3M0IQP5,A0A0L8GBV4,Q32KD4,A0A1J1JBJ0,E0W4C3,A0A482XDA9,A0A3P7EJD6,J9K2Z4,A0A2J7Q8V4,T1IBM6,V3ZRX0,A0A210QKF7,A0A423TSS1,K1PT78,A0A267E8R7,A0A1D2N447,A0A226D7A9,F6YK55,T1KTE4,A0A2C9JGZ6,A0A1V9X9F0,K5X5Z7,A0A3Q0KUG5,T1FY40,1Z26,5AWH,5G5T,6QZK,A0A1I7IXT4,A0A2W1JZ37,A0A2S7WBN3,A0A420DFE6,E0ST67,A0A4V1VDY2,A0A368P5I0,C4L1M1,A0A4R1RMM2,A0A1Y2RDH8,Q11QW7,A0A1M5ZSR3,A0A0K8QX04,A0A0M2PXX3,A0A1L3JHM3,A0A1W6MIP2,A0A1C0UUC4,A0A2U2J9E0,A0A1T4Y3A2,A0A0B0H9B4,R6KUL9,B7GJX9,A0A1N6SSK9,A0A2G9DT08,Q9L1X1,A0A235B542,R5XQK4,A0A1H3LE92,A0A496APJ8,A0A1V9G9U4,A0A1A5X8H4,A0A1I2T6Q1,A0A1R3T9N6,H8KXJ0,A0A2D1U4H7,A0A0B7I4Z6,A0LL61,A0A139WY18,A0A2T1E1K4,A0A1Q8ZD62,A0A4Q6XKV6,A0A1Z3HNN4,A0A239JE83,A0A2N4XBY2,R5JEI2,A0A0Q0ZC47,A0A2T0XH18,A0A1V4CHV0,A0A1K1RQP7,A0A1N6LUI7,A0A0P0NGR6,A0A1X7IML5,A0A0A2LKJ7,K1L112,A0A0U3AL92,A0A1H3A054,A0A0C5JKF3,R5NJJ8,A5D4D9,A0A142Y7A9,A0A432MEQ5,A0A372DKU2,C1F5Q7,A0A4R3EV39,A0A1P8WP90,A0A222F7P0,A0A1C9VH88,A0A2T2YMB1,A0A101R2A0,A0A1U9ND56,A0A4R7BQC4,E0TGY3,A0A259TUP4,F6EYI8,A0A2S9Q9J0,A0A4Q2UIU6,A0A1H0LH25,A0A318LG42,L0JS08,M0AF24,A0A0C1XUA0,M0D2X3,A0A2R5G167,A0A346PK63,R7RTW6,M5RSF0,W0JW77,B7K585,F8D8G0,A0A343TL88,L0AJX6,A0A2A5QS34,A0A343JEE2,A0A285N2A8,E4NRV1,A0A1I0NI68,,",366,37
"780","C.H4.1","C.S5.6",321,172,149,2.59909083814578,"4F1N,4F3T,4KRE,5GUH,5VM9,6KR6,6OON,7KX7,7SWF,A0A163JTZ6,J9D5G4,C4LVV2,A2DPV7,A0A0G4H2S4,T1H8B3,S4RWI0,D2VMG4,A0A074TLL7,A0A0D1ZAJ4,Q1K660,F4PH46,A0A3M7S814,A0A164ZA52,A0A383WDW5,Q54G64,S7WCF7,I0YVB2,R7QGN7,C1DZY0,A0A2C5Z0M1,A0CB11,R9ACY5,A0A1Z5TVE5,A0A1U7LLR0,A0A4S2MWZ7,K1VVQ6,A0A158P1R9,G7DVX0,V6R0U9,G4N9J3,E3KLI3,B7Q5I1,A0A1E3QC61,D5GGK8,S8ANP9,A0A139AUH8,L2GMR6,U4LBG4,A0A177URI1,O74957,A0A3N4IGK1,A6N7Y9,A0A0E9NDK5,T1KZ60,A0A250WXN5,A0A2G8JLH3,Q5KAT1,L2GUF2,W2T741,A0A1W0E4B5,A0A2J7QB22,S4RYE2,A0A2K3CW87,A0A388KES6,A0A226EFL3,A0A3S3PD82,A0A0L0TEV1,A0A1S3J512,A0A1J1HRI1,C4V9J2,Q9JMB7,A0A075AN09,Q5TW24,U5HIG6,A0A401PRI6,Q96J94,A0A2B4RHN2,G2QEV0,A0A397UU01,A0A2T7PFL8,K7ISV0,A0A024FT57,H3HCL6,A0A0G4IME3,A0A1S3CYL5,D7FQK3,A0A1Y1YHC8,F4S231,A0A1D8PMK0,A0A2G5B1D8,Q5BD61,A0A1C7M8P2,A0A4D8YSQ3,A0A158PJG6,J9JZ66,A0A0C2XG51,A0A158QZT6,A0A165QYQ9,T0SAU8,R7YY92,A0A3S1A0C3,A0A074YJ47,A0A2K1J482,A0A1Q3ENA6,O04379,A0A371I3C8,M8AEW7,A8P0D4,A0A2K3NY65,F4NYW7,A0A409Y6G2,A0A0L0HAB7,D8PZT7,A0A1D1W4K0,A7RQ46,W4YU94,A7BJS5,D8SNM6,A0A1J8PPA3,X1WG39,M5FQK2,Q69VD5,A0A2R6NSC2,A0A0D8XL16,A0A016WPN3,Q9QZ81,G5EES3,A0A0K0EFP6,Q8CJG0,A0A1D5NTU6,V2WTL2,A0A0V0YLH8,A0A139WDH0,A0A0R3W9Q7,H3DS31,A0A1Y1HWP2,G4T5G9,B7QCC4,A0A0B2UV00,M7BCJ9,E9GN30,Q7PZ41,A0A077Z361,R7U9I3,A0A1X7V1N5,A0A0K0JDP1,A0A0N4UKJ1,A0A498N3A3,A0A3M0IQP5,A0A0L8GBV4,Q32KD4,A0A1J1JBJ0,E0W4C3,A0A482XDA9,A0A3P7EJD6,J9K2Z4,A0A2J7Q8V4,T1IBM6,V3ZRX0,A0A210QKF7,A0A423TSS1,K1PT78,A0A267E8R7,A0A1D2N447,A0A226D7A9,F6YK55,T1KTE4,A0A2C9JGZ6,A0A1V9X9F0,K5X5Z7,A0A3Q0KUG5,T1FY40,1YVU,1Z26,3DLB,5AWH,5G5T,5I4A,6QZK,7R8K,E8N0K8,A0A328VKE4,E0ST67,A0A4R1RMM2,A0A1Y2RDH8,Q11QW7,A0A1M5ZSR3,A0A1I3LMA1,K9TPA9,A0A1L3JHM3,A0A2U2J9E0,A0A2Z6E1D5,A0A0F4NXW8,L8D0R3,B1XJG0,A0A326U7G5,A0A3D8L290,A0A1Q4R485,K9U8J6,K9RC91,A0A0D8ZUC0,A0A139XGN8,A0A1T4Y3A2,Q5P0R2,A0YYT3,A0A2T1EFY0,G6FTN0,R6KUL9,A0A433NB65,A0A1Z4L0A1,K9UQR0,A0A2T1G8M7,K9VUN0,A0A0P6X5X2,K9ZDE3,B0JXD6,A0A2T1LS63,A0A1Z4K1Y3,A0A2Z6E0R7,A0A0P4UVI8,A0A0V7ZCG4,A0A1J0AGK2,K9PFF9,A0A2G9DT08,K9UEV4,Q9L1X1,A0A060HNJ0,A0A235B542,R5XQK4,A0A1H3LE92,A0A062U2W9,H0HWQ5,A0A1I2ZGP1,A0A317EJY3,A0A1I2BD20,F8ERC7,S7VLM7,A0A1A5X8H4,A0A1I2T6Q1,A0A1R3T9N6,A0A0Q2M2Z1,H8KXJ0,A0A0B7I4Z6,A0LL61,Q8DKB1,A0A1J1EK56,A0A4Q6XKV6,A0A239JE83,A0A2N4XBY2,Q53W94,R5JEI2,A0A0Q0ZC47,A0A2T0XH18,A0A1V4CHV0,A0A1K1RQP7,A0A2T1EKT1,A0A1N6LUI7,A0A0P0NGR6,A0A1X7IML5,A0A0A2LKJ7,K1L112,A0A0U3AL92,A0A1H3A054,E0UCX3,K9XZC6,A0A0C1VHB4,A0A0C5JKF3,R5NJJ8,A5D4D9,Q2JI93,A0A142Y7A9,A0A432MEQ5,A0A372DKU2,A0A3R7KLK4,C1F5Q7,A0A4R3EV39,A0A1P8WP90,A0A222F7P0,A0A1C9VH88,A0A2T2YMB1,A0A329TD61,A0A101R2A0,A0A1E3XF49,A0A1U9ND56,A0A4R7BQC4,A0A1H3DGN3,A0A1Q1FPH0,E0TGY3,A0A259TUP4,F6EYI8,A0A2S9Q9J0,A0A1H0LH25,A0A318LG42,H1YCU5,L0JS08,A0A1Q5ZS75,A0A345E7N0,M0AF24,A0A1W2A082,A0A1H3X247,A0A0C1XUA0,M0D2X3,A0A2R5G167,A0A346PK63,A0A1H2RBI2,A0A1C3ZXN2,B9LVP8,M5RSF0,W0JW77,B7K585,F8D8G0,L0AJX6,A0A2A5QS34,A0A343JEE2,A0A3P3RGE5,A0A329TBQ3,A0A285N2A8,A0A1V4C8L7,E4NRV1,A0A1I6HGN0,A0A1I0NI68,,",366,37
"784","C.H9.3","C.H9.7",335,172,163,2.99570195462976,"4F1N,4F3T,4KRE,5GUH,5VM9,6KR6,6OON,7KX7,7SWF,A0A163JTZ6,J9D5G4,Q389P5,A0A2P6N8X7,R1FDF0,D2VMG4,A0A074TLL7,A0A0D1ZAJ4,Q1K660,F4PH46,A0A3M7S814,A0A164ZA52,A0A383WDW5,Q54G64,I0YVB2,R7QGN7,C1DZY0,A0A2C5Z0M1,A0CB11,R9ACY5,D3BMP8,A0A1Z5TVE5,W7XD45,A0A1U7LLR0,A0A4S2MWZ7,K1VVQ6,A0A158P1R9,G7DVX0,V6R0U9,G4N9J3,E3KLI3,B7Q5I1,A0A1E3QC61,D5GGK8,S8ANP9,A0A139AUH8,L2GMR6,U4LBG4,A0A177URI1,O74957,A0A3N4IGK1,A6N7Y9,A0A0E9NDK5,T1KZ60,A0A250WXN5,A0A2G8JLH3,Q5KAT1,W2T741,A0A2J7QB22,S4RYE2,A0A2K3CW87,A0A388KES6,A0A226EFL3,A0A3S3PD82,A0A0L0TEV1,A0A1S3J512,G0QTT2,A0A1J1HRI1,C4V9J2,Q9JMB7,A0A075AN09,Q5TW24,U5HIG6,A0A401PRI6,Q96J94,A0A2B4RHN2,G2QEV0,A0A397UU01,A0A2T7PFL8,K7ISV0,A0A024FT57,H3HCL6,A0A0G4IME3,E9FUN9,A0A1S3CYL5,D7FQK3,A0A1Y1YHC8,T1GSU4,F4S231,A0A1D8PMK0,A0A2G5B1D8,Q5BD61,A0A1C7M8P2,A0A4D8YSQ3,A0A158PJG6,J9JZ66,A0A0C2XG51,A0A158QZT6,A0A165QYQ9,T0SAU8,R7YY92,A0A3S1A0C3,A0A074YJ47,A0A2K1J482,A0A1Q3ENA6,O04379,A0A371I3C8,M8AEW7,A8P0D4,A0A2K3NY65,F4NYW7,A0A409Y6G2,A0A0L0HAB7,D8PZT7,A0A1D1W4K0,A7RQ46,W4YU94,A7BJS5,D8SNM6,A0A1J8PPA3,X1WG39,M5FQK2,Q69VD5,A0A2R6NSC2,A0A0D8XL16,A0A016WPN3,Q9QZ81,G5EES3,A0A0K0EFP6,Q8CJG0,A0A1D5NTU6,V2WTL2,A0A0V0YLH8,A0A139WDH0,A0A0R3W9Q7,H3DS31,A0A1Y1HWP2,G4T5G9,B7QCC4,A0A0B2UV00,M7BCJ9,E9GN30,Q7PZ41,A0A077Z361,R7U9I3,A0A1X7V1N5,A0A0K0JDP1,A0A0N4UKJ1,A0A498N3A3,A0A3M0IQP5,A0A0L8GBV4,Q32KD4,A0A1J1JBJ0,E0W4C3,A0A482XDA9,A0A3P7EJD6,J9K2Z4,A0A2J7Q8V4,T1IBM6,V3ZRX0,A0A210QKF7,A0A423TSS1,K1PT78,A0A267E8R7,A0A1D2N447,A0A226D7A9,F6YK55,T1KTE4,A0A2C9JGZ6,A0A1V9X9F0,K5X5Z7,A0A3Q0KUG5,T1FY40,1YVU,1Z26,3DLB,5AWH,5G5T,5I4A,6QZK,7R8K,A0A328VKE4,E0ST67,C4L1M1,K9TPA9,A0A2Z6E1D5,A0A0F4NXW8,L8D0R3,B1XJG0,A0A326U7G5,A0A3D8L290,A0A1Q4R485,K9U8J6,A0A097QRL6,K9RC91,A0A0D8ZUC0,A0A139XGN8,A0A1T4Y3A2,Q5P0R2,B6YTQ5,A0A0B0H9B4,A0YYT3,A0A2T1EFY0,G6FTN0,R6KUL9,A0A433NB65,A0A1Z4L0A1,K9UQR0,A0A2T1G8M7,K9VUN0,B7GJX9,A0A0P6X5X2,K9ZDE3,B0JXD6,A0A2T1LS63,A0A1Z4K1Y3,A0A2Z6E0R7,A0A1N6SSK9,A0A0P4UVI8,A0A0V7ZCG4,A0A1J0AGK2,K9PFF9,A0A2G9DT08,K9UEV4,Q9L1X1,A0A060HNJ0,A0A235B542,R5XQK4,A0A1H3LE92,A0A496APJ8,A0A062U2W9,H0HWQ5,A0A1V9G9U4,A0A1I2ZGP1,A0A317EJY3,A0A1I2BD20,F8ERC7,S7VLM7,A0A1A5X8H4,A0A1I2T6Q1,A0A1R3T9N6,A0A0Q2M2Z1,H8KXJ0,D3S0S6,A0A2D1U4H7,I3TE64,A0A0B7I4Z6,A0LL61,Q8DKB1,A0A139WY18,A0A1J1EK56,A0A2T1E1K4,A0A1Q8ZD62,A0A4Q6XKV6,A0A1Z3HNN4,A0A239JE83,A0A2N4XBY2,Q53W94,R5JEI2,A0A0Q0ZC47,A0A2T0XH18,A0A1V4CHV0,A0A1K1RQP7,A0A2T1EKT1,A0A1N6LUI7,A0A0P0NGR6,A0A1X7IML5,A0A0A2LKJ7,K1L112,A0A0U3AL92,A0A1H3A054,E0UCX3,K9XZC6,B9LVW4,A0A0C1VHB4,Q31N05,A0A0C5JKF3,R5NJJ8,A5D4D9,Q2JI93,A0A142Y7A9,A0A432MEQ5,A0A372DKU2,A0A3R7KLK4,C1F5Q7,A0A4R3EV39,A0A1P8WP90,A0A222F7P0,A0A1C9VH88,A0A2T2YMB1,A0A329TD61,A0A101R2A0,A0A1E3XF49,A0A1U9ND56,A0A4R7BQC4,A0A1H3DGN3,A0A1Q1FPH0,E0TGY3,A0A259TUP4,F6EYI8,A0A2S9Q9J0,A0A4Q2UIU6,A0A1H0LH25,A0A318LG42,H1YCU5,L0JS08,A0A1Q5ZS75,A0A345E7N0,M0AF24,A0A1W2A082,A0A1H3X247,A0A0C1XUA0,M0D2X3,A0A2R5G167,A0A346PK63,R7RTW6,A0A1H2RBI2,A0A1C3ZXN2,B9LVP8,M5RSF0,W0JW77,B7K585,F8D8G0,A0A343TL88,L0AJX6,A0A2A5QS34,A0A343JEE2,A0A3P3RGE5,A0A329TBQ3,A0A285N2A8,A0A0W1S8B8,A0A1V4C8L7,L9VRQ2,E4NRV1,A0A1I6HGN0,A0A1I0NI68,,",366,37
"785","C.H9.5","C.H9.8",352,172,180,2.56369509043928,"4F1N,4F3T,4KRE,5GUH,5VM9,6KR6,6OON,7KX7,7SWF,A0A163JTZ6,J9D5G4,Q389P5,C4LVV2,A0A2P6N8X7,A8BCK6,A2DPV7,A0A0G4H2S4,R1FDF0,A0A074TLL7,A0A0D1ZAJ4,Q1K660,F4PH46,A0A3M7S814,A0A164ZA52,A0A383WDW5,Q54G64,S7WCF7,I0YVB2,R7QGN7,C1DZY0,A0A2C5Z0M1,A0CB11,R9ACY5,D3BMP8,A0A1Z5TVE5,W7XD45,A0A1U7LLR0,A0A4S2MWZ7,K1VVQ6,A0A158P1R9,G7DVX0,V6R0U9,G4N9J3,E3KLI3,B7Q5I1,A0A1E3QC61,D5GGK8,S8ANP9,L2GMR6,U4LBG4,A0A177URI1,O74957,A0A3N4IGK1,A6N7Y9,A0A0E9NDK5,T1KZ60,A0A2G8JLH3,Q5KAT1,L2GUF2,W2T741,A0A1W0E4B5,A0A2J7QB22,S4RYE2,A0A388KES6,A0A226EFL3,A0A3S3PD82,A0A0L0TEV1,A0A1S3J512,G0QTT2,A0A1J1HRI1,C4V9J2,Q9JMB7,A0A075AN09,Q5TW24,U5HIG6,A0A401PRI6,Q96J94,A0A2B4RHN2,G2QEV0,A0A397UU01,A0A2T7PFL8,K7ISV0,A0A024FT57,H3HCL6,A0A0G4IME3,E9FUN9,A0A1S3CYL5,D7FQK3,A0A1Y1YHC8,T1GSU4,F4S231,A0A1D8PMK0,A0A2G5B1D8,Q5BD61,A0A4D8YSQ3,A0A158PJG6,J9JZ66,A0A0C2XG51,A0A158QZT6,A0A165QYQ9,T0SAU8,A0A3S1A0C3,A0A074YJ47,A0A2K1J482,A0A1Q3ENA6,O04379,A0A371I3C8,M8AEW7,A0A2K3NY65,F4NYW7,A0A409Y6G2,A0A0L0HAB7,D8PZT7,A0A1D1W4K0,A7RQ46,W4YU94,A7BJS5,D8SNM6,A0A1J8PPA3,X1WG39,M5FQK2,Q69VD5,A0A2R6NSC2,A0A0D8XL16,A0A016WPN3,Q9QZ81,G5EES3,A0A0K0EFP6,Q8CJG0,A0A1D5NTU6,V2WTL2,A0A0V0YLH8,A0A139WDH0,A0A0R3W9Q7,H3DS31,A0A1Y1HWP2,G4T5G9,B7QCC4,A0A0B2UV00,M7BCJ9,E9GN30,Q7PZ41,A0A077Z361,R7U9I3,A0A1X7V1N5,A0A0K0JDP1,A0A0N4UKJ1,A0A498N3A3,A0A3M0IQP5,A0A0L8GBV4,Q32KD4,A0A1J1JBJ0,E0W4C3,A0A482XDA9,A0A3P7EJD6,J9K2Z4,A0A2J7Q8V4,T1IBM6,V3ZRX0,A0A210QKF7,A0A423TSS1,K1PT78,A0A267E8R7,A0A1D2N447,A0A226D7A9,F6YK55,T1KTE4,A0A2C9JGZ6,A0A1V9X9F0,K5X5Z7,A0A3Q0KUG5,T1FY40,1YVU,1Z26,3DLB,5AWH,5G5T,5I4A,6QZK,7R8K,A0A1I7IXT4,A0A2W1JZ37,A0A2S7WBN3,A0A328VKE4,A0A420DFE6,E0ST67,A0A4V1VDY2,A0A368P5I0,C4L1M1,A0A4R1RMM2,A0A1Y2RDH8,Q11QW7,A0A1M5ZSR3,A0A0K8QX04,A0A0M2PXX3,K9TPA9,A0A1L3JHM3,A0A1W6MIP2,A0A1C0UUC4,A0A2U2J9E0,A0A2Z6E1D5,A0A0F4NXW8,A0A142XB92,L8D0R3,B1XJG0,A0A326U7G5,A0A3D8L290,A0A1Q4R485,K9U8J6,A0A097QRL6,K9RC91,A0A0D8ZUC0,A0A139XGN8,A0A1T4Y3A2,Q5P0R2,B6YTQ5,A0A0B0H9B4,A0YYT3,A0A2T1EFY0,G6FTN0,R6KUL9,A0A433NB65,A0A1Z4L0A1,K9UQR0,A0A2T1G8M7,K9VUN0,B7GJX9,A0A0P6X5X2,K9ZDE3,B0JXD6,A0A2T1LS63,A0A1Z4K1Y3,A0A2Z6E0R7,A0A1N6SSK9,A0A0P4UVI8,A0A0V7ZCG4,A0A1J0AGK2,K9PFF9,A0A2G9DT08,K9UEV4,Q9L1X1,A0A060HNJ0,A0A235B542,R5XQK4,A0A1H3LE92,A0A496APJ8,A0A062U2W9,H0HWQ5,A0A1V9G9U4,A0A1I2ZGP1,A0A317EJY3,A0A1I2BD20,F8ERC7,S7VLM7,A0A1A5X8H4,A0A1I2T6Q1,A0A1R3T9N6,A0A0Q2M2Z1,H8KXJ0,D3S0S6,A0A2D1U4H7,I3TE64,A0A0B7I4Z6,A0LL61,Q8DKB1,A0A139WY18,A0A1J1EK56,A0A2T1E1K4,A0A1Q8ZD62,A0A4Q6XKV6,A0A1Z3HNN4,A0A239JE83,A0A2N4XBY2,Q53W94,R5JEI2,A0A0Q0ZC47,A0A2T0XH18,A0A1V4CHV0,A0A1K1RQP7,A0A2T1EKT1,A0A1N6LUI7,A0A0P0NGR6,A0A1X7IML5,A0A0A2LKJ7,K1L112,A0A0U3AL92,A0A1H3A054,E0UCX3,K9XZC6,B9LVW4,A0A0C1VHB4,Q31N05,A0A0C5JKF3,R5NJJ8,A5D4D9,Q2JI93,A0A142Y7A9,A0A432MEQ5,A0A372DKU2,A0A3R7KLK4,C1F5Q7,A0A4R3EV39,A0A1P8WP90,A0A222F7P0,A0A1C9VH88,A0A2T2YMB1,A0A329TD61,A0A101R2A0,A0A1E3XF49,A0A1U9ND56,A0A4R7BQC4,A0A1H3DGN3,A0A1Q1FPH0,E0TGY3,A0A259TUP4,F6EYI8,A0A2S9Q9J0,A0A4Q2UIU6,A0A1H0LH25,A0A318LG42,H1YCU5,L0JS08,A0A1Q5ZS75,A0A345E7N0,M0AF24,A0A1W2A082,A0A1H3X247,A0A0C1XUA0,M0D2X3,A0A2R5G167,A0A346PK63,R7RTW6,A0A1H2RBI2,A0A1C3ZXN2,B9LVP8,M5RSF0,W0JW77,B7K585,F8D8G0,A0A343TL88,L0AJX6,A0A2A5QS34,A0A343JEE2,A0A3P3RGE5,A0A329TBQ3,A0A285N2A8,A0A0W1S8B8,A0A1V4C8L7,L9VRQ2,E4NRV1,A0A1I6HGN0,A0A1I0NI68,,",366,37
"788","C.L20.3","C.L23.11",253,172,81,3.78176141257537,"4F1N,4F3T,4KRE,5GUH,5VM9,6OON,7KX7,7SWF,A0A163JTZ6,A0A196SDB4,J9D5G4,Q389P5,C4LVV2,A0A2P6N8X7,A8BCK6,A0A0G4H2S4,D2VMG4,A0A0D1ZAJ4,Q1K660,A0A3M7S814,A0A164ZA52,A0A383WDW5,Q54G64,S7WCF7,I0YVB2,R7QGN7,C1DZY0,A0A2C5Z0M1,A0CB11,R9ACY5,D3BMP8,A0A1Z5TVE5,W7XD45,A0A1U7LLR0,A0A4S2MWZ7,A0A158P1R9,G7DVX0,V6R0U9,G4N9J3,E3KLI3,B7Q5I1,A0A1E3QC61,D5GGK8,S8ANP9,A0A139AUH8,L2GMR6,U4LBG4,A0A177URI1,O74957,A0A3N4IGK1,A6N7Y9,A0A0E9NDK5,T1KZ60,A0A250WXN5,A0A2G8JLH3,Q5KAT1,L2GUF2,W2T741,A0A1W0E4B5,A0A2J7QB22,A0A2K3CW87,A0A388KES6,A0A226EFL3,A0A3S3PD82,A0A0L0TEV1,A0A1S3J512,G0QTT2,A0A1J1HRI1,C4V9J2,Q9JMB7,A0A075AN09,Q5TW24,U5HIG6,A0A401PRI6,Q96J94,A0A2B4RHN2,G2QEV0,A0A397UU01,A0A2T7PFL8,K7ISV0,A0A024FT57,H3HCL6,A0A0G4IME3,E9FUN9,A0A1S3CYL5,D7FQK3,A0A1Y1YHC8,T1GSU4,F4S231,A0A1D8PMK0,A0A2G5B1D8,Q5BD61,A0A1C7M8P2,A0A4D8YSQ3,A0A158PJG6,A0A0C2XG51,A0A158QZT6,A0A165QYQ9,T0SAU8,R7YY92,A0A3S1A0C3,A0A074YJ47,A0A2K1J482,A0A1Q3ENA6,O04379,A0A371I3C8,M8AEW7,A8P0D4,A0A2K3NY65,F4NYW7,A0A409Y6G2,A0A0L0HAB7,D8PZT7,A0A1D1W4K0,A7RQ46,W4YU94,A7BJS5,D8SNM6,A0A1J8PPA3,X1WG39,M5FQK2,Q69VD5,A0A2R6NSC2,A0A0D8XL16,A0A016WPN3,Q9QZ81,G5EES3,A0A0K0EFP6,Q8CJG0,A0A1D5NTU6,V2WTL2,A0A0V0YLH8,A0A139WDH0,A0A0R3W9Q7,H3DS31,A0A1Y1HWP2,G4T5G9,B7QCC4,A0A0B2UV00,M7BCJ9,E9GN30,Q7PZ41,A0A077Z361,R7U9I3,A0A1X7V1N5,A0A0K0JDP1,A0A0N4UKJ1,A0A498N3A3,A0A3M0IQP5,A0A0L8GBV4,Q32KD4,A0A1J1JBJ0,E0W4C3,A0A482XDA9,A0A3P7EJD6,J9K2Z4,A0A2J7Q8V4,T1IBM6,V3ZRX0,A0A210QKF7,A0A423TSS1,K1PT78,A0A267E8R7,A0A1D2N447,A0A226D7A9,F6YK55,T1KTE4,A0A2C9JGZ6,A0A1V9X9F0,K5X5Z7,A0A3Q0KUG5,T1FY40,1Z26,5AWH,5G5T,5I4A,E0ST67,A0A4R1RMM2,A0A1Y2RDH8,A0A3D8L290,H1KXR6,A0A097QRL6,A0A1T4Y3A2,A0A0B0H9B4,R6KUL9,B7GJX9,A0A0P6X5X2,A0A1N6SSK9,A0A2G9DT08,Q9L1X1,R5XQK4,A0A1H3LE92,A0A496APJ8,A0A1V9G9U4,S7VLM7,A0A1A5X8H4,A0A1I2T6Q1,A0A1R3T9N6,A0A0Q2M2Z1,H8KXJ0,D3S0S6,A0A2D1U4H7,I3TE64,A0A0B7I4Z6,A0LL61,A0A139WY18,A0A2T1E1K4,A0A1Q8ZD62,A0A4Q6XKV6,A0A1Z3HNN4,A0A239JE83,A0A2N4XBY2,R5JEI2,A0A0Q0ZC47,A0A2T0XH18,A0A1V4CHV0,A0A1K1RQP7,A0A1N6LUI7,A0A0P0NGR6,A0A1X7IML5,A0A0A2LKJ7,K1L112,A0A0U3AL92,A0A1H3A054,A0A0C5JKF3,R5NJJ8,A5D4D9,A0A142Y7A9,A0A432MEQ5,A0A372DKU2,C1F5Q7,A0A4R3EV39,A0A222F7P0,A0A1C9VH88,A0A2T2YMB1,A0A101R2A0,A0A1U9ND56,A0A4R7BQC4,A0A1H3DGN3,E0TGY3,A0A259TUP4,F6EYI8,A0A2S9Q9J0,A0A4Q2UIU6,A0A1H0LH25,A0A318LG42,A0A2R5G167,M5RSF0,W0JW77,B7K585,L0AJX6,A0A343JEE2,A0A285N2A8,,",366,37
"789","C.L23.7","N.L24.1",217,172,45,2.51227390180879,"4F1N,4F3T,4KRE,5GUH,5VM9,6KR6,6OON,7KX7,7SWF,A0A163JTZ6,A0A0N4X8S8,A0A196SDB4,J9D5G4,A0A2P6N8X7,A0A0G4H2S4,R1FDF0,D2VMG4,A0A0D1ZAJ4,Q1K660,F4PH46,A0A3M7S814,A0A164ZA52,A0A383WDW5,Q54G64,S7WCF7,R7QGN7,C1DZY0,A0A2C5Z0M1,A0CB11,R9ACY5,D3BMP8,A0A1Z5TVE5,W7XD45,A0A1U7LLR0,A0A4S2MWZ7,A0A158P1R9,G7DVX0,V6R0U9,G4N9J3,E3KLI3,B7Q5I1,A0A1E3QC61,D5GGK8,S8ANP9,A0A139AUH8,L2GMR6,U4LBG4,A0A177URI1,O74957,A0A3N4IGK1,A6N7Y9,A0A0E9NDK5,T1KZ60,A0A250WXN5,A0A2G8JLH3,Q5KAT1,L2GUF2,W2T741,A0A1W0E4B5,A0A2J7QB22,S4RYE2,A0A2K3CW87,A0A388KES6,A0A226EFL3,A0A0L0TEV1,A0A1S3J512,G0QTT2,A0A1J1HRI1,C4V9J2,Q9JMB7,A0A075AN09,Q5TW24,U5HIG6,A0A401PRI6,Q96J94,A0A2B4RHN2,G2QEV0,A0A397UU01,A0A2T7PFL8,K7ISV0,A0A024FT57,H3HCL6,A0A0G4IME3,E9FUN9,A0A1S3CYL5,D7FQK3,A0A1Y1YHC8,T1GSU4,F4S231,A0A1D8PMK0,A0A2G5B1D8,Q5BD61,A0A4D8YSQ3,A0A158PJG6,J9JZ66,A0A0C2XG51,A0A158QZT6,A0A165QYQ9,T0SAU8,R7YY92,A0A3S1A0C3,A0A074YJ47,A0A2K1J482,A0A1Q3ENA6,O04379,A0A371I3C8,M8AEW7,A8P0D4,A0A2K3NY65,F4NYW7,A0A409Y6G2,A0A0L0HAB7,D8PZT7,A0A1D1W4K0,A7RQ46,W4YU94,A7BJS5,D8SNM6,A0A1J8PPA3,X1WG39,M5FQK2,Q69VD5,A0A2R6NSC2,A0A0D8XL16,A0A016WPN3,Q9QZ81,G5EES3,A0A0K0EFP6,Q8CJG0,A0A1D5NTU6,V2WTL2,A0A0V0YLH8,A0A139WDH0,A0A0R3W9Q7,H3DS31,A0A1Y1HWP2,G4T5G9,B7QCC4,A0A0B2UV00,M7BCJ9,E9GN30,Q7PZ41,A0A077Z361,R7U9I3,A0A1X7V1N5,A0A0K0JDP1,A0A0N4UKJ1,A0A498N3A3,A0A3M0IQP5,A0A0L8GBV4,Q32KD4,A0A1J1JBJ0,E0W4C3,A0A482XDA9,A0A3P7EJD6,J9K2Z4,A0A2J7Q8V4,T1IBM6,V3ZRX0,A0A210QKF7,A0A423TSS1,K1PT78,A0A267E8R7,A0A1D2N447,A0A226D7A9,F6YK55,T1KTE4,A0A2C9JGZ6,A0A1V9X9F0,K5X5Z7,A0A3Q0KUG5,T1FY40,1Z26,C4L1M1,A0A3D8L290,A0A0B0H9B4,B7GJX9,A0A1N6SSK9,A0A235B542,R5XQK4,A0A1H3LE92,A0A062U2W9,H0HWQ5,A0A1I2ZGP1,A0A317EJY3,A0A1I2BD20,F8ERC7,A0A0Q2M2Z1,Q8DKB1,B9LVW4,R5NJJ8,Q2JI93,A0A3R7KLK4,A0A1E3XF49,A0A1H3DGN3,H1YCU5,L0JS08,A0A1Q5ZS75,M0AF24,A0A1W2A082,A0A0C1XUA0,M0D2X3,A0A346PK63,R7RTW6,A0A1H2RBI2,A0A1C3ZXN2,W0JW77,F8D8G0,A0A343TL88,A0A343JEE2,A0A3P3RGE5,A0A285N2A8,A0A0W1S8B8,A0A1V4C8L7,L9VRQ2,E4NRV1,A0A1I6HGN0,,",366,37
"805","N.S11.7","N.S9.2",277,172,105,4.64255260243632,"4F1N,4F3T,4KRE,5GUH,5VM9,6KR6,6OON,7KX7,7SWF,C4LVV2,A2DPV7,T1H8B3,R1FDF0,S4RWI0,A0A074TLL7,A0A0D1ZAJ4,Q1K660,F4PH46,A0A3M7S814,A0A164ZA52,Q54G64,S7WCF7,I0YVB2,R7QGN7,C1DZY0,A0A2C5Z0M1,A0CB11,R9ACY5,D3BMP8,A0A1Z5TVE5,W7XD45,A0A1U7LLR0,A0A4S2MWZ7,K1VVQ6,A0A158P1R9,G7DVX0,V6R0U9,G4N9J3,E3KLI3,B7Q5I1,A0A1E3QC61,D5GGK8,S8ANP9,A0A139AUH8,L2GMR6,U4LBG4,A0A177URI1,O74957,A0A3N4IGK1,A6N7Y9,A0A0E9NDK5,T1KZ60,A0A250WXN5,A0A2G8JLH3,Q5KAT1,L2GUF2,W2T741,A0A1W0E4B5,A0A2J7QB22,S4RYE2,A0A2K3CW87,A0A388KES6,A0A226EFL3,A0A3S3PD82,A0A0L0TEV1,A0A1S3J512,G0QTT2,A0A1J1HRI1,Q9JMB7,A0A075AN09,Q5TW24,U5HIG6,A0A401PRI6,Q96J94,A0A2B4RHN2,G2QEV0,A0A397UU01,A0A2T7PFL8,K7ISV0,A0A024FT57,H3HCL6,A0A0G4IME3,E9FUN9,A0A1S3CYL5,D7FQK3,A0A1Y1YHC8,T1GSU4,F4S231,A0A1D8PMK0,A0A2G5B1D8,Q5BD61,A0A1C7M8P2,A0A4D8YSQ3,A0A158PJG6,J9JZ66,A0A0C2XG51,A0A158QZT6,A0A165QYQ9,T0SAU8,R7YY92,A0A3S1A0C3,A0A074YJ47,A0A2K1J482,A0A1Q3ENA6,O04379,A0A371I3C8,M8AEW7,A8P0D4,A0A2K3NY65,F4NYW7,A0A409Y6G2,A0A0L0HAB7,D8PZT7,A0A1D1W4K0,A7RQ46,W4YU94,A7BJS5,D8SNM6,A0A1J8PPA3,X1WG39,M5FQK2,Q69VD5,A0A2R6NSC2,A0A0D8XL16,A0A016WPN3,Q9QZ81,G5EES3,A0A0K0EFP6,Q8CJG0,A0A1D5NTU6,V2WTL2,A0A0V0YLH8,A0A139WDH0,A0A0R3W9Q7,H3DS31,A0A1Y1HWP2,G4T5G9,B7QCC4,A0A0B2UV00,M7BCJ9,E9GN30,Q7PZ41,A0A077Z361,R7U9I3,A0A1X7V1N5,A0A0K0JDP1,A0A0N4UKJ1,A0A498N3A3,A0A3M0IQP5,A0A0L8GBV4,Q32KD4,A0A1J1JBJ0,E0W4C3,A0A482XDA9,A0A3P7EJD6,J9K2Z4,A0A2J7Q8V4,T1IBM6,V3ZRX0,A0A210QKF7,A0A423TSS1,K1PT78,A0A267E8R7,A0A1D2N447,A0A226D7A9,F6YK55,T1KTE4,A0A2C9JGZ6,A0A1V9X9F0,K5X5Z7,A0A3Q0KUG5,T1FY40,3DLB,5AWH,5I4A,6QZK,7R8K,C4L1M1,A0A1M5ZSR3,A0A1T4Y3A2,A0A0B0H9B4,B7GJX9,A0A2G9DT08,Q9L1X1,A0A1H3LE92,A0A496APJ8,A0A062U2W9,H0HWQ5,A0A1V9G9U4,A0A1I2ZGP1,A0A317EJY3,A0A1I2BD20,F8ERC7,S7VLM7,A0A1A5X8H4,A0A1I2T6Q1,A0A1R3T9N6,H8KXJ0,A0A2D1U4H7,A0A0B7I4Z6,A0LL61,A0A139WY18,A0A1J1EK56,A0A2T1E1K4,A0A1Q8ZD62,A0A4Q6XKV6,A0A1Z3HNN4,A0A239JE83,A0A2N4XBY2,Q53W94,R5JEI2,A0A0Q0ZC47,A0A2T0XH18,A0A1V4CHV0,A0A1K1RQP7,A0A1N6LUI7,A0A0P0NGR6,A0A1X7IML5,A0A0A2LKJ7,K1L112,A0A0U3AL92,A0A1H3A054,B9LVW4,A0A0C5JKF3,A5D4D9,A0A142Y7A9,A0A432MEQ5,A0A372DKU2,A0A4R3EV39,A0A1P8WP90,A0A222F7P0,A0A1C9VH88,A0A2T2YMB1,A0A329TD61,A0A101R2A0,A0A1E3XF49,A0A1U9ND56,A0A4R7BQC4,A0A1Q1FPH0,E0TGY3,A0A259TUP4,F6EYI8,A0A2S9Q9J0,A0A4Q2UIU6,A0A1H0LH25,A0A318LG42,H1YCU5,L0JS08,A0A1Q5ZS75,A0A345E7N0,M0AF24,A0A1W2A082,A0A1H3X247,A0A0C1XUA0,M0D2X3,A0A2R5G167,A0A346PK63,A0A1H2RBI2,A0A1C3ZXN2,B9LVP8,M5RSF0,W0JW77,B7K585,F8D8G0,A0A343TL88,L0AJX6,A0A2A5QS34,A0A343JEE2,A0A3P3RGE5,A0A329TBQ3,A0A285N2A8,A0A0W1S8B8,A0A1V4C8L7,L9VRQ2,E4NRV1,A0A1I6HGN0,A0A1I0NI68,,",366,37
"807","C.H1.12","C.H1.16",245,173,72,3.33815028901734,"4F1N,4F3T,4KRE,5GUH,5VM9,6KR6,6OON,7KX7,7SWF,A0A163JTZ6,A0A0N4X8S8,A0A196SDB4,J9D5G4,A0A2P6N8X7,T1H8B3,S4RWI0,D2VMG4,A0A074TLL7,A0A0D1ZAJ4,Q1K660,A0A3M7S814,A0A164ZA52,A0A383WDW5,Q54G64,S7WCF7,I0YVB2,R7QGN7,A0A2C5Z0M1,A0CB11,R9ACY5,A0A1Z5TVE5,W7XD45,A0A1U7LLR0,A0A4S2MWZ7,K1VVQ6,A0A158P1R9,G7DVX0,V6R0U9,G4N9J3,E3KLI3,B7Q5I1,A0A1E3QC61,D5GGK8,S8ANP9,A0A139AUH8,L2GMR6,U4LBG4,A0A177URI1,O74957,A0A3N4IGK1,A6N7Y9,A0A0E9NDK5,T1KZ60,A0A250WXN5,A0A2G8JLH3,Q5KAT1,L2GUF2,W2T741,A0A1W0E4B5,A0A2J7QB22,S4RYE2,A0A2K3CW87,A0A388KES6,A0A226EFL3,A0A3S3PD82,A0A0L0TEV1,A0A1S3J512,G0QTT2,A0A1J1HRI1,C4V9J2,Q9JMB7,A0A075AN09,Q5TW24,U5HIG6,A0A401PRI6,Q96J94,A0A2B4RHN2,G2QEV0,A0A397UU01,A0A2T7PFL8,K7ISV0,A0A024FT57,H3HCL6,A0A0G4IME3,E9FUN9,A0A1S3CYL5,D7FQK3,A0A1Y1YHC8,T1GSU4,F4S231,A0A1D8PMK0,A0A2G5B1D8,Q5BD61,A0A1C7M8P2,A0A4D8YSQ3,A0A158PJG6,J9JZ66,A0A0C2XG51,A0A158QZT6,A0A165QYQ9,T0SAU8,A0A3S1A0C3,A0A074YJ47,A0A2K1J482,A0A1Q3ENA6,O04379,A0A371I3C8,M8AEW7,A8P0D4,A0A2K3NY65,F4NYW7,A0A409Y6G2,A0A0L0HAB7,D8PZT7,A0A1D1W4K0,A7RQ46,W4YU94,A7BJS5,D8SNM6,A0A1J8PPA3,X1WG39,M5FQK2,Q69VD5,A0A2R6NSC2,A0A0D8XL16,A0A016WPN3,Q9QZ81,G5EES3,A0A0K0EFP6,Q8CJG0,A0A1D5NTU6,V2WTL2,A0A0V0YLH8,A0A139WDH0,A0A0R3W9Q7,H3DS31,A0A1Y1HWP2,G4T5G9,B7QCC4,A0A0B2UV00,M7BCJ9,E9GN30,Q7PZ41,A0A077Z361,R7U9I3,A0A1X7V1N5,A0A0K0JDP1,A0A0N4UKJ1,A0A498N3A3,A0A3M0IQP5,A0A0L8GBV4,Q32KD4,A0A1J1JBJ0,E0W4C3,A0A482XDA9,A0A3P7EJD6,J9K2Z4,A0A2J7Q8V4,T1IBM6,V3ZRX0,A0A210QKF7,A0A423TSS1,K1PT78,A0A267E8R7,A0A1D2N447,A0A226D7A9,F6YK55,T1KTE4,A0A2C9JGZ6,A0A1V9X9F0,K5X5Z7,A0A3Q0KUG5,T1FY40,1YVU,1Z26,3DLB,5G5T,5I4A,6QZK,7R8K,C4L1M1,A0A1I3LMA1,A0A142XB92,B1XJG0,B6YTQ5,A0A0B0H9B4,R6KUL9,B7GJX9,A0A1N6SSK9,A0A235B542,R5XQK4,A0A1H3LE92,A0A062U2W9,H0HWQ5,A0A1I2ZGP1,A0A317EJY3,A0A1I2BD20,F8ERC7,A0A0Q2M2Z1,D3S0S6,I3TE64,Q8DKB1,A0A1J1EK56,Q53W94,A0A2T1EKT1,E0UCX3,K9XZC6,A0A0C1VHB4,Q31N05,R5NJJ8,Q2JI93,A0A3R7KLK4,A0A329TD61,A0A1E3XF49,A0A1H3DGN3,A0A1Q1FPH0,H1YCU5,L0JS08,A0A1Q5ZS75,A0A345E7N0,M0AF24,A0A1W2A082,A0A1H3X247,A0A0C1XUA0,M0D2X3,A0A346PK63,R7RTW6,A0A1H2RBI2,A0A1C3ZXN2,B9LVP8,W0JW77,F8D8G0,A0A343TL88,L0AJX6,A0A2A5QS34,A0A343JEE2,A0A3P3RGE5,A0A329TBQ3,A0A285N2A8,A0A0W1S8B8,A0A1V4C8L7,L9VRQ2,E4NRV1,A0A1I6HGN0,A0A1I0NI68,,",366,37
"809","C.H3.10","C.L9.3",330,173,157,1.92673318360885,"4F1N,4F3T,4KRE,5GUH,5VM9,6KR6,6OON,7SWF,A0A163JTZ6,A0A196SDB4,Q389P5,C4LVV2,A0A2P6N8X7,A8BCK6,A2DPV7,T1H8B3,S4RWI0,D2VMG4,A0A0D1ZAJ4,Q1K660,F4PH46,A0A3M7S814,A0A164ZA52,Q54G64,S7WCF7,I0YVB2,R7QGN7,C1DZY0,A0A2C5Z0M1,A0CB11,R9ACY5,D3BMP8,A0A1Z5TVE5,W7XD45,A0A1U7LLR0,A0A4S2MWZ7,K1VVQ6,A0A158P1R9,V6R0U9,G4N9J3,E3KLI3,B7Q5I1,A0A1E3QC61,D5GGK8,S8ANP9,A0A139AUH8,L2GMR6,U4LBG4,A0A177URI1,O74957,A0A3N4IGK1,A6N7Y9,A0A0E9NDK5,T1KZ60,A0A250WXN5,A0A2G8JLH3,Q5KAT1,L2GUF2,W2T741,A0A1W0E4B5,A0A2J7QB22,S4RYE2,A0A2K3CW87,A0A388KES6,A0A226EFL3,A0A3S3PD82,A0A0L0TEV1,A0A1S3J512,G0QTT2,A0A1J1HRI1,Q9JMB7,A0A075AN09,Q5TW24,U5HIG6,A0A401PRI6,Q96J94,A0A2B4RHN2,G2QEV0,A0A397UU01,A0A2T7PFL8,K7ISV0,A0A024FT57,H3HCL6,A0A0G4IME3,E9FUN9,A0A1S3CYL5,D7FQK3,A0A1Y1YHC8,T1GSU4,F4S231,A0A1D8PMK0,A0A2G5B1D8,Q5BD61,A0A1C7M8P2,A0A4D8YSQ3,A0A158PJG6,J9JZ66,A0A0C2XG51,A0A158QZT6,A0A165QYQ9,T0SAU8,R7YY92,A0A3S1A0C3,A0A074YJ47,A0A2K1J482,A0A1Q3ENA6,O04379,A0A371I3C8,M8AEW7,A0A2K3NY65,F4NYW7,A0A409Y6G2,A0A0L0HAB7,D8PZT7,A0A1D1W4K0,A7RQ46,W4YU94,A7BJS5,D8SNM6,A0A1J8PPA3,X1WG39,M5FQK2,Q69VD5,A0A2R6NSC2,A0A0D8XL16,A0A016WPN3,Q9QZ81,G5EES3,A0A0K0EFP6,Q8CJG0,A0A1D5NTU6,V2WTL2,A0A0V0YLH8,A0A139WDH0,A0A0R3W9Q7,H3DS31,A0A1Y1HWP2,G4T5G9,B7QCC4,A0A0B2UV00,M7BCJ9,E9GN30,Q7PZ41,A0A077Z361,R7U9I3,A0A1X7V1N5,A0A0K0JDP1,A0A0N4UKJ1,A0A498N3A3,A0A3M0IQP5,A0A0L8GBV4,Q32KD4,A0A1J1JBJ0,E0W4C3,A0A482XDA9,A0A3P7EJD6,J9K2Z4,A0A2J7Q8V4,T1IBM6,V3ZRX0,A0A210QKF7,A0A423TSS1,K1PT78,A0A267E8R7,A0A1D2N447,A0A226D7A9,F6YK55,T1KTE4,A0A2C9JGZ6,A0A1V9X9F0,K5X5Z7,A0A3Q0KUG5,T1FY40,3DLB,5AWH,5I4A,E8N0K8,A0A1I7IXT4,A0A2W1JZ37,A0A2S7WBN3,A0A328VKE4,A0A420DFE6,E0ST67,A0A4V1VDY2,A0A368P5I0,C4L1M1,A0A4R1RMM2,A0A1Y2RDH8,Q11QW7,A0A1M5ZSR3,A0A0K8QX04,A0A1I3LMA1,K9TPA9,A0A1L3JHM3,A0A1W6MIP2,A0A2U2J9E0,A0A2Z6E1D5,A0A0F4NXW8,L8D0R3,B1XJG0,A0A326U7G5,A0A3D8L290,A0A1Q4R485,K9U8J6,A0A097QRL6,K9RC91,A0A0D8ZUC0,A0A139XGN8,A0A1T4Y3A2,Q5P0R2,B6YTQ5,A0A0B0H9B4,A0YYT3,A0A2T1EFY0,G6FTN0,A0A433NB65,A0A1Z4L0A1,K9UQR0,A0A2T1G8M7,K9VUN0,K9ZDE3,B0JXD6,A0A2T1LS63,A0A1Z4K1Y3,A0A2Z6E0R7,A0A1N6SSK9,A0A0P4UVI8,A0A0V7ZCG4,A0A1J0AGK2,K9PFF9,A0A2G9DT08,K9UEV4,Q9L1X1,A0A235B542,A0A1H3LE92,A0A496APJ8,A0A062U2W9,H0HWQ5,A0A1V9G9U4,A0A1I2ZGP1,A0A317EJY3,A0A1I2BD20,S7VLM7,A0A1A5X8H4,A0A1I2T6Q1,A0A1R3T9N6,A0A0Q2M2Z1,H8KXJ0,D3S0S6,A0A2D1U4H7,I3TE64,A0A0B7I4Z6,A0LL61,Q8DKB1,A0A139WY18,A0A1J1EK56,A0A2T1E1K4,A0A1Q8ZD62,A0A4Q6XKV6,A0A1Z3HNN4,A0A239JE83,A0A2N4XBY2,Q53W94,R5JEI2,A0A0Q0ZC47,A0A2T0XH18,A0A1V4CHV0,A0A1K1RQP7,A0A2T1EKT1,A0A1N6LUI7,A0A0P0NGR6,A0A1X7IML5,A0A0A2LKJ7,K1L112,A0A0U3AL92,A0A1H3A054,E0UCX3,K9XZC6,A0A0C1VHB4,Q31N05,A0A0C5JKF3,R5NJJ8,A5D4D9,Q2JI93,A0A142Y7A9,A0A432MEQ5,A0A372DKU2,C1F5Q7,A0A4R3EV39,A0A1P8WP90,A0A222F7P0,A0A1C9VH88,A0A2T2YMB1,A0A329TD61,A0A101R2A0,A0A1U9ND56,A0A4R7BQC4,A0A1Q1FPH0,E0TGY3,A0A259TUP4,F6EYI8,A0A2S9Q9J0,A0A4Q2UIU6,A0A1H0LH25,A0A318LG42,L0JS08,M0AF24,A0A1H3X247,M0D2X3,A0A2R5G167,A0A346PK63,R7RTW6,B9LVP8,M5RSF0,W0JW77,B7K585,F8D8G0,A0A343TL88,L0AJX6,A0A2A5QS34,A0A343JEE2,A0A3P3RGE5,A0A329TBQ3,A0A285N2A8,A0A0W1S8B8,A0A1V4C8L7,L9VRQ2,E4NRV1,A0A1I6HGN0,A0A1I0NI68,,",366,37
"810","C.H3.6","C.H3.9",348,173,175,1.83545829892651,"4F3T,5GUH,6KR6,7KX7,7SWF,A0A163JTZ6,A0A0N4X8S8,A0A196SDB4,Q389P5,C4LVV2,A0A2P6N8X7,A8BCK6,A2DPV7,A0A0G4H2S4,T1H8B3,S4RWI0,D2VMG4,A0A074TLL7,A0A0D1ZAJ4,Q1K660,F4PH46,A0A3M7S814,A0A164ZA52,A0A383WDW5,Q54G64,S7WCF7,I0YVB2,R7QGN7,C1DZY0,A0A2C5Z0M1,A0CB11,R9ACY5,D3BMP8,A0A1Z5TVE5,W7XD45,A0A1U7LLR0,A0A4S2MWZ7,K1VVQ6,A0A158P1R9,G7DVX0,V6R0U9,G4N9J3,E3KLI3,B7Q5I1,A0A1E3QC61,D5GGK8,S8ANP9,A0A139AUH8,L2GMR6,U4LBG4,A0A177URI1,O74957,A0A3N4IGK1,A6N7Y9,A0A0E9NDK5,T1KZ60,A0A250WXN5,A0A2G8JLH3,Q5KAT1,L2GUF2,W2T741,A0A1W0E4B5,A0A2J7QB22,S4RYE2,A0A2K3CW87,A0A388KES6,A0A226EFL3,A0A3S3PD82,A0A0L0TEV1,A0A1S3J512,G0QTT2,A0A1J1HRI1,C4V9J2,Q9JMB7,A0A075AN09,Q5TW24,U5HIG6,A0A401PRI6,Q96J94,A0A2B4RHN2,G2QEV0,A0A397UU01,A0A2T7PFL8,K7ISV0,A0A024FT57,H3HCL6,A0A0G4IME3,E9FUN9,A0A1S3CYL5,D7FQK3,A0A1Y1YHC8,T1GSU4,F4S231,A0A1D8PMK0,A0A2G5B1D8,Q5BD61,A0A1C7M8P2,A0A4D8YSQ3,A0A158PJG6,J9JZ66,A0A0C2XG51,A0A158QZT6,A0A165QYQ9,T0SAU8,R7YY92,A0A074YJ47,A0A2K1J482,A0A1Q3ENA6,O04379,A0A371I3C8,M8AEW7,A8P0D4,A0A2K3NY65,F4NYW7,A0A409Y6G2,A0A0L0HAB7,D8PZT7,A0A1D1W4K0,A7RQ46,W4YU94,D8SNM6,A0A1J8PPA3,X1WG39,M5FQK2,Q69VD5,A0A2R6NSC2,A0A0D8XL16,A0A016WPN3,Q9QZ81,G5EES3,A0A0K0EFP6,Q8CJG0,A0A1D5NTU6,V2WTL2,A0A0V0YLH8,A0A139WDH0,A0A0R3W9Q7,H3DS31,A0A1Y1HWP2,G4T5G9,B7QCC4,A0A0B2UV00,M7BCJ9,E9GN30,Q7PZ41,A0A077Z361,R7U9I3,A0A1X7V1N5,A0A0K0JDP1,A0A0N4UKJ1,A0A498N3A3,A0A3M0IQP5,A0A0L8GBV4,Q32KD4,A0A1J1JBJ0,E0W4C3,A0A482XDA9,A0A3P7EJD6,J9K2Z4,A0A2J7Q8V4,T1IBM6,V3ZRX0,A0A210QKF7,K1PT78,A0A267E8R7,A0A1D2N447,A0A226D7A9,F6YK55,T1KTE4,A0A2C9JGZ6,K5X5Z7,A0A3Q0KUG5,T1FY40,1YVU,1Z26,3DLB,5AWH,5G5T,6QZK,7R8K,E8N0K8,A0A1I7IXT4,A0A2W1JZ37,A0A2S7WBN3,A0A328VKE4,A0A420DFE6,A0A4V1VDY2,A0A368P5I0,C4L1M1,A0A4R1RMM2,A0A1Y2RDH8,Q11QW7,A0A1M5ZSR3,A0A0K8QX04,A0A0M2PXX3,A0A1I3LMA1,K9TPA9,A0A1L3JHM3,A0A1W6MIP2,A0A1C0UUC4,A0A2U2J9E0,A0A2Z6E1D5,A0A0F4NXW8,A0A142XB92,L8D0R3,B1XJG0,A0A326U7G5,A0A3D8L290,H1KXR6,A0A1Q4R485,K9U8J6,A0A097QRL6,K9RC91,A0A0D8ZUC0,A0A139XGN8,A0A1T4Y3A2,Q5P0R2,B6YTQ5,A0A0B0H9B4,A0YYT3,A0A2T1EFY0,G6FTN0,R6KUL9,A0A433NB65,A0A1Z4L0A1,K9UQR0,A0A2T1G8M7,K9VUN0,B7GJX9,A0A0P6X5X2,K9ZDE3,B0JXD6,A0A2T1LS63,A0A1Z4K1Y3,A0A2Z6E0R7,A0A1N6SSK9,A0A0P4UVI8,A0A0V7ZCG4,A0A1J0AGK2,K9PFF9,A0A2G9DT08,K9UEV4,Q9L1X1,A0A060HNJ0,A0A235B542,R5XQK4,A0A1H3LE92,A0A496APJ8,A0A1V9G9U4,A0A1I2ZGP1,A0A317EJY3,A0A1I2BD20,S7VLM7,A0A1A5X8H4,A0A1I2T6Q1,A0A1R3T9N6,A0A0Q2M2Z1,H8KXJ0,D3S0S6,A0A2D1U4H7,I3TE64,A0A0B7I4Z6,A0LL61,Q8DKB1,A0A139WY18,A0A1J1EK56,A0A2T1E1K4,A0A1Q8ZD62,A0A4Q6XKV6,A0A1Z3HNN4,A0A239JE83,A0A2N4XBY2,Q53W94,R5JEI2,A0A0Q0ZC47,A0A2T0XH18,A0A1V4CHV0,A0A1K1RQP7,A0A2T1EKT1,A0A1N6LUI7,A0A0P0NGR6,A0A1X7IML5,A0A0A2LKJ7,K1L112,A0A0U3AL92,A0A1H3A054,E0UCX3,K9XZC6,A0A0C1VHB4,Q31N05,A0A0C5JKF3,R5NJJ8,A5D4D9,Q2JI93,A0A142Y7A9,A0A432MEQ5,A0A372DKU2,C1F5Q7,A0A4R3EV39,A0A1P8WP90,A0A222F7P0,A0A1C9VH88,A0A2T2YMB1,A0A329TD61,A0A101R2A0,A0A1E3XF49,A0A1U9ND56,A0A4R7BQC4,A0A1Q1FPH0,E0TGY3,A0A259TUP4,F6EYI8,A0A2S9Q9J0,A0A4Q2UIU6,A0A1H0LH25,A0A318LG42,H1YCU5,L0JS08,A0A1Q5ZS75,A0A345E7N0,M0AF24,A0A1W2A082,A0A1H3X247,A0A0C1XUA0,M0D2X3,A0A2R5G167,A0A346PK63,R7RTW6,A0A1H2RBI2,A0A1C3ZXN2,B9LVP8,M5RSF0,W0JW77,B7K585,F8D8G0,A0A343TL88,L0AJX6,A0A2A5QS34,A0A343JEE2,A0A3P3RGE5,A0A329TBQ3,A0A285N2A8,A0A0W1S8B8,A0A1V4C8L7,L9VRQ2,E4NRV1,A0A1I6HGN0,A0A1I0NI68,,",366,37
"812","C.H7.13","C.H7.17",241,173,68,7.33364501870112,"4F1N,4F3T,4KRE,5GUH,5VM9,6KR6,6OON,7KX7,7SWF,A0A163JTZ6,A0A0N4X8S8,A0A196SDB4,J9D5G4,C4LVV2,A0A2P6N8X7,A2DPV7,T1H8B3,R1FDF0,S4RWI0,D2VMG4,A0A0D1ZAJ4,Q1K660,F4PH46,A0A3M7S814,A0A164ZA52,A0A383WDW5,Q54G64,S7WCF7,I0YVB2,C1DZY0,A0A2C5Z0M1,A0CB11,R9ACY5,D3BMP8,A0A1Z5TVE5,W7XD45,A0A1U7LLR0,A0A4S2MWZ7,K1VVQ6,A0A158P1R9,G7DVX0,V6R0U9,G4N9J3,E3KLI3,B7Q5I1,A0A1E3QC61,D5GGK8,S8ANP9,A0A139AUH8,L2GMR6,U4LBG4,A0A177URI1,O74957,A0A3N4IGK1,A6N7Y9,A0A0E9NDK5,T1KZ60,A0A250WXN5,A0A2G8JLH3,Q5KAT1,L2GUF2,W2T741,A0A1W0E4B5,A0A2J7QB22,A0A2K3CW87,A0A226EFL3,A0A3S3PD82,A0A0L0TEV1,A0A1S3J512,G0QTT2,A0A1J1HRI1,C4V9J2,Q9JMB7,A0A075AN09,Q5TW24,U5HIG6,A0A401PRI6,Q96J94,A0A2B4RHN2,A0A397UU01,A0A2T7PFL8,K7ISV0,A0A024FT57,H3HCL6,A0A0G4IME3,E9FUN9,A0A1S3CYL5,D7FQK3,A0A1Y1YHC8,T1GSU4,F4S231,A0A1D8PMK0,A0A2G5B1D8,A0A1C7M8P2,A0A4D8YSQ3,A0A158PJG6,J9JZ66,A0A0C2XG51,A0A158QZT6,A0A165QYQ9,T0SAU8,A0A3S1A0C3,A0A074YJ47,A0A2K1J482,A0A1Q3ENA6,O04379,A0A371I3C8,M8AEW7,A8P0D4,A0A2K3NY65,F4NYW7,A0A409Y6G2,A0A0L0HAB7,D8PZT7,A0A1D1W4K0,A7RQ46,W4YU94,A7BJS5,D8SNM6,A0A1J8PPA3,X1WG39,M5FQK2,Q69VD5,A0A2R6NSC2,A0A0D8XL16,A0A016WPN3,Q9QZ81,G5EES3,A0A0K0EFP6,Q8CJG0,A0A1D5NTU6,V2WTL2,A0A0V0YLH8,A0A139WDH0,A0A0R3W9Q7,H3DS31,A0A1Y1HWP2,G4T5G9,B7QCC4,A0A0B2UV00,M7BCJ9,E9GN30,Q7PZ41,A0A077Z361,R7U9I3,A0A1X7V1N5,A0A0K0JDP1,A0A0N4UKJ1,A0A498N3A3,A0A3M0IQP5,A0A0L8GBV4,Q32KD4,A0A1J1JBJ0,E0W4C3,A0A482XDA9,A0A3P7EJD6,J9K2Z4,A0A2J7Q8V4,T1IBM6,V3ZRX0,A0A210QKF7,A0A423TSS1,K1PT78,A0A267E8R7,A0A1D2N447,A0A226D7A9,F6YK55,T1KTE4,A0A2C9JGZ6,A0A1V9X9F0,K5X5Z7,A0A3Q0KUG5,T1FY40,1YVU,1Z26,3DLB,5AWH,5I4A,6QZK,C4L1M1,A0A0K8QX04,A0A0M2PXX3,A0A1I3LMA1,A0A1C0UUC4,B1XJG0,A0A097QRL6,B6YTQ5,A0A0B0H9B4,R6KUL9,B7GJX9,A0A1N6SSK9,A0A060HNJ0,A0A235B542,R5XQK4,A0A1H3LE92,A0A496APJ8,A0A062U2W9,A0A1I2ZGP1,A0A317EJY3,A0A1I2BD20,A0A0Q2M2Z1,Q8DKB1,A0A1J1EK56,A0A1Z3HNN4,Q53W94,A0A2T1EKT1,E0UCX3,K9XZC6,B9LVW4,A0A0C1VHB4,Q31N05,R5NJJ8,Q2JI93,A0A432MEQ5,H1YCU5,L0JS08,A0A1Q5ZS75,M0AF24,A0A1H3X247,A0A0C1XUA0,M0D2X3,A0A2R5G167,A0A346PK63,R7RTW6,A0A1H2RBI2,A0A1C3ZXN2,B9LVP8,M5RSF0,W0JW77,B7K585,A0A343TL88,L0AJX6,A0A2A5QS34,A0A343JEE2,A0A3P3RGE5,A0A329TBQ3,A0A285N2A8,A0A0W1S8B8,L9VRQ2,E4NRV1,A0A1I6HGN0,,",366,37
"821","C.L20.4","N.L2.1",227,173,54,1.63032541211732,"4F1N,4F3T,4KRE,5GUH,5VM9,6KR6,6OON,7KX7,Q389P5,C4LVV2,A0A2P6N8X7,A8BCK6,A2DPV7,A0A0G4H2S4,T1H8B3,S4RWI0,D2VMG4,A0A074TLL7,A0A0D1ZAJ4,Q1K660,F4PH46,A0A164ZA52,A0A383WDW5,Q54G64,S7WCF7,R7QGN7,C1DZY0,A0A2C5Z0M1,A0CB11,R9ACY5,D3BMP8,A0A1Z5TVE5,W7XD45,A0A1U7LLR0,A0A4S2MWZ7,A0A158P1R9,G7DVX0,V6R0U9,G4N9J3,E3KLI3,B7Q5I1,A0A1E3QC61,D5GGK8,S8ANP9,A0A139AUH8,L2GMR6,U4LBG4,A0A177URI1,O74957,A0A3N4IGK1,A6N7Y9,A0A0E9NDK5,T1KZ60,A0A250WXN5,A0A2G8JLH3,Q5KAT1,L2GUF2,A0A1W0E4B5,A0A2J7QB22,S4RYE2,A0A2K3CW87,A0A388KES6,A0A226EFL3,A0A3S3PD82,A0A0L0TEV1,A0A1S3J512,G0QTT2,A0A1J1HRI1,C4V9J2,Q9JMB7,A0A075AN09,Q5TW24,U5HIG6,A0A401PRI6,Q96J94,A0A2B4RHN2,G2QEV0,A0A397UU01,A0A2T7PFL8,K7ISV0,A0A024FT57,H3HCL6,A0A0G4IME3,E9FUN9,A0A1S3CYL5,D7FQK3,A0A1Y1YHC8,T1GSU4,F4S231,A0A1D8PMK0,A0A2G5B1D8,Q5BD61,A0A1C7M8P2,A0A4D8YSQ3,A0A158PJG6,J9JZ66,A0A0C2XG51,A0A158QZT6,A0A165QYQ9,T0SAU8,R7YY92,A0A3S1A0C3,A0A074YJ47,A0A2K1J482,A0A1Q3ENA6,O04379,A0A371I3C8,M8AEW7,A8P0D4,A0A2K3NY65,F4NYW7,A0A409Y6G2,A0A0L0HAB7,D8PZT7,A0A1D1W4K0,A7RQ46,W4YU94,A7BJS5,D8SNM6,A0A1J8PPA3,X1WG39,M5FQK2,Q69VD5,A0A2R6NSC2,A0A0D8XL16,A0A016WPN3,Q9QZ81,G5EES3,A0A0K0EFP6,Q8CJG0,A0A1D5NTU6,V2WTL2,A0A0V0YLH8,A0A139WDH0,A0A0R3W9Q7,H3DS31,A0A1Y1HWP2,G4T5G9,B7QCC4,A0A0B2UV00,M7BCJ9,E9GN30,Q7PZ41,A0A077Z361,R7U9I3,A0A1X7V1N5,A0A0K0JDP1,A0A0N4UKJ1,A0A498N3A3,A0A3M0IQP5,A0A0L8GBV4,Q32KD4,A0A1J1JBJ0,E0W4C3,A0A482XDA9,A0A3P7EJD6,J9K2Z4,A0A2J7Q8V4,T1IBM6,V3ZRX0,A0A210QKF7,A0A423TSS1,K1PT78,A0A267E8R7,A0A1D2N447,A0A226D7A9,F6YK55,T1KTE4,A0A2C9JGZ6,A0A1V9X9F0,K5X5Z7,A0A3Q0KUG5,T1FY40,1Z26,5AWH,5G5T,5I4A,A0A3D8L290,H1KXR6,A0A060HNJ0,S7VLM7,A0A0Q2M2Z1,H8KXJ0,D3S0S6,A0A2D1U4H7,A0A0B7I4Z6,A0LL61,A0A4Q6XKV6,A0A239JE83,A0A2N4XBY2,R5JEI2,A0A0Q0ZC47,A0A2T0XH18,A0A1V4CHV0,A0A1K1RQP7,A0A1N6LUI7,A0A0P0NGR6,A0A1X7IML5,A0A0A2LKJ7,K1L112,A0A0U3AL92,A0A1H3A054,A0A0C5JKF3,A5D4D9,A0A142Y7A9,A0A372DKU2,A0A3R7KLK4,C1F5Q7,A0A4R3EV39,A0A1P8WP90,A0A222F7P0,A0A1C9VH88,A0A2T2YMB1,A0A101R2A0,A0A1U9ND56,A0A4R7BQC4,A0A1H3DGN3,E0TGY3,A0A259TUP4,F6EYI8,A0A2S9Q9J0,A0A4Q2UIU6,A0A1H0LH25,A0A318LG42,A0A2R5G167,M5RSF0,B7K585,,",366,37
"822","C.L20.6","N.S1.7",269,173,96,1.71215679190751,"4F1N,4F3T,4KRE,5GUH,5VM9,6OON,7KX7,7SWF,Q389P5,C4LVV2,A0A2P6N8X7,A8BCK6,A2DPV7,A0A0G4H2S4,T1H8B3,R1FDF0,S4RWI0,D2VMG4,A0A074TLL7,A0A0D1ZAJ4,Q1K660,F4PH46,A0A164ZA52,A0A383WDW5,Q54G64,S7WCF7,R7QGN7,C1DZY0,A0A2C5Z0M1,A0CB11,R9ACY5,D3BMP8,W7XD45,A0A1U7LLR0,A0A4S2MWZ7,A0A158P1R9,G7DVX0,V6R0U9,G4N9J3,E3KLI3,B7Q5I1,A0A1E3QC61,D5GGK8,S8ANP9,A0A139AUH8,L2GMR6,U4LBG4,A0A177URI1,O74957,A0A3N4IGK1,A6N7Y9,A0A0E9NDK5,T1KZ60,A0A250WXN5,A0A2G8JLH3,Q5KAT1,L2GUF2,A0A1W0E4B5,A0A2J7QB22,S4RYE2,A0A2K3CW87,A0A388KES6,A0A226EFL3,A0A3S3PD82,A0A0L0TEV1,A0A1S3J512,G0QTT2,A0A1J1HRI1,C4V9J2,Q9JMB7,A0A075AN09,Q5TW24,U5HIG6,A0A401PRI6,Q96J94,A0A2B4RHN2,G2QEV0,A0A397UU01,A0A2T7PFL8,K7ISV0,A0A024FT57,H3HCL6,A0A0G4IME3,E9FUN9,A0A1S3CYL5,D7FQK3,A0A1Y1YHC8,T1GSU4,F4S231,A0A1D8PMK0,A0A2G5B1D8,Q5BD61,A0A1C7M8P2,A0A4D8YSQ3,A0A158PJG6,J9JZ66,A0A0C2XG51,A0A158QZT6,A0A165QYQ9,T0SAU8,R7YY92,A0A3S1A0C3,A0A074YJ47,A0A2K1J482,A0A1Q3ENA6,O04379,A0A371I3C8,M8AEW7,A8P0D4,A0A2K3NY65,F4NYW7,A0A409Y6G2,A0A0L0HAB7,D8PZT7,A0A1D1W4K0,A7RQ46,W4YU94,A7BJS5,D8SNM6,A0A1J8PPA3,X1WG39,M5FQK2,Q69VD5,A0A2R6NSC2,A0A0D8XL16,A0A016WPN3,Q9QZ81,G5EES3,A0A0K0EFP6,Q8CJG0,A0A1D5NTU6,V2WTL2,A0A0V0YLH8,A0A139WDH0,A0A0R3W9Q7,H3DS31,A0A1Y1HWP2,G4T5G9,B7QCC4,A0A0B2UV00,M7BCJ9,E9GN30,Q7PZ41,A0A077Z361,R7U9I3,A0A1X7V1N5,A0A0K0JDP1,A0A0N4UKJ1,A0A498N3A3,A0A3M0IQP5,A0A0L8GBV4,Q32KD4,A0A1J1JBJ0,E0W4C3,A0A482XDA9,A0A3P7EJD6,J9K2Z4,A0A2J7Q8V4,T1IBM6,V3ZRX0,A0A210QKF7,A0A423TSS1,K1PT78,A0A267E8R7,A0A1D2N447,A0A226D7A9,F6YK55,T1KTE4,A0A2C9JGZ6,A0A1V9X9F0,K5X5Z7,A0A3Q0KUG5,T1FY40,1YVU,1Z26,3DLB,5AWH,5G5T,5I4A,A0A1I3LMA1,A0A3D8L290,A0A0B0H9B4,R6KUL9,B7GJX9,A0A1N6SSK9,A0A060HNJ0,A0A235B542,R5XQK4,S7VLM7,A0A0Q2M2Z1,H8KXJ0,D3S0S6,A0A2D1U4H7,A0A0B7I4Z6,A0LL61,Q8DKB1,A0A1J1EK56,A0A4Q6XKV6,A0A239JE83,A0A2N4XBY2,Q53W94,R5JEI2,A0A0Q0ZC47,A0A2T0XH18,A0A1V4CHV0,A0A1K1RQP7,A0A2T1EKT1,A0A1N6LUI7,A0A0P0NGR6,A0A1X7IML5,A0A0A2LKJ7,K1L112,A0A0U3AL92,A0A1H3A054,E0UCX3,K9XZC6,A0A0C1VHB4,Q31N05,A0A0C5JKF3,R5NJJ8,A5D4D9,Q2JI93,A0A142Y7A9,A0A372DKU2,A0A3R7KLK4,C1F5Q7,A0A4R3EV39,A0A1P8WP90,A0A222F7P0,A0A1C9VH88,A0A2T2YMB1,A0A329TD61,A0A101R2A0,A0A1U9ND56,A0A4R7BQC4,A0A1H3DGN3,A0A1Q1FPH0,E0TGY3,A0A259TUP4,F6EYI8,A0A2S9Q9J0,A0A4Q2UIU6,A0A1H0LH25,A0A318LG42,L0JS08,A0A345E7N0,M0AF24,A0A1H3X247,M0D2X3,A0A2R5G167,A0A346PK63,R7RTW6,B9LVP8,M5RSF0,W0JW77,B7K585,F8D8G0,A0A343TL88,L0AJX6,A0A2A5QS34,A0A343JEE2,A0A3P3RGE5,A0A329TBQ3,A0A285N2A8,A0A0W1S8B8,L9VRQ2,E4NRV1,A0A1I6HGN0,A0A1I0NI68,,",366,37
"824","C.L23.8","N.L24.1",226,173,53,2.21785363725597,"4F1N,4F3T,4KRE,5GUH,5VM9,6KR6,6OON,7KX7,A0A163JTZ6,A0A0N4X8S8,A0A196SDB4,J9D5G4,A0A2P6N8X7,A8BCK6,A0A0G4H2S4,R1FDF0,D2VMG4,A0A0D1ZAJ4,Q1K660,F4PH46,A0A3M7S814,A0A164ZA52,A0A383WDW5,Q54G64,S7WCF7,I0YVB2,R7QGN7,C1DZY0,A0A2C5Z0M1,A0CB11,R9ACY5,D3BMP8,A0A1Z5TVE5,W7XD45,A0A1U7LLR0,A0A4S2MWZ7,K1VVQ6,A0A158P1R9,G7DVX0,V6R0U9,G4N9J3,E3KLI3,B7Q5I1,A0A1E3QC61,D5GGK8,S8ANP9,A0A139AUH8,L2GMR6,U4LBG4,A0A177URI1,O74957,A0A3N4IGK1,A6N7Y9,A0A0E9NDK5,T1KZ60,A0A250WXN5,A0A2G8JLH3,Q5KAT1,L2GUF2,W2T741,A0A1W0E4B5,A0A2J7QB22,S4RYE2,A0A2K3CW87,A0A388KES6,A0A226EFL3,A0A3S3PD82,A0A0L0TEV1,A0A1S3J512,A0A1J1HRI1,C4V9J2,Q9JMB7,A0A075AN09,Q5TW24,U5HIG6,A0A401PRI6,Q96J94,A0A2B4RHN2,G2QEV0,A0A397UU01,A0A2T7PFL8,K7ISV0,A0A024FT57,H3HCL6,A0A0G4IME3,E9FUN9,A0A1S3CYL5,D7FQK3,A0A1Y1YHC8,T1GSU4,F4S231,A0A1D8PMK0,A0A2G5B1D8,A0A1C7M8P2,A0A4D8YSQ3,A0A158PJG6,A0A0C2XG51,A0A158QZT6,A0A165QYQ9,T0SAU8,R7YY92,A0A3S1A0C3,A0A074YJ47,A0A2K1J482,A0A1Q3ENA6,O04379,A0A371I3C8,M8AEW7,A8P0D4,A0A2K3NY65,F4NYW7,A0A409Y6G2,A0A0L0HAB7,D8PZT7,A0A1D1W4K0,A7RQ46,W4YU94,A7BJS5,D8SNM6,A0A1J8PPA3,X1WG39,M5FQK2,Q69VD5,A0A2R6NSC2,A0A0D8XL16,A0A016WPN3,Q9QZ81,G5EES3,A0A0K0EFP6,Q8CJG0,A0A1D5NTU6,V2WTL2,A0A0V0YLH8,A0A139WDH0,A0A0R3W9Q7,H3DS31,A0A1Y1HWP2,G4T5G9,B7QCC4,A0A0B2UV00,M7BCJ9,E9GN30,Q7PZ41,A0A077Z361,R7U9I3,A0A1X7V1N5,A0A0K0JDP1,A0A0N4UKJ1,A0A498N3A3,A0A3M0IQP5,A0A0L8GBV4,Q32KD4,A0A1J1JBJ0,E0W4C3,A0A482XDA9,A0A3P7EJD6,J9K2Z4,A0A2J7Q8V4,T1IBM6,V3ZRX0,A0A210QKF7,A0A423TSS1,K1PT78,A0A267E8R7,A0A1D2N447,A0A226D7A9,F6YK55,T1KTE4,A0A2C9JGZ6,A0A1V9X9F0,K5X5Z7,A0A3Q0KUG5,T1FY40,1Z26,6QZK,7R8K,C4L1M1,A0A3D8L290,A0A0B0H9B4,B7GJX9,A0A1N6SSK9,A0A060HNJ0,A0A235B542,R5XQK4,A0A1H3LE92,A0A062U2W9,H0HWQ5,A0A1I2ZGP1,A0A317EJY3,A0A1I2BD20,F8ERC7,A0A0Q2M2Z1,Q8DKB1,K9XZC6,B9LVW4,R5NJJ8,Q2JI93,A0A3R7KLK4,A0A329TD61,A0A1E3XF49,A0A1H3DGN3,H1YCU5,L0JS08,A0A1Q5ZS75,A0A345E7N0,M0AF24,A0A1W2A082,A0A0C1XUA0,M0D2X3,A0A346PK63,R7RTW6,A0A1H2RBI2,A0A1C3ZXN2,W0JW77,F8D8G0,A0A343TL88,A0A343JEE2,A0A3P3RGE5,A0A329TBQ3,A0A285N2A8,A0A0W1S8B8,A0A1V4C8L7,L9VRQ2,E4NRV1,A0A1I6HGN0,A0A1I0NI68,,",366,37
"828","N.H3.12","N.H3.9",328,173,155,2.2393063583815,"4F1N,4F3T,4KRE,5GUH,5VM9,6KR6,6OON,7KX7,7SWF,A0A0N4X8S8,A0A196SDB4,Q389P5,C4LVV2,A0A0G4H2S4,T1H8B3,S4RWI0,D2VMG4,A0A074TLL7,A0A0D1ZAJ4,Q1K660,F4PH46,A0A3M7S814,A0A164ZA52,Q54G64,S7WCF7,I0YVB2,R7QGN7,C1DZY0,A0A2C5Z0M1,A0CB11,R9ACY5,D3BMP8,A0A1Z5TVE5,W7XD45,A0A1U7LLR0,A0A4S2MWZ7,K1VVQ6,A0A158P1R9,G7DVX0,V6R0U9,G4N9J3,E3KLI3,B7Q5I1,A0A1E3QC61,D5GGK8,S8ANP9,A0A139AUH8,L2GMR6,U4LBG4,A0A177URI1,O74957,A0A3N4IGK1,A6N7Y9,A0A0E9NDK5,T1KZ60,A0A2G8JLH3,Q5KAT1,L2GUF2,W2T741,A0A2J7QB22,S4RYE2,A0A2K3CW87,A0A388KES6,A0A226EFL3,A0A3S3PD82,A0A0L0TEV1,A0A1S3J512,G0QTT2,A0A1J1HRI1,C4V9J2,Q9JMB7,Q5TW24,U5HIG6,A0A401PRI6,Q96J94,A0A2B4RHN2,G2QEV0,A0A397UU01,A0A2T7PFL8,K7ISV0,A0A024FT57,H3HCL6,A0A0G4IME3,E9FUN9,A0A1S3CYL5,D7FQK3,A0A1Y1YHC8,T1GSU4,F4S231,A0A1D8PMK0,A0A2G5B1D8,Q5BD61,A0A1C7M8P2,A0A4D8YSQ3,A0A158PJG6,J9JZ66,A0A0C2XG51,A0A158QZT6,A0A165QYQ9,T0SAU8,R7YY92,A0A3S1A0C3,A0A074YJ47,A0A2K1J482,A0A1Q3ENA6,O04379,A0A371I3C8,M8AEW7,A8P0D4,A0A2K3NY65,F4NYW7,A0A409Y6G2,A0A0L0HAB7,D8PZT7,A0A1D1W4K0,A7RQ46,W4YU94,A7BJS5,D8SNM6,A0A1J8PPA3,X1WG39,M5FQK2,Q69VD5,A0A2R6NSC2,A0A0D8XL16,A0A016WPN3,Q9QZ81,G5EES3,A0A0K0EFP6,Q8CJG0,A0A1D5NTU6,V2WTL2,A0A0V0YLH8,A0A139WDH0,A0A0R3W9Q7,H3DS31,A0A1Y1HWP2,G4T5G9,B7QCC4,A0A0B2UV00,M7BCJ9,E9GN30,Q7PZ41,A0A077Z361,R7U9I3,A0A1X7V1N5,A0A0K0JDP1,A0A0N4UKJ1,A0A498N3A3,A0A3M0IQP5,A0A0L8GBV4,Q32KD4,A0A1J1JBJ0,E0W4C3,A0A482XDA9,A0A3P7EJD6,J9K2Z4,A0A2J7Q8V4,T1IBM6,V3ZRX0,A0A210QKF7,A0A423TSS1,K1PT78,A0A267E8R7,A0A1D2N447,A0A226D7A9,F6YK55,T1KTE4,A0A2C9JGZ6,A0A1V9X9F0,K5X5Z7,A0A3Q0KUG5,T1FY40,1YVU,1Z26,3DLB,5G5T,5I4A,6QZK,E0ST67,A0A4R1RMM2,A0A1Y2RDH8,A0A1M5ZSR3,A0A1I3LMA1,K9TPA9,A0A1L3JHM3,A0A1W6MIP2,A0A2U2J9E0,A0A2Z6E1D5,A0A0F4NXW8,A0A142XB92,L8D0R3,H1KXR6,A0A1Q4R485,K9U8J6,K9RC91,A0A0D8ZUC0,A0A139XGN8,Q5P0R2,A0A0B0H9B4,A0YYT3,A0A2T1EFY0,G6FTN0,R6KUL9,A0A433NB65,K9UQR0,A0A2T1G8M7,K9VUN0,B7GJX9,A0A0P6X5X2,K9ZDE3,B0JXD6,A0A2T1LS63,A0A1Z4K1Y3,A0A2Z6E0R7,A0A1N6SSK9,A0A0P4UVI8,A0A0V7ZCG4,A0A1J0AGK2,K9PFF9,A0A2G9DT08,K9UEV4,Q9L1X1,A0A060HNJ0,R5XQK4,A0A496APJ8,A0A1V9G9U4,A0A1I2ZGP1,A0A317EJY3,A0A1I2BD20,F8ERC7,S7VLM7,A0A1A5X8H4,A0A1I2T6Q1,A0A1R3T9N6,A0A0Q2M2Z1,H8KXJ0,D3S0S6,A0A2D1U4H7,A0A0B7I4Z6,A0LL61,Q8DKB1,A0A139WY18,A0A1J1EK56,A0A2T1E1K4,A0A1Q8ZD62,A0A4Q6XKV6,A0A1Z3HNN4,A0A239JE83,A0A2N4XBY2,Q53W94,R5JEI2,A0A0Q0ZC47,A0A2T0XH18,A0A1V4CHV0,A0A1K1RQP7,A0A2T1EKT1,A0A1N6LUI7,A0A0P0NGR6,A0A1X7IML5,A0A0A2LKJ7,K1L112,A0A0U3AL92,A0A1H3A054,E0UCX3,K9XZC6,B9LVW4,A0A0C1VHB4,Q31N05,A0A0C5JKF3,R5NJJ8,A5D4D9,Q2JI93,A0A142Y7A9,A0A372DKU2,A0A3R7KLK4,C1F5Q7,A0A4R3EV39,A0A1P8WP90,A0A222F7P0,A0A1C9VH88,A0A2T2YMB1,A0A329TD61,A0A101R2A0,A0A1E3XF49,A0A1U9ND56,A0A4R7BQC4,A0A1H3DGN3,A0A1Q1FPH0,E0TGY3,A0A259TUP4,F6EYI8,A0A2S9Q9J0,A0A4Q2UIU6,A0A1H0LH25,A0A318LG42,H1YCU5,L0JS08,A0A1Q5ZS75,A0A345E7N0,M0AF24,A0A1W2A082,A0A1H3X247,A0A0C1XUA0,M0D2X3,A0A2R5G167,A0A346PK63,R7RTW6,A0A1H2RBI2,A0A1C3ZXN2,B9LVP8,M5RSF0,W0JW77,B7K585,F8D8G0,A0A343TL88,L0AJX6,A0A2A5QS34,A0A343JEE2,A0A3P3RGE5,A0A329TBQ3,A0A285N2A8,A0A0W1S8B8,A0A1V4C8L7,L9VRQ2,E4NRV1,A0A1I6HGN0,A0A1I0NI68,,",366,37
"833","N.H5.12","N.L16.2",268,173,95,4.20033465165805,"4F1N,4F3T,4KRE,5GUH,5VM9,6KR6,6OON,7KX7,7SWF,A0A163JTZ6,A0A0N4X8S8,A0A196SDB4,J9D5G4,A0A2P6N8X7,A0A0G4H2S4,T1H8B3,S4RWI0,D2VMG4,Q1K660,F4PH46,A0A3M7S814,A0A164ZA52,Q54G64,S7WCF7,I0YVB2,R7QGN7,C1DZY0,A0A2C5Z0M1,A0CB11,R9ACY5,D3BMP8,A0A1Z5TVE5,W7XD45,A0A1U7LLR0,A0A4S2MWZ7,K1VVQ6,A0A158P1R9,G7DVX0,V6R0U9,G4N9J3,E3KLI3,B7Q5I1,A0A1E3QC61,D5GGK8,S8ANP9,A0A139AUH8,L2GMR6,U4LBG4,A0A177URI1,O74957,A0A3N4IGK1,A6N7Y9,A0A0E9NDK5,T1KZ60,A0A2G8JLH3,Q5KAT1,L2GUF2,W2T741,A0A1W0E4B5,A0A2J7QB22,S4RYE2,A0A388KES6,A0A226EFL3,A0A3S3PD82,A0A0L0TEV1,A0A1S3J512,G0QTT2,A0A1J1HRI1,C4V9J2,Q9JMB7,A0A075AN09,Q5TW24,U5HIG6,A0A401PRI6,Q96J94,A0A2B4RHN2,G2QEV0,A0A397UU01,A0A2T7PFL8,K7ISV0,A0A024FT57,H3HCL6,A0A0G4IME3,E9FUN9,A0A1S3CYL5,D7FQK3,A0A1Y1YHC8,T1GSU4,F4S231,A0A1D8PMK0,A0A2G5B1D8,Q5BD61,A0A1C7M8P2,A0A4D8YSQ3,A0A158PJG6,J9JZ66,A0A0C2XG51,A0A158QZT6,A0A165QYQ9,T0SAU8,R7YY92,A0A3S1A0C3,A0A074YJ47,A0A2K1J482,A0A1Q3ENA6,O04379,A0A371I3C8,M8AEW7,A8P0D4,A0A2K3NY65,F4NYW7,A0A409Y6G2,A0A0L0HAB7,D8PZT7,A0A1D1W4K0,A7RQ46,W4YU94,A7BJS5,D8SNM6,A0A1J8PPA3,X1WG39,M5FQK2,Q69VD5,A0A2R6NSC2,A0A0D8XL16,A0A016WPN3,Q9QZ81,G5EES3,A0A0K0EFP6,Q8CJG0,A0A1D5NTU6,V2WTL2,A0A0V0YLH8,A0A139WDH0,A0A0R3W9Q7,H3DS31,A0A1Y1HWP2,G4T5G9,B7QCC4,A0A0B2UV00,M7BCJ9,E9GN30,Q7PZ41,A0A077Z361,R7U9I3,A0A1X7V1N5,A0A0K0JDP1,A0A0N4UKJ1,A0A498N3A3,A0A3M0IQP5,A0A0L8GBV4,Q32KD4,A0A1J1JBJ0,E0W4C3,A0A482XDA9,A0A3P7EJD6,J9K2Z4,A0A2J7Q8V4,T1IBM6,V3ZRX0,A0A210QKF7,A0A423TSS1,K1PT78,A0A267E8R7,A0A1D2N447,A0A226D7A9,F6YK55,T1KTE4,A0A2C9JGZ6,A0A1V9X9F0,K5X5Z7,A0A3Q0KUG5,T1FY40,1YVU,1Z26,5AWH,5G5T,7R8K,C4L1M1,A0A0M2PXX3,A0A326U7G5,A0A1T4Y3A2,R6KUL9,A0A2G9DT08,Q9L1X1,A0A060HNJ0,R5XQK4,A0A496APJ8,A0A062U2W9,H0HWQ5,A0A1V9G9U4,F8ERC7,S7VLM7,A0A1A5X8H4,A0A1I2T6Q1,A0A1R3T9N6,A0A0Q2M2Z1,H8KXJ0,A0A2D1U4H7,A0A0B7I4Z6,A0LL61,A0A139WY18,A0A2T1E1K4,A0A1Q8ZD62,A0A4Q6XKV6,A0A1Z3HNN4,A0A239JE83,A0A2N4XBY2,R5JEI2,A0A0Q0ZC47,A0A2T0XH18,A0A1V4CHV0,A0A1K1RQP7,A0A1N6LUI7,A0A0P0NGR6,A0A1X7IML5,A0A0A2LKJ7,K1L112,A0A0U3AL92,A0A1H3A054,A0A0C5JKF3,R5NJJ8,A5D4D9,A0A142Y7A9,A0A432MEQ5,A0A372DKU2,C1F5Q7,A0A4R3EV39,A0A1P8WP90,A0A222F7P0,A0A1C9VH88,A0A2T2YMB1,A0A101R2A0,A0A1E3XF49,A0A1U9ND56,A0A4R7BQC4,E0TGY3,A0A259TUP4,F6EYI8,A0A2S9Q9J0,A0A4Q2UIU6,A0A1H0LH25,A0A318LG42,H1YCU5,A0A1Q5ZS75,M0AF24,A0A1W2A082,A0A1H3X247,A0A0C1XUA0,M0D2X3,A0A2R5G167,A0A346PK63,R7RTW6,A0A1H2RBI2,A0A1C3ZXN2,B9LVP8,M5RSF0,B7K585,F8D8G0,A0A343TL88,A0A343JEE2,A0A3P3RGE5,A0A329TBQ3,A0A0W1S8B8,L9VRQ2,E4NRV1,A0A1I6HGN0,A0A1I0NI68,,",366,37
"838","N.S11.10","N.S12.3",330,173,157,2.33336401457973,"4F3T,4KRE,5GUH,5VM9,6KR6,6OON,7KX7,A0A196SDB4,J9D5G4,C4LVV2,A0A2P6N8X7,A2DPV7,A0A0G4H2S4,T1H8B3,S4RWI0,D2VMG4,A0A0D1ZAJ4,Q1K660,F4PH46,A0A3M7S814,A0A164ZA52,A0A383WDW5,Q54G64,S7WCF7,I0YVB2,R7QGN7,C1DZY0,A0A2C5Z0M1,R9ACY5,D3BMP8,A0A1Z5TVE5,W7XD45,A0A1U7LLR0,A0A4S2MWZ7,K1VVQ6,A0A158P1R9,G7DVX0,V6R0U9,G4N9J3,E3KLI3,B7Q5I1,A0A1E3QC61,D5GGK8,S8ANP9,A0A139AUH8,L2GMR6,U4LBG4,A0A177URI1,O74957,A0A3N4IGK1,A6N7Y9,A0A0E9NDK5,T1KZ60,A0A250WXN5,Q5KAT1,L2GUF2,W2T741,A0A1W0E4B5,A0A2J7QB22,S4RYE2,A0A2K3CW87,A0A388KES6,A0A226EFL3,A0A3S3PD82,A0A0L0TEV1,A0A1S3J512,G0QTT2,A0A1J1HRI1,C4V9J2,Q9JMB7,A0A075AN09,Q5TW24,U5HIG6,A0A401PRI6,Q96J94,A0A2B4RHN2,G2QEV0,A0A397UU01,A0A2T7PFL8,K7ISV0,A0A024FT57,H3HCL6,A0A0G4IME3,E9FUN9,A0A1S3CYL5,D7FQK3,A0A1Y1YHC8,T1GSU4,F4S231,A0A1D8PMK0,A0A2G5B1D8,Q5BD61,A0A1C7M8P2,A0A4D8YSQ3,A0A158PJG6,J9JZ66,A0A0C2XG51,A0A158QZT6,A0A165QYQ9,T0SAU8,R7YY92,A0A3S1A0C3,A0A074YJ47,A0A2K1J482,A0A1Q3ENA6,O04379,A0A371I3C8,M8AEW7,A8P0D4,A0A2K3NY65,F4NYW7,A0A409Y6G2,A0A0L0HAB7,D8PZT7,A0A1D1W4K0,A7RQ46,W4YU94,A7BJS5,D8SNM6,A0A1J8PPA3,X1WG39,M5FQK2,Q69VD5,A0A2R6NSC2,A0A0D8XL16,A0A016WPN3,Q9QZ81,G5EES3,A0A0K0EFP6,Q8CJG0,A0A1D5NTU6,V2WTL2,A0A0V0YLH8,A0A139WDH0,A0A0R3W9Q7,H3DS31,A0A1Y1HWP2,G4T5G9,B7QCC4,A0A0B2UV00,M7BCJ9,E9GN30,Q7PZ41,A0A077Z361,R7U9I3,A0A1X7V1N5,A0A0K0JDP1,A0A0N4UKJ1,A0A498N3A3,A0A3M0IQP5,A0A0L8GBV4,Q32KD4,A0A1J1JBJ0,E0W4C3,A0A482XDA9,A0A3P7EJD6,J9K2Z4,A0A2J7Q8V4,T1IBM6,V3ZRX0,A0A210QKF7,A0A423TSS1,K1PT78,A0A267E8R7,A0A1D2N447,A0A226D7A9,F6YK55,T1KTE4,A0A2C9JGZ6,A0A1V9X9F0,K5X5Z7,A0A3Q0KUG5,T1FY40,1Z26,3DLB,5AWH,5G5T,5I4A,A0A1I7IXT4,A0A2W1JZ37,A0A2S7WBN3,A0A420DFE6,A0A4V1VDY2,A0A368P5I0,C4L1M1,A0A4R1RMM2,A0A1Y2RDH8,A0A1M5ZSR3,A0A0K8QX04,A0A1I3LMA1,K9TPA9,A0A1L3JHM3,A0A1W6MIP2,A0A2U2J9E0,B1XJG0,A0A3D8L290,K9U8J6,A0A097QRL6,K9RC91,A0A0D8ZUC0,A0A139XGN8,A0A1T4Y3A2,A0A0B0H9B4,A0YYT3,A0A2T1EFY0,G6FTN0,R6KUL9,A0A433NB65,A0A1Z4L0A1,K9UQR0,A0A2T1G8M7,K9VUN0,B7GJX9,K9ZDE3,B0JXD6,A0A2T1LS63,A0A1Z4K1Y3,A0A1N6SSK9,A0A0P4UVI8,A0A0V7ZCG4,A0A1J0AGK2,K9PFF9,A0A2G9DT08,K9UEV4,Q9L1X1,A0A060HNJ0,A0A235B542,R5XQK4,A0A1H3LE92,A0A496APJ8,A0A062U2W9,H0HWQ5,A0A1V9G9U4,A0A1I2ZGP1,A0A317EJY3,A0A1I2BD20,F8ERC7,S7VLM7,A0A1A5X8H4,A0A1I2T6Q1,A0A1R3T9N6,A0A0Q2M2Z1,H8KXJ0,D3S0S6,A0A2D1U4H7,I3TE64,A0A0B7I4Z6,A0LL61,Q8DKB1,A0A139WY18,A0A1J1EK56,A0A2T1E1K4,A0A1Q8ZD62,A0A4Q6XKV6,A0A1Z3HNN4,A0A239JE83,A0A2N4XBY2,Q53W94,R5JEI2,A0A0Q0ZC47,A0A2T0XH18,A0A1V4CHV0,A0A1K1RQP7,A0A2T1EKT1,A0A1N6LUI7,A0A0P0NGR6,A0A1X7IML5,A0A0A2LKJ7,K1L112,A0A0U3AL92,A0A1H3A054,E0UCX3,K9XZC6,B9LVW4,A0A0C1VHB4,Q31N05,A0A0C5JKF3,R5NJJ8,A5D4D9,Q2JI93,A0A372DKU2,A0A3R7KLK4,C1F5Q7,A0A4R3EV39,A0A1P8WP90,A0A222F7P0,A0A1C9VH88,A0A329TD61,A0A101R2A0,A0A1E3XF49,A0A1U9ND56,A0A4R7BQC4,A0A1H3DGN3,A0A1Q1FPH0,E0TGY3,A0A259TUP4,F6EYI8,A0A2S9Q9J0,A0A4Q2UIU6,A0A1H0LH25,A0A318LG42,H1YCU5,L0JS08,A0A1Q5ZS75,A0A345E7N0,M0AF24,A0A1W2A082,A0A1H3X247,A0A0C1XUA0,M0D2X3,A0A2R5G167,A0A346PK63,A0A1H2RBI2,B9LVP8,M5RSF0,W0JW77,B7K585,F8D8G0,A0A343TL88,L0AJX6,A0A2A5QS34,A0A3P3RGE5,A0A329TBQ3,A0A285N2A8,A0A0W1S8B8,A0A1V4C8L7,L9VRQ2,E4NRV1,A0A1I6HGN0,A0A1I0NI68,,",366,37
"840","N.S13.2","N.S14.2",245,173,72,5.05900770712909,"4F1N,4F3T,4KRE,5GUH,5VM9,6KR6,6OON,7KX7,7SWF,A0A163JTZ6,A0A196SDB4,J9D5G4,A0A0G4H2S4,T1H8B3,S4RWI0,D2VMG4,A0A074TLL7,Q1K660,F4PH46,A0A3M7S814,A0A164ZA52,A0A383WDW5,Q54G64,S7WCF7,I0YVB2,R7QGN7,C1DZY0,A0A2C5Z0M1,A0CB11,R9ACY5,D3BMP8,W7XD45,A0A1U7LLR0,A0A4S2MWZ7,K1VVQ6,A0A158P1R9,G7DVX0,V6R0U9,G4N9J3,E3KLI3,B7Q5I1,A0A1E3QC61,D5GGK8,S8ANP9,A0A139AUH8,L2GMR6,U4LBG4,A0A177URI1,O74957,A0A3N4IGK1,A6N7Y9,T1KZ60,A0A250WXN5,A0A2G8JLH3,Q5KAT1,L2GUF2,W2T741,A0A1W0E4B5,A0A2J7QB22,S4RYE2,A0A2K3CW87,A0A388KES6,A0A226EFL3,A0A3S3PD82,A0A0L0TEV1,A0A1S3J512,G0QTT2,A0A1J1HRI1,C4V9J2,Q9JMB7,A0A075AN09,Q5TW24,U5HIG6,A0A401PRI6,Q96J94,A0A2B4RHN2,G2QEV0,A0A397UU01,A0A2T7PFL8,K7ISV0,A0A024FT57,H3HCL6,A0A0G4IME3,E9FUN9,A0A1S3CYL5,D7FQK3,A0A1Y1YHC8,T1GSU4,F4S231,A0A1D8PMK0,A0A2G5B1D8,Q5BD61,A0A1C7M8P2,A0A4D8YSQ3,A0A158PJG6,J9JZ66,A0A0C2XG51,A0A158QZT6,A0A165QYQ9,T0SAU8,R7YY92,A0A3S1A0C3,A0A074YJ47,A0A2K1J482,A0A1Q3ENA6,O04379,A0A371I3C8,M8AEW7,A8P0D4,A0A2K3NY65,F4NYW7,A0A409Y6G2,A0A0L0HAB7,D8PZT7,A0A1D1W4K0,A7RQ46,W4YU94,A7BJS5,D8SNM6,A0A1J8PPA3,X1WG39,M5FQK2,Q69VD5,A0A2R6NSC2,A0A0D8XL16,A0A016WPN3,Q9QZ81,G5EES3,A0A0K0EFP6,Q8CJG0,A0A1D5NTU6,V2WTL2,A0A0V0YLH8,A0A139WDH0,A0A0R3W9Q7,H3DS31,A0A1Y1HWP2,G4T5G9,B7QCC4,A0A0B2UV00,M7BCJ9,E9GN30,Q7PZ41,A0A077Z361,R7U9I3,A0A1X7V1N5,A0A0K0JDP1,A0A0N4UKJ1,A0A498N3A3,A0A3M0IQP5,A0A0L8GBV4,Q32KD4,A0A1J1JBJ0,E0W4C3,A0A482XDA9,A0A3P7EJD6,J9K2Z4,A0A2J7Q8V4,T1IBM6,V3ZRX0,A0A210QKF7,A0A423TSS1,K1PT78,A0A267E8R7,A0A1D2N447,A0A226D7A9,F6YK55,T1KTE4,A0A2C9JGZ6,A0A1V9X9F0,K5X5Z7,A0A3Q0KUG5,T1FY40,1YVU,1Z26,3DLB,5AWH,5G5T,5I4A,6QZK,C4L1M1,A0A1I3LMA1,B1XJG0,H1KXR6,A0A0B0H9B4,R6KUL9,B7GJX9,A0A1N6SSK9,A0A060HNJ0,A0A235B542,R5XQK4,A0A1H3LE92,A0A496APJ8,A0A1V9G9U4,A0A317EJY3,F8ERC7,A0A0Q2M2Z1,Q8DKB1,A0A139WY18,A0A1J1EK56,A0A2T1E1K4,A0A1Q8ZD62,A0A1Z3HNN4,Q53W94,A0A2T1EKT1,E0UCX3,K9XZC6,B9LVW4,A0A0C1VHB4,Q31N05,R5NJJ8,Q2JI93,A0A432MEQ5,A0A1E3XF49,H1YCU5,L0JS08,A0A1Q5ZS75,M0AF24,A0A1W2A082,A0A1H3X247,A0A0C1XUA0,M0D2X3,A0A2R5G167,A0A346PK63,R7RTW6,A0A1H2RBI2,A0A1C3ZXN2,B9LVP8,M5RSF0,W0JW77,B7K585,F8D8G0,A0A343TL88,L0AJX6,A0A2A5QS34,A0A343JEE2,A0A3P3RGE5,A0A329TBQ3,A0A285N2A8,A0A0W1S8B8,A0A1V4C8L7,L9VRQ2,E4NRV1,A0A1I6HGN0,A0A1I0NI68,,",366,37
"841","N.S3.5","N.S5.2",275,173,102,4.33837696928482,"4F1N,4F3T,4KRE,5GUH,5VM9,6KR6,6OON,7KX7,7SWF,A0A0N4X8S8,A0A196SDB4,Q389P5,C4LVV2,A0A2P6N8X7,A2DPV7,T1H8B3,S4RWI0,D2VMG4,A0A0D1ZAJ4,Q1K660,F4PH46,A0A164ZA52,A0A383WDW5,Q54G64,S7WCF7,I0YVB2,R7QGN7,C1DZY0,A0A2C5Z0M1,A0CB11,R9ACY5,D3BMP8,A0A1Z5TVE5,W7XD45,A0A1U7LLR0,A0A4S2MWZ7,K1VVQ6,A0A158P1R9,G7DVX0,V6R0U9,G4N9J3,E3KLI3,B7Q5I1,A0A1E3QC61,D5GGK8,S8ANP9,A0A139AUH8,L2GMR6,U4LBG4,A0A177URI1,O74957,A0A3N4IGK1,A6N7Y9,A0A0E9NDK5,A0A250WXN5,A0A2G8JLH3,Q5KAT1,L2GUF2,A0A1W0E4B5,A0A2J7QB22,S4RYE2,A0A2K3CW87,A0A388KES6,A0A226EFL3,A0A3S3PD82,A0A0L0TEV1,A0A1S3J512,G0QTT2,A0A1J1HRI1,C4V9J2,Q9JMB7,A0A075AN09,Q5TW24,U5HIG6,A0A401PRI6,Q96J94,A0A2B4RHN2,G2QEV0,A0A397UU01,A0A2T7PFL8,K7ISV0,A0A024FT57,A0A0G4IME3,E9FUN9,A0A1S3CYL5,D7FQK3,A0A1Y1YHC8,T1GSU4,F4S231,A0A1D8PMK0,A0A2G5B1D8,Q5BD61,A0A1C7M8P2,A0A4D8YSQ3,A0A158PJG6,J9JZ66,A0A0C2XG51,A0A158QZT6,A0A165QYQ9,T0SAU8,R7YY92,A0A3S1A0C3,A0A074YJ47,A0A2K1J482,A0A1Q3ENA6,O04379,A0A371I3C8,M8AEW7,A8P0D4,A0A2K3NY65,F4NYW7,A0A409Y6G2,A0A0L0HAB7,D8PZT7,A0A1D1W4K0,A7RQ46,W4YU94,A7BJS5,D8SNM6,A0A1J8PPA3,X1WG39,M5FQK2,Q69VD5,A0A2R6NSC2,A0A0D8XL16,A0A016WPN3,Q9QZ81,G5EES3,A0A0K0EFP6,Q8CJG0,A0A1D5NTU6,V2WTL2,A0A0V0YLH8,A0A139WDH0,A0A0R3W9Q7,H3DS31,A0A1Y1HWP2,G4T5G9,B7QCC4,A0A0B2UV00,M7BCJ9,E9GN30,Q7PZ41,A0A077Z361,R7U9I3,A0A1X7V1N5,A0A0K0JDP1,A0A0N4UKJ1,A0A498N3A3,A0A3M0IQP5,A0A0L8GBV4,Q32KD4,A0A1J1JBJ0,E0W4C3,A0A482XDA9,A0A3P7EJD6,J9K2Z4,A0A2J7Q8V4,T1IBM6,V3ZRX0,A0A210QKF7,A0A423TSS1,K1PT78,A0A267E8R7,A0A1D2N447,A0A226D7A9,F6YK55,T1KTE4,A0A2C9JGZ6,A0A1V9X9F0,K5X5Z7,A0A3Q0KUG5,T1FY40,1YVU,1Z26,3DLB,5AWH,5G5T,5I4A,6QZK,A0A1I3LMA1,A0A1L3JHM3,A0A1W6MIP2,A0A2U2J9E0,A0A0B0H9B4,R6KUL9,B7GJX9,A0A0P6X5X2,A0A1N6SSK9,A0A060HNJ0,A0A235B542,R5XQK4,S7VLM7,A0A0Q2M2Z1,H8KXJ0,D3S0S6,A0A2D1U4H7,I3TE64,A0A0B7I4Z6,A0LL61,Q8DKB1,A0A1J1EK56,A0A4Q6XKV6,A0A239JE83,A0A2N4XBY2,Q53W94,R5JEI2,A0A0Q0ZC47,A0A2T0XH18,A0A1V4CHV0,A0A1K1RQP7,A0A2T1EKT1,A0A1N6LUI7,A0A0P0NGR6,A0A1X7IML5,A0A0A2LKJ7,K1L112,A0A0U3AL92,A0A1H3A054,E0UCX3,K9XZC6,B9LVW4,A0A0C1VHB4,Q31N05,A0A0C5JKF3,R5NJJ8,A5D4D9,Q2JI93,A0A142Y7A9,A0A372DKU2,C1F5Q7,A0A4R3EV39,A0A1P8WP90,A0A222F7P0,A0A1C9VH88,A0A2T2YMB1,A0A329TD61,A0A101R2A0,A0A1U9ND56,A0A4R7BQC4,A0A1H3DGN3,A0A1Q1FPH0,E0TGY3,A0A259TUP4,F6EYI8,A0A2S9Q9J0,A0A4Q2UIU6,A0A1H0LH25,A0A318LG42,L0JS08,A0A345E7N0,M0AF24,A0A1H3X247,M0D2X3,A0A2R5G167,A0A346PK63,R7RTW6,B9LVP8,M5RSF0,W0JW77,B7K585,F8D8G0,A0A343TL88,L0AJX6,A0A2A5QS34,A0A343JEE2,A0A3P3RGE5,A0A329TBQ3,A0A285N2A8,A0A0W1S8B8,A0A1V4C8L7,L9VRQ2,E4NRV1,A0A1I6HGN0,A0A1I0NI68,,",366,37
"842","C.H1.12","C.H1.15",304,174,130,3.21273209549072,"4F1N,4F3T,4KRE,5GUH,5VM9,6KR6,6OON,7KX7,7SWF,A0A163JTZ6,A0A0N4X8S8,A0A196SDB4,J9D5G4,A0A2P6N8X7,T1H8B3,S4RWI0,D2VMG4,A0A074TLL7,A0A0D1ZAJ4,Q1K660,F4PH46,A0A3M7S814,A0A164ZA52,A0A383WDW5,Q54G64,S7WCF7,I0YVB2,R7QGN7,A0A2C5Z0M1,R9ACY5,D3BMP8,A0A1Z5TVE5,W7XD45,A0A1U7LLR0,A0A4S2MWZ7,K1VVQ6,A0A158P1R9,G7DVX0,V6R0U9,G4N9J3,E3KLI3,B7Q5I1,A0A1E3QC61,D5GGK8,S8ANP9,A0A139AUH8,L2GMR6,U4LBG4,A0A177URI1,O74957,A0A3N4IGK1,A6N7Y9,A0A0E9NDK5,T1KZ60,A0A250WXN5,A0A2G8JLH3,Q5KAT1,L2GUF2,W2T741,A0A1W0E4B5,A0A2J7QB22,S4RYE2,A0A2K3CW87,A0A388KES6,A0A226EFL3,A0A3S3PD82,A0A0L0TEV1,A0A1S3J512,G0QTT2,A0A1J1HRI1,C4V9J2,Q9JMB7,A0A075AN09,Q5TW24,U5HIG6,A0A401PRI6,Q96J94,A0A2B4RHN2,G2QEV0,A0A397UU01,A0A2T7PFL8,K7ISV0,A0A024FT57,H3HCL6,A0A0G4IME3,E9FUN9,A0A1S3CYL5,D7FQK3,A0A1Y1YHC8,T1GSU4,F4S231,A0A1D8PMK0,A0A2G5B1D8,Q5BD61,A0A1C7M8P2,A0A4D8YSQ3,A0A158PJG6,J9JZ66,A0A0C2XG51,A0A158QZT6,A0A165QYQ9,T0SAU8,R7YY92,A0A3S1A0C3,A0A074YJ47,A0A2K1J482,A0A1Q3ENA6,O04379,A0A371I3C8,M8AEW7,A8P0D4,A0A2K3NY65,F4NYW7,A0A409Y6G2,A0A0L0HAB7,D8PZT7,A0A1D1W4K0,A7RQ46,W4YU94,A7BJS5,D8SNM6,A0A1J8PPA3,X1WG39,M5FQK2,Q69VD5,A0A2R6NSC2,A0A0D8XL16,A0A016WPN3,Q9QZ81,G5EES3,A0A0K0EFP6,Q8CJG0,A0A1D5NTU6,V2WTL2,A0A0V0YLH8,A0A139WDH0,A0A0R3W9Q7,H3DS31,A0A1Y1HWP2,G4T5G9,B7QCC4,A0A0B2UV00,M7BCJ9,E9GN30,Q7PZ41,A0A077Z361,R7U9I3,A0A1X7V1N5,A0A0K0JDP1,A0A0N4UKJ1,A0A498N3A3,A0A3M0IQP5,A0A0L8GBV4,Q32KD4,A0A1J1JBJ0,E0W4C3,A0A482XDA9,A0A3P7EJD6,J9K2Z4,A0A2J7Q8V4,T1IBM6,V3ZRX0,A0A210QKF7,A0A423TSS1,K1PT78,A0A267E8R7,A0A1D2N447,A0A226D7A9,F6YK55,T1KTE4,A0A2C9JGZ6,A0A1V9X9F0,K5X5Z7,A0A3Q0KUG5,1YVU,1Z26,3DLB,5AWH,5G5T,5I4A,6QZK,7R8K,C4L1M1,A0A1I3LMA1,A0A142XB92,B1XJG0,A0A097QRL6,A0A1T4Y3A2,B6YTQ5,A0A0B0H9B4,R6KUL9,B7GJX9,A0A1N6SSK9,A0A2G9DT08,Q9L1X1,A0A235B542,R5XQK4,A0A1H3LE92,A0A496APJ8,A0A062U2W9,H0HWQ5,A0A1V9G9U4,A0A1I2ZGP1,A0A317EJY3,A0A1I2BD20,F8ERC7,S7VLM7,A0A1A5X8H4,A0A1I2T6Q1,A0A1R3T9N6,A0A0Q2M2Z1,H8KXJ0,D3S0S6,A0A2D1U4H7,I3TE64,A0A0B7I4Z6,A0LL61,Q8DKB1,A0A139WY18,A0A1J1EK56,A0A2T1E1K4,A0A1Q8ZD62,A0A4Q6XKV6,A0A1Z3HNN4,A0A239JE83,A0A2N4XBY2,Q53W94,R5JEI2,A0A0Q0ZC47,A0A2T0XH18,A0A1V4CHV0,A0A1K1RQP7,A0A2T1EKT1,A0A1N6LUI7,A0A0P0NGR6,A0A1X7IML5,A0A0A2LKJ7,K1L112,A0A0U3AL92,A0A1H3A054,E0UCX3,K9XZC6,A0A0C1VHB4,Q31N05,A0A0C5JKF3,R5NJJ8,A5D4D9,Q2JI93,A0A142Y7A9,A0A432MEQ5,A0A372DKU2,A0A3R7KLK4,C1F5Q7,A0A4R3EV39,A0A1P8WP90,A0A222F7P0,A0A1C9VH88,A0A2T2YMB1,A0A329TD61,A0A101R2A0,A0A1E3XF49,A0A1U9ND56,A0A4R7BQC4,A0A1H3DGN3,A0A1Q1FPH0,E0TGY3,A0A259TUP4,F6EYI8,A0A2S9Q9J0,A0A4Q2UIU6,A0A1H0LH25,A0A318LG42,H1YCU5,L0JS08,A0A1Q5ZS75,A0A345E7N0,M0AF24,A0A1W2A082,A0A1H3X247,A0A0C1XUA0,M0D2X3,A0A2R5G167,A0A346PK63,R7RTW6,A0A1H2RBI2,A0A1C3ZXN2,B9LVP8,M5RSF0,W0JW77,B7K585,F8D8G0,A0A343TL88,L0AJX6,A0A2A5QS34,A0A343JEE2,A0A3P3RGE5,A0A329TBQ3,A0A285N2A8,A0A0W1S8B8,A0A1V4C8L7,L9VRQ2,E4NRV1,A0A1I6HGN0,A0A1I0NI68,,",366,37
"843","C.H10.10","C.H10.14",282,174,108,3.00462962962963,"4F1N,4F3T,4KRE,5GUH,5VM9,6KR6,6OON,7KX7,7SWF,A0A163JTZ6,J9D5G4,A0A2P6N8X7,A8BCK6,A2DPV7,A0A0G4H2S4,D2VMG4,A0A074TLL7,A0A0D1ZAJ4,Q1K660,F4PH46,A0A3M7S814,A0A164ZA52,Q54G64,S7WCF7,I0YVB2,R7QGN7,C1DZY0,A0A2C5Z0M1,A0CB11,R9ACY5,D3BMP8,A0A1Z5TVE5,W7XD45,A0A1U7LLR0,A0A4S2MWZ7,K1VVQ6,A0A158P1R9,G7DVX0,V6R0U9,G4N9J3,E3KLI3,B7Q5I1,A0A1E3QC61,D5GGK8,S8ANP9,A0A139AUH8,L2GMR6,U4LBG4,A0A177URI1,O74957,A0A3N4IGK1,A6N7Y9,A0A0E9NDK5,T1KZ60,A0A250WXN5,A0A2G8JLH3,Q5KAT1,L2GUF2,W2T741,A0A1W0E4B5,A0A2J7QB22,S4RYE2,A0A2K3CW87,A0A388KES6,A0A226EFL3,A0A3S3PD82,A0A0L0TEV1,A0A1S3J512,G0QTT2,A0A1J1HRI1,C4V9J2,Q9JMB7,A0A075AN09,Q5TW24,U5HIG6,A0A401PRI6,Q96J94,A0A2B4RHN2,G2QEV0,A0A397UU01,A0A2T7PFL8,K7ISV0,A0A024FT57,H3HCL6,A0A0G4IME3,E9FUN9,A0A1S3CYL5,D7FQK3,A0A1Y1YHC8,T1GSU4,F4S231,A0A1D8PMK0,A0A2G5B1D8,Q5BD61,A0A1C7M8P2,A0A4D8YSQ3,A0A158PJG6,J9JZ66,A0A0C2XG51,A0A158QZT6,A0A165QYQ9,T0SAU8,R7YY92,A0A3S1A0C3,A0A074YJ47,A0A2K1J482,A0A1Q3ENA6,O04379,A0A371I3C8,M8AEW7,A8P0D4,A0A2K3NY65,F4NYW7,A0A409Y6G2,A0A0L0HAB7,D8PZT7,A0A1D1W4K0,A7RQ46,W4YU94,A7BJS5,D8SNM6,A0A1J8PPA3,X1WG39,Q69VD5,A0A2R6NSC2,A0A0D8XL16,A0A016WPN3,Q9QZ81,G5EES3,A0A0K0EFP6,Q8CJG0,A0A1D5NTU6,V2WTL2,A0A0V0YLH8,A0A139WDH0,A0A0R3W9Q7,H3DS31,A0A1Y1HWP2,G4T5G9,B7QCC4,A0A0B2UV00,M7BCJ9,E9GN30,Q7PZ41,A0A077Z361,R7U9I3,A0A1X7V1N5,A0A0K0JDP1,A0A0N4UKJ1,A0A498N3A3,A0A3M0IQP5,A0A0L8GBV4,Q32KD4,A0A1J1JBJ0,E0W4C3,A0A482XDA9,A0A3P7EJD6,J9K2Z4,A0A2J7Q8V4,T1IBM6,V3ZRX0,A0A210QKF7,A0A423TSS1,K1PT78,A0A267E8R7,A0A1D2N447,A0A226D7A9,F6YK55,T1KTE4,A0A2C9JGZ6,A0A1V9X9F0,K5X5Z7,A0A3Q0KUG5,T1FY40,1Z26,5AWH,5G5T,6QZK,A0A1I7IXT4,A0A2W1JZ37,A0A2S7WBN3,A0A420DFE6,E0ST67,A0A4V1VDY2,A0A368P5I0,C4L1M1,A0A4R1RMM2,A0A1Y2RDH8,Q11QW7,A0A1M5ZSR3,A0A0K8QX04,A0A1L3JHM3,A0A1W6MIP2,A0A2U2J9E0,B1XJG0,A0A3D8L290,H1KXR6,A0A1T4Y3A2,B6YTQ5,A0A0B0H9B4,R6KUL9,B7GJX9,A0A1N6SSK9,A0A2G9DT08,Q9L1X1,A0A060HNJ0,A0A235B542,A0A496APJ8,A0A1V9G9U4,A0A1A5X8H4,A0A1I2T6Q1,A0A1R3T9N6,A0A0Q2M2Z1,H8KXJ0,A0A2D1U4H7,I3TE64,A0A0B7I4Z6,A0LL61,A0A139WY18,A0A1J1EK56,A0A2T1E1K4,A0A1Q8ZD62,A0A4Q6XKV6,A0A1Z3HNN4,A0A239JE83,A0A2N4XBY2,Q53W94,R5JEI2,A0A0Q0ZC47,A0A2T0XH18,A0A1V4CHV0,A0A1K1RQP7,A0A1N6LUI7,A0A0P0NGR6,A0A1X7IML5,A0A0A2LKJ7,K1L112,A0A0U3AL92,A0A1H3A054,E0UCX3,K9XZC6,A0A0C1VHB4,A0A0C5JKF3,A5D4D9,A0A142Y7A9,A0A432MEQ5,A0A372DKU2,C1F5Q7,A0A4R3EV39,A0A1P8WP90,A0A222F7P0,A0A1C9VH88,A0A2T2YMB1,A0A329TD61,A0A101R2A0,A0A1U9ND56,A0A4R7BQC4,A0A1Q1FPH0,E0TGY3,A0A259TUP4,F6EYI8,A0A2S9Q9J0,A0A4Q2UIU6,A0A1H0LH25,A0A318LG42,A0A2R5G167,A0A346PK63,B9LVP8,M5RSF0,W0JW77,B7K585,F8D8G0,A0A343TL88,L0AJX6,A0A3P3RGE5,A0A329TBQ3,A0A285N2A8,A0A0W1S8B8,A0A1V4C8L7,L9VRQ2,E4NRV1,A0A1I6HGN0,,",366,37
"844","C.H10.8","C.S8.7",249,174,75,3.65310344827586,"4F1N,4KRE,5GUH,5VM9,6KR6,6OON,7KX7,7SWF,A0A163JTZ6,J9D5G4,C4LVV2,A0A2P6N8X7,A8BCK6,A2DPV7,A0A0G4H2S4,R1FDF0,D2VMG4,A0A074TLL7,A0A0D1ZAJ4,Q1K660,F4PH46,A0A3M7S814,A0A164ZA52,A0A383WDW5,Q54G64,S7WCF7,I0YVB2,R7QGN7,C1DZY0,A0A2C5Z0M1,A0CB11,R9ACY5,D3BMP8,A0A1Z5TVE5,W7XD45,A0A4S2MWZ7,K1VVQ6,A0A158P1R9,G7DVX0,V6R0U9,G4N9J3,E3KLI3,B7Q5I1,A0A1E3QC61,D5GGK8,S8ANP9,A0A139AUH8,L2GMR6,U4LBG4,A0A177URI1,O74957,A0A3N4IGK1,A6N7Y9,A0A0E9NDK5,T1KZ60,A0A250WXN5,A0A2G8JLH3,Q5KAT1,L2GUF2,W2T741,A0A1W0E4B5,A0A2J7QB22,S4RYE2,A0A2K3CW87,A0A388KES6,A0A226EFL3,A0A3S3PD82,A0A0L0TEV1,A0A1S3J512,G0QTT2,A0A1J1HRI1,C4V9J2,Q9JMB7,A0A075AN09,Q5TW24,U5HIG6,A0A401PRI6,Q96J94,A0A2B4RHN2,A0A397UU01,A0A2T7PFL8,K7ISV0,A0A024FT57,H3HCL6,A0A0G4IME3,E9FUN9,A0A1S3CYL5,D7FQK3,A0A1Y1YHC8,T1GSU4,F4S231,A0A1D8PMK0,A0A2G5B1D8,Q5BD61,A0A1C7M8P2,A0A4D8YSQ3,A0A158PJG6,J9JZ66,A0A0C2XG51,A0A158QZT6,A0A165QYQ9,T0SAU8,R7YY92,A0A3S1A0C3,A0A074YJ47,A0A2K1J482,A0A1Q3ENA6,O04379,A0A371I3C8,M8AEW7,A8P0D4,A0A2K3NY65,F4NYW7,A0A409Y6G2,A0A0L0HAB7,D8PZT7,A0A1D1W4K0,A7RQ46,W4YU94,A7BJS5,D8SNM6,A0A1J8PPA3,X1WG39,M5FQK2,Q69VD5,A0A2R6NSC2,A0A0D8XL16,A0A016WPN3,Q9QZ81,G5EES3,A0A0K0EFP6,Q8CJG0,A0A1D5NTU6,V2WTL2,A0A0V0YLH8,A0A139WDH0,A0A0R3W9Q7,H3DS31,A0A1Y1HWP2,G4T5G9,B7QCC4,A0A0B2UV00,M7BCJ9,E9GN30,Q7PZ41,A0A077Z361,R7U9I3,A0A1X7V1N5,A0A0K0JDP1,A0A0N4UKJ1,A0A3M0IQP5,A0A0L8GBV4,Q32KD4,A0A1J1JBJ0,E0W4C3,A0A482XDA9,A0A3P7EJD6,J9K2Z4,A0A2J7Q8V4,T1IBM6,V3ZRX0,A0A210QKF7,A0A423TSS1,K1PT78,A0A267E8R7,A0A1D2N447,A0A226D7A9,F6YK55,T1KTE4,A0A2C9JGZ6,A0A1V9X9F0,K5X5Z7,A0A3Q0KUG5,T1FY40,1YVU,1Z26,5AWH,5G5T,5I4A,E0ST67,C4L1M1,A0A1M5ZSR3,A0A0M2PXX3,A0A1C0UUC4,A0A2Z6E1D5,A0A0F4NXW8,A0A142XB92,L8D0R3,B1XJG0,H1KXR6,A0A1Q4R485,A0A097QRL6,K9RC91,A0A0D8ZUC0,A0A1T4Y3A2,B6YTQ5,A0A0B0H9B4,A0A2T1EFY0,G6FTN0,R6KUL9,A0A433NB65,K9UQR0,K9VUN0,B7GJX9,B0JXD6,A0A1Z4K1Y3,A0A2Z6E0R7,A0A1N6SSK9,A0A0P4UVI8,A0A1J0AGK2,K9UEV4,A0A060HNJ0,A0A235B542,A0A1H3LE92,A0A062U2W9,H0HWQ5,A0A0Q2M2Z1,D3S0S6,I3TE64,A0LL61,Q8DKB1,A0A2T1EKT1,E0UCX3,K9XZC6,A0A0C1VHB4,Q31N05,R5NJJ8,Q2JI93,A0A4R3EV39,A0A1C9VH88,A0A1Q1FPH0,L0JS08,M0AF24,M0D2X3,A0A346PK63,R7RTW6,W0JW77,A0A343TL88,L0AJX6,A0A2A5QS34,A0A343JEE2,A0A3P3RGE5,A0A329TBQ3,A0A285N2A8,A0A0W1S8B8,A0A1V4C8L7,L9VRQ2,E4NRV1,A0A1I6HGN0,,",366,37
"848","C.H3.2","C.H3.6",302,174,128,4.03758081896552,"4F1N,4F3T,4KRE,5GUH,5VM9,6KR6,6OON,7KX7,7SWF,A0A163JTZ6,J9D5G4,Q389P5,A8BCK6,A0A0G4H2S4,T1H8B3,S4RWI0,D2VMG4,A0A074TLL7,A0A0D1ZAJ4,Q1K660,F4PH46,A0A3M7S814,A0A164ZA52,A0A383WDW5,Q54G64,S7WCF7,I0YVB2,R7QGN7,C1DZY0,A0CB11,R9ACY5,D3BMP8,A0A1Z5TVE5,W7XD45,A0A1U7LLR0,A0A4S2MWZ7,K1VVQ6,A0A158P1R9,G7DVX0,V6R0U9,G4N9J3,E3KLI3,B7Q5I1,A0A1E3QC61,D5GGK8,S8ANP9,A0A139AUH8,L2GMR6,U4LBG4,A0A177URI1,O74957,A0A3N4IGK1,A6N7Y9,A0A0E9NDK5,T1KZ60,A0A250WXN5,A0A2G8JLH3,Q5KAT1,L2GUF2,W2T741,A0A1W0E4B5,A0A2J7QB22,S4RYE2,A0A2K3CW87,A0A388KES6,A0A226EFL3,A0A3S3PD82,A0A0L0TEV1,A0A1S3J512,G0QTT2,A0A1J1HRI1,C4V9J2,Q9JMB7,A0A075AN09,Q5TW24,U5HIG6,A0A401PRI6,Q96J94,A0A2B4RHN2,G2QEV0,A0A397UU01,A0A2T7PFL8,K7ISV0,A0A024FT57,H3HCL6,A0A0G4IME3,E9FUN9,A0A1S3CYL5,D7FQK3,A0A1Y1YHC8,A0A1D8PMK0,A0A2G5B1D8,Q5BD61,A0A1C7M8P2,A0A4D8YSQ3,A0A158PJG6,J9JZ66,A0A0C2XG51,A0A158QZT6,A0A165QYQ9,T0SAU8,R7YY92,A0A3S1A0C3,A0A074YJ47,A0A2K1J482,A0A1Q3ENA6,O04379,A0A371I3C8,M8AEW7,A8P0D4,A0A2K3NY65,F4NYW7,A0A409Y6G2,A0A0L0HAB7,D8PZT7,A0A1D1W4K0,A7RQ46,W4YU94,A7BJS5,D8SNM6,A0A1J8PPA3,X1WG39,M5FQK2,Q69VD5,A0A2R6NSC2,A0A0D8XL16,A0A016WPN3,Q9QZ81,G5EES3,A0A0K0EFP6,Q8CJG0,A0A1D5NTU6,V2WTL2,A0A0V0YLH8,A0A139WDH0,A0A0R3W9Q7,H3DS31,A0A1Y1HWP2,G4T5G9,B7QCC4,A0A0B2UV00,M7BCJ9,E9GN30,Q7PZ41,A0A077Z361,R7U9I3,A0A1X7V1N5,A0A0K0JDP1,A0A0N4UKJ1,A0A498N3A3,A0A3M0IQP5,A0A0L8GBV4,Q32KD4,A0A1J1JBJ0,E0W4C3,A0A482XDA9,A0A3P7EJD6,J9K2Z4,A0A2J7Q8V4,T1IBM6,V3ZRX0,A0A210QKF7,A0A423TSS1,K1PT78,A0A267E8R7,A0A1D2N447,A0A226D7A9,F6YK55,T1KTE4,A0A2C9JGZ6,A0A1V9X9F0,K5X5Z7,A0A3Q0KUG5,T1FY40,1YVU,1Z26,3DLB,5AWH,6QZK,E8N0K8,A0A328VKE4,Q11QW7,A0A0M2PXX3,K9TPA9,A0A1C0UUC4,A0A142XB92,B1XJG0,A0A326U7G5,A0A1Q4R485,K9U8J6,K9RC91,A0A0D8ZUC0,A0A139XGN8,A0A1T4Y3A2,B6YTQ5,A0YYT3,A0A2T1EFY0,G6FTN0,A0A433NB65,A0A1Z4L0A1,K9UQR0,A0A2T1G8M7,K9VUN0,K9ZDE3,B0JXD6,A0A2T1LS63,A0A1Z4K1Y3,A0A0P4UVI8,A0A0V7ZCG4,A0A1J0AGK2,K9PFF9,A0A2G9DT08,K9UEV4,Q9L1X1,A0A496APJ8,A0A1V9G9U4,S7VLM7,A0A1A5X8H4,A0A1I2T6Q1,A0A1R3T9N6,H8KXJ0,A0A2D1U4H7,A0A0B7I4Z6,A0LL61,Q8DKB1,A0A139WY18,A0A1J1EK56,A0A2T1E1K4,A0A1Q8ZD62,A0A4Q6XKV6,A0A1Z3HNN4,A0A239JE83,A0A2N4XBY2,Q53W94,R5JEI2,A0A0Q0ZC47,A0A2T0XH18,A0A1V4CHV0,A0A1K1RQP7,A0A2T1EKT1,A0A1N6LUI7,A0A0P0NGR6,A0A1X7IML5,A0A0A2LKJ7,K1L112,A0A0U3AL92,A0A1H3A054,E0UCX3,K9XZC6,A0A0C1VHB4,Q31N05,A0A0C5JKF3,R5NJJ8,A5D4D9,Q2JI93,A0A142Y7A9,A0A432MEQ5,A0A372DKU2,C1F5Q7,A0A4R3EV39,A0A1P8WP90,A0A222F7P0,A0A1C9VH88,A0A2T2YMB1,A0A329TD61,A0A101R2A0,A0A1U9ND56,A0A4R7BQC4,A0A1Q1FPH0,E0TGY3,A0A259TUP4,F6EYI8,A0A2S9Q9J0,A0A4Q2UIU6,A0A1H0LH25,A0A318LG42,H1YCU5,L0JS08,A0A1Q5ZS75,A0A345E7N0,M0AF24,A0A1W2A082,M0D2X3,A0A2R5G167,A0A346PK63,R7RTW6,A0A1H2RBI2,B9LVP8,M5RSF0,B7K585,F8D8G0,A0A343TL88,A0A343JEE2,A0A3P3RGE5,A0A329TBQ3,A0A285N2A8,A0A0W1S8B8,A0A1V4C8L7,L9VRQ2,E4NRV1,A0A1I6HGN0,A0A1I0NI68,,",366,37
"852","C.H9.1","C.H9.5",325,174,151,1.99670777194184,"4F1N,4F3T,4KRE,5GUH,5VM9,6KR6,6OON,7KX7,7SWF,A0A163JTZ6,J9D5G4,Q389P5,A0A2P6N8X7,R1FDF0,D2VMG4,A0A074TLL7,Q1K660,F4PH46,A0A3M7S814,A0A164ZA52,A0A383WDW5,Q54G64,S7WCF7,I0YVB2,R7QGN7,C1DZY0,A0A2C5Z0M1,A0CB11,R9ACY5,D3BMP8,A0A1Z5TVE5,W7XD45,A0A1U7LLR0,A0A4S2MWZ7,K1VVQ6,A0A158P1R9,G7DVX0,V6R0U9,G4N9J3,E3KLI3,B7Q5I1,A0A1E3QC61,D5GGK8,S8ANP9,A0A139AUH8,L2GMR6,U4LBG4,A0A177URI1,O74957,A0A3N4IGK1,A6N7Y9,A0A0E9NDK5,T1KZ60,A0A250WXN5,A0A2G8JLH3,Q5KAT1,L2GUF2,W2T741,A0A1W0E4B5,A0A2J7QB22,S4RYE2,A0A2K3CW87,A0A388KES6,A0A226EFL3,A0A3S3PD82,A0A0L0TEV1,A0A1S3J512,G0QTT2,A0A1J1HRI1,C4V9J2,Q9JMB7,A0A075AN09,Q5TW24,U5HIG6,A0A401PRI6,Q96J94,A0A2B4RHN2,G2QEV0,A0A397UU01,A0A2T7PFL8,K7ISV0,A0A024FT57,H3HCL6,A0A0G4IME3,E9FUN9,A0A1S3CYL5,D7FQK3,A0A1Y1YHC8,T1GSU4,F4S231,A0A1D8PMK0,A0A2G5B1D8,Q5BD61,A0A1C7M8P2,A0A4D8YSQ3,A0A158PJG6,J9JZ66,A0A0C2XG51,A0A158QZT6,A0A165QYQ9,T0SAU8,R7YY92,A0A3S1A0C3,A0A074YJ47,A0A2K1J482,A0A1Q3ENA6,O04379,A0A371I3C8,M8AEW7,A8P0D4,A0A2K3NY65,F4NYW7,A0A409Y6G2,A0A0L0HAB7,D8PZT7,A0A1D1W4K0,A7RQ46,W4YU94,A7BJS5,D8SNM6,A0A1J8PPA3,X1WG39,M5FQK2,Q69VD5,A0A2R6NSC2,A0A0D8XL16,A0A016WPN3,Q9QZ81,G5EES3,A0A0K0EFP6,Q8CJG0,A0A1D5NTU6,V2WTL2,A0A0V0YLH8,A0A139WDH0,A0A0R3W9Q7,H3DS31,A0A1Y1HWP2,G4T5G9,B7QCC4,A0A0B2UV00,M7BCJ9,E9GN30,Q7PZ41,A0A077Z361,R7U9I3,A0A1X7V1N5,A0A0K0JDP1,A0A0N4UKJ1,A0A498N3A3,A0A3M0IQP5,A0A0L8GBV4,Q32KD4,A0A1J1JBJ0,E0W4C3,A0A482XDA9,A0A3P7EJD6,J9K2Z4,A0A2J7Q8V4,T1IBM6,V3ZRX0,A0A210QKF7,A0A423TSS1,K1PT78,A0A267E8R7,A0A1D2N447,A0A226D7A9,F6YK55,T1KTE4,A0A2C9JGZ6,A0A1V9X9F0,K5X5Z7,A0A3Q0KUG5,T1FY40,1YVU,3DLB,5AWH,5I4A,6QZK,7R8K,A0A328VKE4,E0ST67,Q11QW7,A0A1M5ZSR3,A0A0K8QX04,K9TPA9,A0A2Z6E1D5,A0A0F4NXW8,L8D0R3,B1XJG0,A0A326U7G5,A0A1Q4R485,K9U8J6,K9RC91,A0A0D8ZUC0,A0A139XGN8,A0A1T4Y3A2,Q5P0R2,A0YYT3,A0A2T1EFY0,G6FTN0,A0A433NB65,A0A1Z4L0A1,K9UQR0,A0A2T1G8M7,K9VUN0,A0A0P6X5X2,K9ZDE3,B0JXD6,A0A2T1LS63,A0A1Z4K1Y3,A0A2Z6E0R7,A0A0P4UVI8,A0A0V7ZCG4,A0A1J0AGK2,K9PFF9,A0A2G9DT08,K9UEV4,Q9L1X1,A0A060HNJ0,A0A1H3LE92,A0A496APJ8,A0A062U2W9,H0HWQ5,A0A1V9G9U4,A0A1I2ZGP1,A0A317EJY3,A0A1I2BD20,F8ERC7,S7VLM7,A0A1A5X8H4,A0A1I2T6Q1,A0A1R3T9N6,H8KXJ0,A0A2D1U4H7,A0A0B7I4Z6,A0LL61,Q8DKB1,A0A139WY18,A0A1J1EK56,A0A2T1E1K4,A0A1Q8ZD62,A0A4Q6XKV6,A0A1Z3HNN4,A0A239JE83,A0A2N4XBY2,Q53W94,R5JEI2,A0A0Q0ZC47,A0A2T0XH18,A0A1V4CHV0,A0A1K1RQP7,A0A2T1EKT1,A0A1N6LUI7,A0A0P0NGR6,A0A1X7IML5,A0A0A2LKJ7,K1L112,A0A0U3AL92,A0A1H3A054,E0UCX3,K9XZC6,B9LVW4,A0A0C1VHB4,Q31N05,A0A0C5JKF3,R5NJJ8,A5D4D9,Q2JI93,A0A142Y7A9,A0A432MEQ5,A0A372DKU2,A0A3R7KLK4,C1F5Q7,A0A4R3EV39,A0A1P8WP90,A0A222F7P0,A0A1C9VH88,A0A2T2YMB1,A0A329TD61,A0A101R2A0,A0A1E3XF49,A0A1U9ND56,A0A4R7BQC4,A0A1H3DGN3,A0A1Q1FPH0,E0TGY3,A0A259TUP4,F6EYI8,A0A2S9Q9J0,A0A4Q2UIU6,A0A1H0LH25,A0A318LG42,H1YCU5,L0JS08,A0A1Q5ZS75,A0A345E7N0,M0AF24,A0A1W2A082,A0A1H3X247,A0A0C1XUA0,M0D2X3,A0A2R5G167,A0A346PK63,R7RTW6,A0A1H2RBI2,A0A1C3ZXN2,B9LVP8,M5RSF0,W0JW77,B7K585,F8D8G0,A0A343TL88,L0AJX6,A0A2A5QS34,A0A343JEE2,A0A3P3RGE5,A0A329TBQ3,A0A285N2A8,A0A0W1S8B8,A0A1V4C8L7,L9VRQ2,E4NRV1,A0A1I6HGN0,A0A1I0NI68,,",366,37
"855","C.H9.3","C.H9.5",341,174,167,1.86241310482483,"4F1N,4F3T,4KRE,5GUH,5VM9,6KR6,6OON,7KX7,7SWF,A0A163JTZ6,J9D5G4,Q389P5,C4LVV2,A0A2P6N8X7,R1FDF0,D2VMG4,A0A074TLL7,A0A0D1ZAJ4,Q1K660,F4PH46,A0A3M7S814,A0A164ZA52,A0A383WDW5,Q54G64,I0YVB2,R7QGN7,C1DZY0,A0A2C5Z0M1,A0CB11,R9ACY5,D3BMP8,A0A1Z5TVE5,W7XD45,A0A1U7LLR0,A0A4S2MWZ7,K1VVQ6,A0A158P1R9,G7DVX0,V6R0U9,G4N9J3,E3KLI3,B7Q5I1,A0A1E3QC61,D5GGK8,S8ANP9,A0A139AUH8,L2GMR6,U4LBG4,A0A177URI1,O74957,A0A3N4IGK1,A6N7Y9,A0A0E9NDK5,T1KZ60,A0A250WXN5,A0A2G8JLH3,Q5KAT1,W2T741,A0A1W0E4B5,A0A2J7QB22,S4RYE2,A0A2K3CW87,A0A388KES6,A0A226EFL3,A0A3S3PD82,A0A0L0TEV1,A0A1S3J512,G0QTT2,A0A1J1HRI1,C4V9J2,Q9JMB7,A0A075AN09,Q5TW24,U5HIG6,A0A401PRI6,Q96J94,A0A2B4RHN2,G2QEV0,A0A397UU01,A0A2T7PFL8,K7ISV0,A0A024FT57,H3HCL6,A0A0G4IME3,E9FUN9,A0A1S3CYL5,D7FQK3,A0A1Y1YHC8,T1GSU4,F4S231,A0A1D8PMK0,A0A2G5B1D8,Q5BD61,A0A1C7M8P2,A0A4D8YSQ3,A0A158PJG6,J9JZ66,A0A0C2XG51,A0A158QZT6,A0A165QYQ9,T0SAU8,R7YY92,A0A3S1A0C3,A0A074YJ47,A0A2K1J482,A0A1Q3ENA6,O04379,A0A371I3C8,M8AEW7,A8P0D4,A0A2K3NY65,F4NYW7,A0A409Y6G2,A0A0L0HAB7,D8PZT7,A0A1D1W4K0,A7RQ46,W4YU94,A7BJS5,D8SNM6,A0A1J8PPA3,X1WG39,M5FQK2,Q69VD5,A0A2R6NSC2,A0A0D8XL16,A0A016WPN3,Q9QZ81,G5EES3,A0A0K0EFP6,Q8CJG0,A0A1D5NTU6,V2WTL2,A0A0V0YLH8,A0A139WDH0,A0A0R3W9Q7,H3DS31,A0A1Y1HWP2,G4T5G9,B7QCC4,A0A0B2UV00,M7BCJ9,E9GN30,Q7PZ41,A0A077Z361,R7U9I3,A0A1X7V1N5,A0A0K0JDP1,A0A0N4UKJ1,A0A498N3A3,A0A3M0IQP5,A0A0L8GBV4,Q32KD4,A0A1J1JBJ0,E0W4C3,A0A482XDA9,A0A3P7EJD6,J9K2Z4,A0A2J7Q8V4,T1IBM6,V3ZRX0,A0A210QKF7,A0A423TSS1,K1PT78,A0A267E8R7,A0A1D2N447,A0A226D7A9,F6YK55,T1KTE4,A0A2C9JGZ6,A0A1V9X9F0,K5X5Z7,A0A3Q0KUG5,T1FY40,1YVU,1Z26,3DLB,5AWH,5G5T,5I4A,6QZK,7R8K,A0A328VKE4,E0ST67,C4L1M1,A0A0M2PXX3,K9TPA9,A0A1C0UUC4,A0A2Z6E1D5,A0A0F4NXW8,A0A142XB92,L8D0R3,B1XJG0,A0A326U7G5,A0A3D8L290,H1KXR6,A0A1Q4R485,K9U8J6,A0A097QRL6,K9RC91,A0A0D8ZUC0,A0A139XGN8,A0A1T4Y3A2,Q5P0R2,B6YTQ5,A0A0B0H9B4,A0YYT3,A0A2T1EFY0,G6FTN0,R6KUL9,A0A433NB65,A0A1Z4L0A1,K9UQR0,A0A2T1G8M7,K9VUN0,B7GJX9,A0A0P6X5X2,K9ZDE3,B0JXD6,A0A2T1LS63,A0A1Z4K1Y3,A0A2Z6E0R7,A0A1N6SSK9,A0A0P4UVI8,A0A0V7ZCG4,A0A1J0AGK2,K9PFF9,A0A2G9DT08,K9UEV4,Q9L1X1,A0A060HNJ0,A0A235B542,R5XQK4,A0A1H3LE92,A0A496APJ8,A0A062U2W9,H0HWQ5,A0A1V9G9U4,A0A1I2ZGP1,A0A317EJY3,A0A1I2BD20,F8ERC7,S7VLM7,A0A1A5X8H4,A0A1I2T6Q1,A0A1R3T9N6,A0A0Q2M2Z1,H8KXJ0,D3S0S6,A0A2D1U4H7,I3TE64,A0A0B7I4Z6,A0LL61,Q8DKB1,A0A139WY18,A0A1J1EK56,A0A2T1E1K4,A0A1Q8ZD62,A0A4Q6XKV6,A0A1Z3HNN4,A0A239JE83,A0A2N4XBY2,Q53W94,R5JEI2,A0A0Q0ZC47,A0A2T0XH18,A0A1V4CHV0,A0A1K1RQP7,A0A2T1EKT1,A0A1N6LUI7,A0A0P0NGR6,A0A1X7IML5,A0A0A2LKJ7,K1L112,A0A0U3AL92,A0A1H3A054,E0UCX3,K9XZC6,B9LVW4,A0A0C1VHB4,Q31N05,A0A0C5JKF3,R5NJJ8,A5D4D9,Q2JI93,A0A142Y7A9,A0A432MEQ5,A0A372DKU2,A0A3R7KLK4,C1F5Q7,A0A4R3EV39,A0A1P8WP90,A0A222F7P0,A0A1C9VH88,A0A2T2YMB1,A0A329TD61,A0A101R2A0,A0A1E3XF49,A0A1U9ND56,A0A4R7BQC4,A0A1H3DGN3,A0A1Q1FPH0,E0TGY3,A0A259TUP4,F6EYI8,A0A2S9Q9J0,A0A4Q2UIU6,A0A1H0LH25,A0A318LG42,H1YCU5,L0JS08,A0A1Q5ZS75,A0A345E7N0,M0AF24,A0A1W2A082,A0A1H3X247,A0A0C1XUA0,M0D2X3,A0A2R5G167,A0A346PK63,R7RTW6,A0A1H2RBI2,A0A1C3ZXN2,B9LVP8,M5RSF0,W0JW77,B7K585,F8D8G0,A0A343TL88,L0AJX6,A0A2A5QS34,A0A343JEE2,A0A3P3RGE5,A0A329TBQ3,A0A285N2A8,A0A0W1S8B8,A0A1V4C8L7,L9VRQ2,E4NRV1,A0A1I6HGN0,A0A1I0NI68,,",366,37
"857","C.L18.1","C.S8.6",261,174,87,2.00287356321839,"4F1N,4F3T,4KRE,5GUH,5VM9,6KR6,6OON,7KX7,7SWF,A0A163JTZ6,A0A0N4X8S8,A0A196SDB4,A0A2P6N8X7,A8BCK6,A2DPV7,A0A0G4H2S4,T1H8B3,R1FDF0,S4RWI0,D2VMG4,A0A074TLL7,A0A0D1ZAJ4,Q1K660,F4PH46,A0A3M7S814,A0A164ZA52,A0A383WDW5,Q54G64,S7WCF7,I0YVB2,R7QGN7,C1DZY0,A0A2C5Z0M1,A0CB11,R9ACY5,D3BMP8,A0A1Z5TVE5,W7XD45,A0A1U7LLR0,A0A4S2MWZ7,K1VVQ6,A0A158P1R9,G7DVX0,V6R0U9,G4N9J3,E3KLI3,B7Q5I1,A0A1E3QC61,D5GGK8,S8ANP9,A0A139AUH8,U4LBG4,A0A177URI1,O74957,A0A3N4IGK1,A6N7Y9,A0A0E9NDK5,T1KZ60,A0A250WXN5,A0A2G8JLH3,Q5KAT1,L2GUF2,W2T741,A0A2J7QB22,A0A2K3CW87,A0A226EFL3,A0A3S3PD82,A0A0L0TEV1,A0A1S3J512,G0QTT2,A0A1J1HRI1,Q9JMB7,A0A075AN09,Q5TW24,U5HIG6,A0A401PRI6,Q96J94,A0A2B4RHN2,G2QEV0,A0A397UU01,A0A2T7PFL8,K7ISV0,A0A024FT57,H3HCL6,A0A0G4IME3,E9FUN9,A0A1S3CYL5,D7FQK3,A0A1Y1YHC8,T1GSU4,F4S231,A0A1D8PMK0,A0A2G5B1D8,Q5BD61,A0A1C7M8P2,A0A4D8YSQ3,A0A158PJG6,J9JZ66,A0A0C2XG51,A0A158QZT6,A0A165QYQ9,T0SAU8,R7YY92,A0A3S1A0C3,A0A074YJ47,A0A2K1J482,A0A1Q3ENA6,O04379,A0A371I3C8,A8P0D4,A0A2K3NY65,F4NYW7,A0A409Y6G2,A0A0L0HAB7,D8PZT7,A0A1D1W4K0,A7RQ46,W4YU94,A7BJS5,D8SNM6,A0A1J8PPA3,X1WG39,M5FQK2,Q69VD5,A0A2R6NSC2,A0A0D8XL16,A0A016WPN3,Q9QZ81,G5EES3,A0A0K0EFP6,Q8CJG0,A0A1D5NTU6,V2WTL2,A0A0V0YLH8,A0A139WDH0,A0A0R3W9Q7,H3DS31,A0A1Y1HWP2,G4T5G9,B7QCC4,A0A0B2UV00,M7BCJ9,E9GN30,Q7PZ41,A0A077Z361,R7U9I3,A0A1X7V1N5,A0A0K0JDP1,A0A0N4UKJ1,A0A498N3A3,A0A3M0IQP5,A0A0L8GBV4,Q32KD4,A0A1J1JBJ0,E0W4C3,A0A482XDA9,A0A3P7EJD6,J9K2Z4,A0A2J7Q8V4,T1IBM6,V3ZRX0,A0A210QKF7,A0A423TSS1,K1PT78,A0A267E8R7,A0A1D2N447,A0A226D7A9,F6YK55,T1KTE4,A0A2C9JGZ6,A0A1V9X9F0,K5X5Z7,A0A3Q0KUG5,T1FY40,1YVU,5I4A,6QZK,7R8K,E0ST67,C4L1M1,A0A0M2PXX3,A0A1I3LMA1,A0A1C0UUC4,A0A142XB92,B1XJG0,A0A097QRL6,A0A1T4Y3A2,B6YTQ5,A0A0B0H9B4,R6KUL9,B7GJX9,A0A1N6SSK9,A0A2G9DT08,Q9L1X1,A0A060HNJ0,A0A235B542,R5XQK4,A0A1H3LE92,A0A062U2W9,H0HWQ5,A0A1I2ZGP1,A0A317EJY3,A0A1I2BD20,F8ERC7,A0A1A5X8H4,A0A1I2T6Q1,H8KXJ0,D3S0S6,A0LL61,Q8DKB1,A0A1J1EK56,Q53W94,A0A1V4CHV0,A0A2T1EKT1,A0A1N6LUI7,E0UCX3,K9XZC6,A0A0C1VHB4,Q31N05,R5NJJ8,A5D4D9,Q2JI93,A0A142Y7A9,A0A3R7KLK4,C1F5Q7,A0A4R3EV39,A0A222F7P0,A0A329TD61,A0A101R2A0,A0A1E3XF49,A0A1U9ND56,A0A4R7BQC4,A0A1H3DGN3,A0A1Q1FPH0,E0TGY3,F6EYI8,A0A4Q2UIU6,A0A1H0LH25,A0A318LG42,H1YCU5,L0JS08,A0A1Q5ZS75,A0A345E7N0,M0AF24,A0A1H3X247,A0A0C1XUA0,M0D2X3,A0A346PK63,R7RTW6,A0A1H2RBI2,A0A1C3ZXN2,B9LVP8,A0A343TL88,A0A343JEE2,A0A3P3RGE5,A0A329TBQ3,A0A0W1S8B8,A0A1V4C8L7,L9VRQ2,E4NRV1,A0A1I6HGN0,,",366,37
"858","C.L21.14","C.L21.16",324,174,150,1.2383908045977,"4F1N,4F3T,4KRE,5GUH,6KR6,6OON,7KX7,7SWF,A0A163JTZ6,A0A0N4X8S8,J9D5G4,Q389P5,C4LVV2,A2DPV7,A0A0G4H2S4,T1H8B3,D2VMG4,A0A074TLL7,A0A0D1ZAJ4,Q1K660,F4PH46,A0A3M7S814,A0A164ZA52,A0A383WDW5,Q54G64,S7WCF7,R7QGN7,C1DZY0,A0A2C5Z0M1,A0CB11,R9ACY5,D3BMP8,A0A1Z5TVE5,W7XD45,A0A1U7LLR0,A0A4S2MWZ7,K1VVQ6,A0A158P1R9,G7DVX0,V6R0U9,G4N9J3,B7Q5I1,A0A1E3QC61,D5GGK8,S8ANP9,A0A139AUH8,L2GMR6,U4LBG4,A0A177URI1,O74957,A0A3N4IGK1,A6N7Y9,A0A0E9NDK5,T1KZ60,A0A250WXN5,A0A2G8JLH3,Q5KAT1,L2GUF2,W2T741,A0A1W0E4B5,A0A2J7QB22,S4RYE2,A0A2K3CW87,A0A388KES6,A0A226EFL3,A0A3S3PD82,A0A0L0TEV1,A0A1S3J512,G0QTT2,A0A1J1HRI1,C4V9J2,Q9JMB7,A0A075AN09,Q5TW24,U5HIG6,A0A401PRI6,Q96J94,A0A2B4RHN2,G2QEV0,A0A397UU01,A0A2T7PFL8,K7ISV0,A0A024FT57,H3HCL6,A0A0G4IME3,E9FUN9,A0A1S3CYL5,D7FQK3,A0A1Y1YHC8,T1GSU4,A0A1D8PMK0,A0A2G5B1D8,Q5BD61,A0A1C7M8P2,A0A4D8YSQ3,A0A158PJG6,J9JZ66,A0A0C2XG51,A0A158QZT6,A0A165QYQ9,T0SAU8,R7YY92,A0A3S1A0C3,A0A074YJ47,A0A2K1J482,A0A1Q3ENA6,O04379,A0A371I3C8,M8AEW7,A8P0D4,A0A2K3NY65,F4NYW7,A0A409Y6G2,A0A0L0HAB7,D8PZT7,A0A1D1W4K0,A7RQ46,W4YU94,A7BJS5,D8SNM6,A0A1J8PPA3,X1WG39,M5FQK2,Q69VD5,A0A2R6NSC2,A0A0D8XL16,A0A016WPN3,Q9QZ81,G5EES3,A0A0K0EFP6,Q8CJG0,A0A1D5NTU6,V2WTL2,A0A0V0YLH8,A0A139WDH0,A0A0R3W9Q7,H3DS31,A0A1Y1HWP2,G4T5G9,B7QCC4,A0A0B2UV00,M7BCJ9,E9GN30,Q7PZ41,A0A077Z361,R7U9I3,A0A1X7V1N5,A0A0K0JDP1,A0A0N4UKJ1,A0A498N3A3,A0A3M0IQP5,A0A0L8GBV4,Q32KD4,A0A1J1JBJ0,E0W4C3,A0A482XDA9,A0A3P7EJD6,J9K2Z4,A0A2J7Q8V4,T1IBM6,V3ZRX0,A0A210QKF7,A0A423TSS1,K1PT78,A0A267E8R7,A0A1D2N447,A0A226D7A9,F6YK55,T1KTE4,A0A2C9JGZ6,A0A1V9X9F0,K5X5Z7,A0A3Q0KUG5,T1FY40,1YVU,5AWH,5I4A,6QZK,7R8K,E8N0K8,A0A1I7IXT4,A0A2W1JZ37,A0A2S7WBN3,A0A328VKE4,A0A420DFE6,E0ST67,A0A4V1VDY2,A0A368P5I0,C4L1M1,A0A4R1RMM2,A0A1Y2RDH8,Q11QW7,A0A1M5ZSR3,A0A0K8QX04,K9TPA9,A0A1L3JHM3,A0A1W6MIP2,A0A2U2J9E0,A0A2Z6E1D5,A0A0F4NXW8,A0A142XB92,L8D0R3,B1XJG0,A0A326U7G5,A0A3D8L290,A0A1Q4R485,K9U8J6,K9RC91,A0A0D8ZUC0,A0A139XGN8,A0A1T4Y3A2,Q5P0R2,A0A0B0H9B4,A0YYT3,A0A2T1EFY0,G6FTN0,R6KUL9,A0A433NB65,A0A1Z4L0A1,K9UQR0,A0A2T1G8M7,K9VUN0,B7GJX9,A0A0P6X5X2,K9ZDE3,B0JXD6,A0A2T1LS63,A0A1Z4K1Y3,A0A2Z6E0R7,A0A0P4UVI8,A0A0V7ZCG4,A0A1J0AGK2,K9PFF9,A0A2G9DT08,K9UEV4,Q9L1X1,A0A235B542,R5XQK4,A0A496APJ8,A0A062U2W9,H0HWQ5,A0A1V9G9U4,A0A1I2ZGP1,A0A317EJY3,A0A1I2BD20,F8ERC7,S7VLM7,A0A1A5X8H4,A0A1I2T6Q1,A0A1R3T9N6,H8KXJ0,A0A2D1U4H7,A0A0B7I4Z6,A0LL61,Q8DKB1,A0A139WY18,A0A1J1EK56,A0A2T1E1K4,A0A1Q8ZD62,A0A4Q6XKV6,A0A1Z3HNN4,A0A239JE83,A0A2N4XBY2,Q53W94,R5JEI2,A0A0Q0ZC47,A0A2T0XH18,A0A1V4CHV0,A0A1K1RQP7,A0A2T1EKT1,A0A0P0NGR6,A0A1X7IML5,A0A0A2LKJ7,K1L112,A0A0U3AL92,A0A1H3A054,E0UCX3,A0A0C1VHB4,Q31N05,A0A0C5JKF3,R5NJJ8,A5D4D9,Q2JI93,A0A142Y7A9,A0A432MEQ5,A0A372DKU2,A0A3R7KLK4,C1F5Q7,A0A4R3EV39,A0A1P8WP90,A0A222F7P0,A0A1C9VH88,A0A2T2YMB1,A0A329TD61,A0A101R2A0,A0A1E3XF49,A0A1U9ND56,A0A4R7BQC4,A0A1H3DGN3,A0A1Q1FPH0,E0TGY3,A0A259TUP4,F6EYI8,A0A2S9Q9J0,A0A4Q2UIU6,H1YCU5,A0A1Q5ZS75,A0A345E7N0,M0AF24,A0A1W2A082,A0A1H3X247,A0A0C1XUA0,M0D2X3,A0A2R5G167,A0A346PK63,R7RTW6,A0A1H2RBI2,A0A1C3ZXN2,B9LVP8,M5RSF0,B7K585,L0AJX6,A0A2A5QS34,A0A343JEE2,,",366,37
"860","C.S14.3","C.S15.3",335,174,161,2.4524344970372,"4F1N,4F3T,4KRE,5GUH,5VM9,6KR6,6OON,7KX7,7SWF,A0A163JTZ6,A0A0N4X8S8,A0A196SDB4,Q389P5,C4LVV2,A2DPV7,A0A0G4H2S4,R1FDF0,D2VMG4,A0A074TLL7,A0A0D1ZAJ4,Q1K660,F4PH46,A0A3M7S814,A0A164ZA52,A0A383WDW5,Q54G64,S7WCF7,I0YVB2,R7QGN7,C1DZY0,A0A2C5Z0M1,A0CB11,R9ACY5,D3BMP8,A0A1Z5TVE5,W7XD45,A0A1U7LLR0,A0A4S2MWZ7,K1VVQ6,A0A158P1R9,G7DVX0,V6R0U9,G4N9J3,E3KLI3,A0A1E3QC61,D5GGK8,S8ANP9,A0A139AUH8,U4LBG4,A0A177URI1,O74957,A0A3N4IGK1,A6N7Y9,A0A0E9NDK5,T1KZ60,A0A250WXN5,A0A2G8JLH3,Q5KAT1,L2GUF2,W2T741,A0A2J7QB22,S4RYE2,A0A2K3CW87,A0A388KES6,A0A226EFL3,A0A3S3PD82,A0A0L0TEV1,A0A1S3J512,G0QTT2,A0A1J1HRI1,Q9JMB7,A0A075AN09,Q5TW24,U5HIG6,A0A401PRI6,Q96J94,A0A2B4RHN2,G2QEV0,A0A397UU01,A0A2T7PFL8,K7ISV0,A0A024FT57,H3HCL6,A0A0G4IME3,E9FUN9,A0A1S3CYL5,D7FQK3,A0A1Y1YHC8,T1GSU4,F4S231,A0A1D8PMK0,A0A2G5B1D8,Q5BD61,A0A1C7M8P2,A0A4D8YSQ3,A0A158PJG6,J9JZ66,A0A0C2XG51,A0A158QZT6,A0A165QYQ9,T0SAU8,R7YY92,A0A3S1A0C3,A0A074YJ47,A0A2K1J482,A0A1Q3ENA6,O04379,A0A371I3C8,M8AEW7,A8P0D4,A0A2K3NY65,F4NYW7,A0A409Y6G2,A0A0L0HAB7,D8PZT7,A0A1D1W4K0,A7RQ46,W4YU94,A7BJS5,D8SNM6,A0A1J8PPA3,X1WG39,M5FQK2,Q69VD5,A0A2R6NSC2,A0A0D8XL16,A0A016WPN3,Q9QZ81,G5EES3,A0A0K0EFP6,Q8CJG0,A0A1D5NTU6,V2WTL2,A0A0V0YLH8,A0A139WDH0,A0A0R3W9Q7,H3DS31,A0A1Y1HWP2,G4T5G9,B7QCC4,A0A0B2UV00,M7BCJ9,E9GN30,Q7PZ41,A0A077Z361,R7U9I3,A0A1X7V1N5,A0A0K0JDP1,A0A0N4UKJ1,A0A498N3A3,A0A3M0IQP5,A0A0L8GBV4,Q32KD4,A0A1J1JBJ0,E0W4C3,A0A482XDA9,A0A3P7EJD6,J9K2Z4,A0A2J7Q8V4,T1IBM6,V3ZRX0,A0A210QKF7,A0A423TSS1,K1PT78,A0A267E8R7,A0A1D2N447,A0A226D7A9,F6YK55,T1KTE4,A0A2C9JGZ6,A0A1V9X9F0,K5X5Z7,A0A3Q0KUG5,T1FY40,1YVU,1Z26,3DLB,5AWH,5G5T,5I4A,6QZK,7R8K,E8N0K8,A0A1I7IXT4,A0A2W1JZ37,A0A2S7WBN3,A0A328VKE4,A0A420DFE6,E0ST67,A0A4V1VDY2,A0A368P5I0,A0A4R1RMM2,A0A1Y2RDH8,Q11QW7,A0A1M5ZSR3,A0A0K8QX04,K9TPA9,A0A1L3JHM3,A0A1W6MIP2,A0A2U2J9E0,A0A2Z6E1D5,A0A326U7G5,A0A3D8L290,A0A1Q4R485,K9U8J6,A0A097QRL6,K9RC91,A0A0D8ZUC0,A0A139XGN8,A0A1T4Y3A2,Q5P0R2,B6YTQ5,A0YYT3,A0A2T1EFY0,G6FTN0,A0A433NB65,A0A1Z4L0A1,K9UQR0,A0A2T1G8M7,K9VUN0,A0A0P6X5X2,K9ZDE3,B0JXD6,A0A2T1LS63,A0A1Z4K1Y3,A0A2Z6E0R7,A0A0P4UVI8,A0A0V7ZCG4,A0A1J0AGK2,K9PFF9,A0A2G9DT08,K9UEV4,Q9L1X1,A0A060HNJ0,A0A1H3LE92,A0A496APJ8,A0A062U2W9,H0HWQ5,A0A1V9G9U4,A0A1I2ZGP1,A0A317EJY3,A0A1I2BD20,F8ERC7,S7VLM7,A0A1A5X8H4,A0A1I2T6Q1,A0A1R3T9N6,A0A0Q2M2Z1,H8KXJ0,D3S0S6,A0A2D1U4H7,I3TE64,A0A0B7I4Z6,A0LL61,A0A139WY18,A0A1J1EK56,A0A2T1E1K4,A0A1Q8ZD62,A0A4Q6XKV6,A0A1Z3HNN4,A0A239JE83,A0A2N4XBY2,Q53W94,R5JEI2,A0A0Q0ZC47,A0A2T0XH18,A0A1V4CHV0,A0A1K1RQP7,A0A1N6LUI7,A0A0P0NGR6,A0A1X7IML5,A0A0A2LKJ7,K1L112,A0A0U3AL92,A0A1H3A054,B9LVW4,A0A0C5JKF3,R5NJJ8,A5D4D9,A0A142Y7A9,A0A432MEQ5,A0A372DKU2,A0A3R7KLK4,C1F5Q7,A0A4R3EV39,A0A1P8WP90,A0A222F7P0,A0A1C9VH88,A0A2T2YMB1,A0A329TD61,A0A101R2A0,A0A1E3XF49,A0A1U9ND56,A0A4R7BQC4,A0A1H3DGN3,A0A1Q1FPH0,E0TGY3,A0A259TUP4,F6EYI8,A0A2S9Q9J0,A0A4Q2UIU6,A0A1H0LH25,A0A318LG42,H1YCU5,L0JS08,A0A1Q5ZS75,A0A345E7N0,M0AF24,A0A1W2A082,A0A1H3X247,A0A0C1XUA0,M0D2X3,A0A2R5G167,A0A346PK63,R7RTW6,A0A1H2RBI2,A0A1C3ZXN2,B9LVP8,M5RSF0,W0JW77,B7K585,F8D8G0,A0A343TL88,L0AJX6,A0A2A5QS34,A0A343JEE2,A0A3P3RGE5,A0A329TBQ3,A0A285N2A8,A0A0W1S8B8,A0A1V4C8L7,L9VRQ2,E4NRV1,A0A1I6HGN0,A0A1I0NI68,,",366,37
"861","C.S3.4","C.S5.4",336,174,162,2.21902937420179,"4F1N,4F3T,4KRE,5GUH,5VM9,6KR6,6OON,7KX7,7SWF,A0A163JTZ6,J9D5G4,C4LVV2,A8BCK6,A0A0G4H2S4,T1H8B3,S4RWI0,D2VMG4,A0A074TLL7,A0A0D1ZAJ4,Q1K660,F4PH46,A0A3M7S814,A0A164ZA52,A0A383WDW5,Q54G64,S7WCF7,I0YVB2,R7QGN7,C1DZY0,A0A2C5Z0M1,A0CB11,R9ACY5,D3BMP8,A0A1Z5TVE5,W7XD45,A0A1U7LLR0,A0A4S2MWZ7,K1VVQ6,A0A158P1R9,G7DVX0,V6R0U9,G4N9J3,E3KLI3,B7Q5I1,A0A1E3QC61,D5GGK8,S8ANP9,A0A139AUH8,L2GMR6,U4LBG4,A0A177URI1,O74957,A0A3N4IGK1,A6N7Y9,A0A0E9NDK5,T1KZ60,A0A250WXN5,A0A2G8JLH3,Q5KAT1,L2GUF2,W2T741,A0A1W0E4B5,A0A2J7QB22,S4RYE2,A0A2K3CW87,A0A388KES6,A0A226EFL3,A0A3S3PD82,A0A0L0TEV1,A0A1S3J512,G0QTT2,A0A1J1HRI1,Q9JMB7,A0A075AN09,Q5TW24,U5HIG6,A0A401PRI6,Q96J94,G2QEV0,A0A397UU01,A0A2T7PFL8,K7ISV0,A0A024FT57,H3HCL6,A0A0G4IME3,E9FUN9,A0A1S3CYL5,D7FQK3,A0A1Y1YHC8,F4S231,A0A1D8PMK0,A0A2G5B1D8,Q5BD61,A0A1C7M8P2,A0A4D8YSQ3,A0A158PJG6,J9JZ66,A0A0C2XG51,A0A158QZT6,A0A165QYQ9,T0SAU8,R7YY92,A0A3S1A0C3,A0A074YJ47,A0A2K1J482,A0A1Q3ENA6,O04379,A0A371I3C8,M8AEW7,A8P0D4,A0A2K3NY65,F4NYW7,A0A409Y6G2,A0A0L0HAB7,D8PZT7,A0A1D1W4K0,A7RQ46,W4YU94,A7BJS5,D8SNM6,A0A1J8PPA3,X1WG39,M5FQK2,Q69VD5,A0A2R6NSC2,A0A0D8XL16,A0A016WPN3,Q9QZ81,G5EES3,A0A0K0EFP6,Q8CJG0,A0A1D5NTU6,V2WTL2,A0A0V0YLH8,A0A139WDH0,A0A0R3W9Q7,H3DS31,A0A1Y1HWP2,G4T5G9,B7QCC4,A0A0B2UV00,M7BCJ9,E9GN30,Q7PZ41,A0A077Z361,R7U9I3,A0A1X7V1N5,A0A0K0JDP1,A0A0N4UKJ1,A0A498N3A3,A0A3M0IQP5,A0A0L8GBV4,Q32KD4,A0A1J1JBJ0,E0W4C3,A0A482XDA9,A0A3P7EJD6,J9K2Z4,A0A2J7Q8V4,T1IBM6,V3ZRX0,A0A210QKF7,A0A423TSS1,K1PT78,A0A267E8R7,A0A1D2N447,A0A226D7A9,F6YK55,T1KTE4,A0A2C9JGZ6,A0A1V9X9F0,K5X5Z7,A0A3Q0KUG5,T1FY40,1YVU,1Z26,3DLB,5AWH,5G5T,5I4A,6QZK,7R8K,E8N0K8,A0A1I7IXT4,A0A2W1JZ37,A0A2S7WBN3,A0A328VKE4,A0A420DFE6,E0ST67,A0A4V1VDY2,A0A368P5I0,C4L1M1,A0A4R1RMM2,A0A1Y2RDH8,A0A1M5ZSR3,A0A0K8QX04,A0A0M2PXX3,A0A1I3LMA1,K9TPA9,A0A1L3JHM3,A0A1W6MIP2,A0A1C0UUC4,A0A2U2J9E0,B1XJG0,A0A326U7G5,A0A1Q4R485,K9U8J6,K9RC91,A0A0D8ZUC0,A0A139XGN8,A0A1T4Y3A2,A0A0B0H9B4,A0YYT3,A0A2T1EFY0,G6FTN0,R6KUL9,A0A433NB65,A0A1Z4L0A1,K9UQR0,A0A2T1G8M7,K9VUN0,B7GJX9,K9ZDE3,B0JXD6,A0A2T1LS63,A0A1Z4K1Y3,A0A1N6SSK9,A0A0P4UVI8,A0A0V7ZCG4,A0A1J0AGK2,K9PFF9,K9UEV4,Q9L1X1,A0A060HNJ0,A0A235B542,R5XQK4,A0A1H3LE92,A0A496APJ8,A0A062U2W9,H0HWQ5,A0A1V9G9U4,A0A1I2ZGP1,A0A317EJY3,A0A1I2BD20,F8ERC7,S7VLM7,A0A1A5X8H4,A0A1I2T6Q1,A0A1R3T9N6,A0A0Q2M2Z1,H8KXJ0,D3S0S6,A0A2D1U4H7,I3TE64,A0A0B7I4Z6,A0LL61,Q8DKB1,A0A139WY18,A0A1J1EK56,A0A2T1E1K4,A0A1Q8ZD62,A0A4Q6XKV6,A0A1Z3HNN4,A0A239JE83,A0A2N4XBY2,Q53W94,R5JEI2,A0A0Q0ZC47,A0A2T0XH18,A0A1V4CHV0,A0A1K1RQP7,A0A2T1EKT1,A0A1N6LUI7,A0A0P0NGR6,A0A1X7IML5,A0A0A2LKJ7,K1L112,A0A1H3A054,E0UCX3,K9XZC6,A0A0C1VHB4,Q31N05,A0A0C5JKF3,R5NJJ8,A5D4D9,Q2JI93,A0A142Y7A9,A0A372DKU2,A0A3R7KLK4,C1F5Q7,A0A4R3EV39,A0A1P8WP90,A0A222F7P0,A0A1C9VH88,A0A2T2YMB1,A0A329TD61,A0A1E3XF49,A0A1U9ND56,A0A4R7BQC4,A0A1H3DGN3,A0A1Q1FPH0,E0TGY3,A0A259TUP4,F6EYI8,A0A4Q2UIU6,A0A1H0LH25,H1YCU5,L0JS08,A0A1Q5ZS75,A0A345E7N0,M0AF24,A0A1W2A082,A0A1H3X247,A0A0C1XUA0,M0D2X3,A0A346PK63,R7RTW6,A0A1H2RBI2,A0A1C3ZXN2,B9LVP8,M5RSF0,W0JW77,F8D8G0,A0A343TL88,L0AJX6,A0A2A5QS34,A0A343JEE2,A0A3P3RGE5,A0A329TBQ3,A0A285N2A8,A0A0W1S8B8,A0A1V4C8L7,L9VRQ2,E4NRV1,A0A1I6HGN0,A0A1I0NI68,,",366,37
"867","N.H3.12","N.H3.14",345,174,171,1.64937487396653,"4F1N,4F3T,4KRE,5GUH,5VM9,6KR6,6OON,7KX7,7SWF,A0A196SDB4,Q389P5,A0A0G4H2S4,T1H8B3,S4RWI0,D2VMG4,A0A074TLL7,A0A0D1ZAJ4,Q1K660,F4PH46,A0A3M7S814,A0A164ZA52,Q54G64,S7WCF7,I0YVB2,R7QGN7,C1DZY0,A0A2C5Z0M1,A0CB11,R9ACY5,D3BMP8,A0A1Z5TVE5,W7XD45,A0A1U7LLR0,A0A4S2MWZ7,K1VVQ6,A0A158P1R9,G7DVX0,V6R0U9,G4N9J3,E3KLI3,B7Q5I1,A0A1E3QC61,D5GGK8,S8ANP9,A0A139AUH8,L2GMR6,U4LBG4,A0A177URI1,O74957,A0A3N4IGK1,A6N7Y9,A0A0E9NDK5,T1KZ60,A0A250WXN5,A0A2G8JLH3,Q5KAT1,L2GUF2,W2T741,A0A1W0E4B5,A0A2J7QB22,S4RYE2,A0A2K3CW87,A0A388KES6,A0A226EFL3,A0A3S3PD82,A0A0L0TEV1,A0A1S3J512,G0QTT2,A0A1J1HRI1,C4V9J2,Q9JMB7,A0A075AN09,Q5TW24,U5HIG6,A0A401PRI6,Q96J94,A0A2B4RHN2,G2QEV0,A0A397UU01,A0A2T7PFL8,K7ISV0,A0A024FT57,H3HCL6,A0A0G4IME3,E9FUN9,A0A1S3CYL5,D7FQK3,A0A1Y1YHC8,T1GSU4,F4S231,A0A1D8PMK0,A0A2G5B1D8,Q5BD61,A0A1C7M8P2,A0A4D8YSQ3,A0A158PJG6,J9JZ66,A0A0C2XG51,A0A158QZT6,A0A165QYQ9,T0SAU8,R7YY92,A0A3S1A0C3,A0A074YJ47,A0A2K1J482,A0A1Q3ENA6,O04379,A0A371I3C8,M8AEW7,A8P0D4,A0A2K3NY65,F4NYW7,A0A409Y6G2,A0A0L0HAB7,D8PZT7,A0A1D1W4K0,A7RQ46,W4YU94,A7BJS5,D8SNM6,A0A1J8PPA3,X1WG39,M5FQK2,Q69VD5,A0A2R6NSC2,A0A0D8XL16,A0A016WPN3,Q9QZ81,G5EES3,A0A0K0EFP6,Q8CJG0,A0A1D5NTU6,V2WTL2,A0A0V0YLH8,A0A139WDH0,A0A0R3W9Q7,H3DS31,A0A1Y1HWP2,G4T5G9,B7QCC4,A0A0B2UV00,M7BCJ9,E9GN30,Q7PZ41,A0A077Z361,R7U9I3,A0A1X7V1N5,A0A0K0JDP1,A0A0N4UKJ1,A0A498N3A3,A0A3M0IQP5,A0A0L8GBV4,Q32KD4,A0A1J1JBJ0,E0W4C3,A0A482XDA9,A0A3P7EJD6,J9K2Z4,A0A2J7Q8V4,T1IBM6,V3ZRX0,A0A210QKF7,A0A423TSS1,K1PT78,A0A267E8R7,A0A1D2N447,A0A226D7A9,F6YK55,T1KTE4,A0A2C9JGZ6,A0A1V9X9F0,K5X5Z7,A0A3Q0KUG5,T1FY40,1Z26,3DLB,5AWH,5G5T,5I4A,6QZK,7R8K,A0A1I7IXT4,A0A2W1JZ37,A0A2S7WBN3,A0A328VKE4,A0A420DFE6,E0ST67,A0A4V1VDY2,A0A368P5I0,A0A4R1RMM2,A0A1Y2RDH8,Q11QW7,A0A1M5ZSR3,A0A1I3LMA1,K9TPA9,A0A1L3JHM3,A0A1W6MIP2,A0A2U2J9E0,A0A2Z6E1D5,A0A0F4NXW8,A0A142XB92,L8D0R3,A0A326U7G5,A0A3D8L290,A0A1Q4R485,K9U8J6,A0A097QRL6,K9RC91,A0A0D8ZUC0,A0A139XGN8,Q5P0R2,A0A0B0H9B4,A0YYT3,A0A2T1EFY0,G6FTN0,R6KUL9,A0A433NB65,K9UQR0,A0A2T1G8M7,K9VUN0,B7GJX9,A0A0P6X5X2,K9ZDE3,B0JXD6,A0A2T1LS63,A0A1Z4K1Y3,A0A2Z6E0R7,A0A1N6SSK9,A0A0P4UVI8,A0A0V7ZCG4,A0A1J0AGK2,K9PFF9,A0A2G9DT08,K9UEV4,Q9L1X1,A0A060HNJ0,A0A235B542,R5XQK4,A0A496APJ8,A0A062U2W9,H0HWQ5,A0A1V9G9U4,A0A1I2ZGP1,A0A317EJY3,A0A1I2BD20,F8ERC7,S7VLM7,A0A1A5X8H4,A0A1I2T6Q1,A0A1R3T9N6,A0A0Q2M2Z1,H8KXJ0,D3S0S6,A0A2D1U4H7,I3TE64,A0A0B7I4Z6,A0LL61,Q8DKB1,A0A139WY18,A0A1J1EK56,A0A2T1E1K4,A0A1Q8ZD62,A0A4Q6XKV6,A0A1Z3HNN4,A0A239JE83,A0A2N4XBY2,Q53W94,R5JEI2,A0A0Q0ZC47,A0A2T0XH18,A0A1V4CHV0,A0A1K1RQP7,A0A2T1EKT1,A0A1N6LUI7,A0A0P0NGR6,A0A1X7IML5,A0A0A2LKJ7,K1L112,A0A0U3AL92,A0A1H3A054,E0UCX3,K9XZC6,B9LVW4,A0A0C1VHB4,Q31N05,A0A0C5JKF3,R5NJJ8,A5D4D9,Q2JI93,A0A142Y7A9,A0A432MEQ5,A0A372DKU2,A0A3R7KLK4,C1F5Q7,A0A4R3EV39,A0A1P8WP90,A0A222F7P0,A0A1C9VH88,A0A2T2YMB1,A0A329TD61,A0A101R2A0,A0A1E3XF49,A0A1U9ND56,A0A4R7BQC4,A0A1H3DGN3,A0A1Q1FPH0,E0TGY3,A0A259TUP4,F6EYI8,A0A2S9Q9J0,A0A4Q2UIU6,A0A1H0LH25,A0A318LG42,H1YCU5,L0JS08,A0A1Q5ZS75,A0A345E7N0,M0AF24,A0A1W2A082,A0A1H3X247,A0A0C1XUA0,M0D2X3,A0A2R5G167,A0A346PK63,R7RTW6,A0A1H2RBI2,A0A1C3ZXN2,B9LVP8,M5RSF0,W0JW77,B7K585,F8D8G0,A0A343TL88,L0AJX6,A0A2A5QS34,A0A343JEE2,A0A3P3RGE5,A0A329TBQ3,A0A285N2A8,A0A0W1S8B8,A0A1V4C8L7,L9VRQ2,E4NRV1,A0A1I6HGN0,A0A1I0NI68,,",366,37
"874","N.H8.27","N.L25.2",261,174,87,2.32758620689655,"4F3T,4KRE,5GUH,5VM9,6KR6,6OON,7KX7,7SWF,A0A163JTZ6,A0A0N4X8S8,J9D5G4,Q389P5,C4LVV2,A0A0G4H2S4,T1H8B3,S4RWI0,D2VMG4,A0A074TLL7,A0A0D1ZAJ4,Q1K660,F4PH46,A0A3M7S814,A0A164ZA52,A0A383WDW5,Q54G64,S7WCF7,I0YVB2,R7QGN7,C1DZY0,A0A2C5Z0M1,A0CB11,R9ACY5,D3BMP8,A0A1Z5TVE5,A0A1U7LLR0,A0A4S2MWZ7,K1VVQ6,A0A158P1R9,G7DVX0,V6R0U9,G4N9J3,E3KLI3,B7Q5I1,A0A1E3QC61,D5GGK8,S8ANP9,A0A139AUH8,L2GMR6,U4LBG4,A0A177URI1,O74957,A0A3N4IGK1,A6N7Y9,A0A0E9NDK5,T1KZ60,A0A250WXN5,A0A2G8JLH3,Q5KAT1,L2GUF2,W2T741,A0A1W0E4B5,A0A2J7QB22,S4RYE2,A0A2K3CW87,A0A388KES6,A0A226EFL3,A0A3S3PD82,A0A0L0TEV1,A0A1S3J512,G0QTT2,A0A1J1HRI1,C4V9J2,Q9JMB7,A0A075AN09,U5HIG6,A0A401PRI6,Q96J94,A0A2B4RHN2,G2QEV0,A0A397UU01,A0A2T7PFL8,K7ISV0,A0A024FT57,H3HCL6,A0A0G4IME3,E9FUN9,A0A1S3CYL5,D7FQK3,A0A1Y1YHC8,T1GSU4,F4S231,A0A2G5B1D8,Q5BD61,A0A1C7M8P2,A0A4D8YSQ3,A0A158PJG6,J9JZ66,A0A0C2XG51,A0A158QZT6,A0A165QYQ9,T0SAU8,R7YY92,A0A3S1A0C3,A0A074YJ47,A0A2K1J482,A0A1Q3ENA6,O04379,A0A371I3C8,M8AEW7,A8P0D4,A0A2K3NY65,F4NYW7,A0A409Y6G2,A0A0L0HAB7,D8PZT7,A0A1D1W4K0,A7RQ46,W4YU94,A7BJS5,D8SNM6,A0A1J8PPA3,X1WG39,M5FQK2,Q69VD5,A0A2R6NSC2,A0A0D8XL16,A0A016WPN3,Q9QZ81,G5EES3,A0A0K0EFP6,Q8CJG0,A0A1D5NTU6,V2WTL2,A0A0V0YLH8,A0A139WDH0,A0A0R3W9Q7,H3DS31,A0A1Y1HWP2,G4T5G9,B7QCC4,A0A0B2UV00,M7BCJ9,E9GN30,Q7PZ41,A0A077Z361,R7U9I3,A0A1X7V1N5,A0A0K0JDP1,A0A0N4UKJ1,A0A498N3A3,A0A3M0IQP5,A0A0L8GBV4,Q32KD4,A0A1J1JBJ0,E0W4C3,A0A482XDA9,A0A3P7EJD6,J9K2Z4,A0A2J7Q8V4,T1IBM6,V3ZRX0,A0A210QKF7,A0A423TSS1,K1PT78,A0A267E8R7,A0A1D2N447,A0A226D7A9,F6YK55,T1KTE4,A0A2C9JGZ6,A0A1V9X9F0,K5X5Z7,A0A3Q0KUG5,T1FY40,1YVU,6QZK,E8N0K8,A0A328VKE4,C4L1M1,Q11QW7,K9TPA9,A0A0F4NXW8,L8D0R3,B1XJG0,A0A326U7G5,A0A1Q4R485,K9U8J6,K9RC91,A0A0D8ZUC0,A0A139XGN8,Q5P0R2,A0A0B0H9B4,A0YYT3,A0A2T1EFY0,G6FTN0,R6KUL9,A0A433NB65,A0A1Z4L0A1,K9UQR0,A0A2T1G8M7,K9VUN0,B7GJX9,K9ZDE3,B0JXD6,A0A2T1LS63,A0A1Z4K1Y3,A0A2Z6E0R7,A0A1N6SSK9,A0A0P4UVI8,A0A0V7ZCG4,A0A1J0AGK2,K9PFF9,K9UEV4,A0A060HNJ0,A0A235B542,R5XQK4,A0A1H3LE92,H0HWQ5,A0A317EJY3,A0A1I2BD20,F8ERC7,S7VLM7,A0A0B7I4Z6,Q8DKB1,A0A4Q6XKV6,A0A239JE83,A0A2N4XBY2,A0A0Q0ZC47,A0A1K1RQP7,A0A2T1EKT1,A0A0P0NGR6,A0A1X7IML5,Q31N05,R5NJJ8,A0A3R7KLK4,A0A1P8WP90,A0A1E3XF49,A0A1H3DGN3,A0A2S9Q9J0,L0JS08,M0AF24,A0A1W2A082,A0A0C1XUA0,M0D2X3,A0A346PK63,R7RTW6,A0A1H2RBI2,A0A1C3ZXN2,F8D8G0,A0A343TL88,A0A2A5QS34,A0A343JEE2,A0A3P3RGE5,A0A329TBQ3,A0A285N2A8,A0A0W1S8B8,A0A1V4C8L7,L9VRQ2,E4NRV1,A0A1I6HGN0,A0A1I0NI68,,",366,37
"875","N.L2.1","N.S12.5",276,174,102,4.97430696416498,"4F1N,4F3T,4KRE,5GUH,5VM9,6KR6,6OON,7KX7,7SWF,Q389P5,C4LVV2,A0A2P6N8X7,A8BCK6,A2DPV7,A0A0G4H2S4,T1H8B3,R1FDF0,S4RWI0,D2VMG4,A0A0D1ZAJ4,Q1K660,F4PH46,A0A164ZA52,A0A383WDW5,Q54G64,S7WCF7,R7QGN7,C1DZY0,A0A2C5Z0M1,A0CB11,R9ACY5,D3BMP8,A0A1Z5TVE5,W7XD45,A0A1U7LLR0,A0A4S2MWZ7,K1VVQ6,A0A158P1R9,G7DVX0,V6R0U9,G4N9J3,E3KLI3,B7Q5I1,A0A1E3QC61,D5GGK8,S8ANP9,A0A139AUH8,L2GMR6,U4LBG4,A0A177URI1,O74957,A0A3N4IGK1,A6N7Y9,A0A0E9NDK5,A0A250WXN5,A0A2G8JLH3,Q5KAT1,L2GUF2,A0A1W0E4B5,A0A2J7QB22,S4RYE2,A0A2K3CW87,A0A388KES6,A0A226EFL3,A0A3S3PD82,A0A0L0TEV1,A0A1S3J512,G0QTT2,A0A1J1HRI1,C4V9J2,Q9JMB7,A0A075AN09,Q5TW24,U5HIG6,A0A401PRI6,Q96J94,A0A2B4RHN2,G2QEV0,A0A397UU01,A0A2T7PFL8,K7ISV0,A0A024FT57,H3HCL6,A0A0G4IME3,E9FUN9,A0A1S3CYL5,D7FQK3,A0A1Y1YHC8,T1GSU4,F4S231,A0A1D8PMK0,A0A2G5B1D8,Q5BD61,A0A1C7M8P2,A0A4D8YSQ3,A0A158PJG6,J9JZ66,A0A0C2XG51,A0A158QZT6,A0A165QYQ9,T0SAU8,R7YY92,A0A3S1A0C3,A0A074YJ47,A0A2K1J482,A0A1Q3ENA6,O04379,A0A371I3C8,M8AEW7,A8P0D4,A0A2K3NY65,F4NYW7,A0A409Y6G2,A0A0L0HAB7,D8PZT7,A0A1D1W4K0,A7RQ46,W4YU94,A7BJS5,D8SNM6,A0A1J8PPA3,X1WG39,M5FQK2,Q69VD5,A0A2R6NSC2,A0A0D8XL16,A0A016WPN3,Q9QZ81,G5EES3,A0A0K0EFP6,Q8CJG0,A0A1D5NTU6,V2WTL2,A0A0V0YLH8,A0A139WDH0,A0A0R3W9Q7,H3DS31,A0A1Y1HWP2,G4T5G9,B7QCC4,A0A0B2UV00,M7BCJ9,E9GN30,Q7PZ41,A0A077Z361,R7U9I3,A0A1X7V1N5,A0A0K0JDP1,A0A0N4UKJ1,A0A498N3A3,A0A3M0IQP5,A0A0L8GBV4,Q32KD4,A0A1J1JBJ0,E0W4C3,A0A482XDA9,A0A3P7EJD6,J9K2Z4,A0A2J7Q8V4,T1IBM6,V3ZRX0,A0A210QKF7,A0A423TSS1,K1PT78,A0A267E8R7,A0A1D2N447,A0A226D7A9,F6YK55,T1KTE4,A0A2C9JGZ6,A0A1V9X9F0,K5X5Z7,A0A3Q0KUG5,T1FY40,1YVU,1Z26,3DLB,5AWH,5G5T,5I4A,6QZK,7R8K,A0A1I3LMA1,A0A3D8L290,A0A0B0H9B4,R6KUL9,B7GJX9,A0A1N6SSK9,A0A060HNJ0,A0A235B542,R5XQK4,H0HWQ5,A0A1I2BD20,F8ERC7,S7VLM7,A0A0Q2M2Z1,H8KXJ0,D3S0S6,A0A2D1U4H7,A0A0B7I4Z6,A0LL61,Q8DKB1,A0A1J1EK56,A0A4Q6XKV6,A0A239JE83,A0A2N4XBY2,Q53W94,R5JEI2,A0A0Q0ZC47,A0A2T0XH18,A0A1V4CHV0,A0A1K1RQP7,A0A2T1EKT1,A0A1N6LUI7,A0A0P0NGR6,A0A1X7IML5,A0A0A2LKJ7,K1L112,A0A0U3AL92,A0A1H3A054,E0UCX3,K9XZC6,A0A0C1VHB4,Q31N05,A0A0C5JKF3,R5NJJ8,A5D4D9,Q2JI93,A0A142Y7A9,A0A372DKU2,A0A3R7KLK4,C1F5Q7,A0A4R3EV39,A0A1P8WP90,A0A222F7P0,A0A1C9VH88,A0A2T2YMB1,A0A329TD61,A0A101R2A0,A0A1E3XF49,A0A1U9ND56,A0A4R7BQC4,A0A1H3DGN3,A0A1Q1FPH0,E0TGY3,A0A259TUP4,F6EYI8,A0A2S9Q9J0,A0A4Q2UIU6,A0A1H0LH25,A0A318LG42,H1YCU5,L0JS08,A0A1Q5ZS75,A0A345E7N0,M0AF24,A0A1H3X247,A0A0C1XUA0,M0D2X3,A0A2R5G167,A0A346PK63,R7RTW6,A0A1C3ZXN2,B9LVP8,M5RSF0,W0JW77,B7K585,A0A343TL88,L0AJX6,A0A2A5QS34,A0A343JEE2,A0A3P3RGE5,A0A329TBQ3,A0A285N2A8,A0A0W1S8B8,L9VRQ2,,",366,37
"878","N.S11.6","N.S9.2",277,174,103,2.10015623256333,"4F1N,4F3T,4KRE,5GUH,5VM9,6KR6,6OON,7KX7,7SWF,C4LVV2,A2DPV7,A0A0G4H2S4,T1H8B3,R1FDF0,S4RWI0,D2VMG4,A0A074TLL7,A0A0D1ZAJ4,Q1K660,F4PH46,A0A3M7S814,A0A164ZA52,Q54G64,S7WCF7,I0YVB2,R7QGN7,C1DZY0,A0A2C5Z0M1,A0CB11,R9ACY5,D3BMP8,A0A1Z5TVE5,W7XD45,A0A1U7LLR0,A0A4S2MWZ7,K1VVQ6,A0A158P1R9,G7DVX0,V6R0U9,G4N9J3,E3KLI3,B7Q5I1,A0A1E3QC61,D5GGK8,S8ANP9,A0A139AUH8,L2GMR6,U4LBG4,A0A177URI1,O74957,A0A3N4IGK1,A6N7Y9,A0A0E9NDK5,T1KZ60,A0A250WXN5,A0A2G8JLH3,Q5KAT1,L2GUF2,W2T741,A0A1W0E4B5,A0A2J7QB22,S4RYE2,A0A2K3CW87,A0A388KES6,A0A226EFL3,A0A3S3PD82,A0A0L0TEV1,A0A1S3J512,G0QTT2,A0A1J1HRI1,Q9JMB7,A0A075AN09,Q5TW24,U5HIG6,A0A401PRI6,Q96J94,A0A2B4RHN2,G2QEV0,A0A397UU01,A0A2T7PFL8,K7ISV0,A0A024FT57,H3HCL6,A0A0G4IME3,E9FUN9,A0A1S3CYL5,D7FQK3,A0A1Y1YHC8,T1GSU4,F4S231,A0A1D8PMK0,A0A2G5B1D8,Q5BD61,A0A1C7M8P2,A0A4D8YSQ3,A0A158PJG6,J9JZ66,A0A0C2XG51,A0A158QZT6,A0A165QYQ9,T0SAU8,R7YY92,A0A3S1A0C3,A0A074YJ47,A0A2K1J482,A0A1Q3ENA6,O04379,A0A371I3C8,M8AEW7,A8P0D4,A0A2K3NY65,F4NYW7,A0A409Y6G2,A0A0L0HAB7,D8PZT7,A0A1D1W4K0,A7RQ46,W4YU94,A7BJS5,D8SNM6,A0A1J8PPA3,X1WG39,M5FQK2,Q69VD5,A0A2R6NSC2,A0A0D8XL16,A0A016WPN3,Q9QZ81,G5EES3,A0A0K0EFP6,Q8CJG0,A0A1D5NTU6,V2WTL2,A0A0V0YLH8,A0A139WDH0,A0A0R3W9Q7,H3DS31,A0A1Y1HWP2,G4T5G9,B7QCC4,A0A0B2UV00,M7BCJ9,E9GN30,Q7PZ41,A0A077Z361,R7U9I3,A0A1X7V1N5,A0A0K0JDP1,A0A0N4UKJ1,A0A498N3A3,A0A3M0IQP5,A0A0L8GBV4,Q32KD4,A0A1J1JBJ0,E0W4C3,A0A482XDA9,A0A3P7EJD6,J9K2Z4,A0A2J7Q8V4,T1IBM6,V3ZRX0,A0A210QKF7,A0A423TSS1,K1PT78,A0A267E8R7,A0A1D2N447,A0A226D7A9,F6YK55,T1KTE4,A0A2C9JGZ6,A0A1V9X9F0,K5X5Z7,A0A3Q0KUG5,T1FY40,3DLB,5AWH,5I4A,6QZK,7R8K,C4L1M1,A0A1T4Y3A2,A0A0B0H9B4,B7GJX9,A0A2G9DT08,Q9L1X1,A0A1H3LE92,A0A496APJ8,A0A062U2W9,H0HWQ5,A0A1V9G9U4,A0A1I2ZGP1,A0A317EJY3,A0A1I2BD20,F8ERC7,S7VLM7,A0A1A5X8H4,A0A1I2T6Q1,A0A1R3T9N6,H8KXJ0,A0A2D1U4H7,A0A0B7I4Z6,A0LL61,A0A139WY18,A0A1J1EK56,A0A2T1E1K4,A0A1Q8ZD62,A0A4Q6XKV6,A0A1Z3HNN4,A0A239JE83,A0A2N4XBY2,Q53W94,R5JEI2,A0A0Q0ZC47,A0A2T0XH18,A0A1V4CHV0,A0A1K1RQP7,A0A1N6LUI7,A0A0P0NGR6,A0A1X7IML5,A0A0A2LKJ7,K1L112,A0A0U3AL92,A0A1H3A054,B9LVW4,A0A0C5JKF3,A5D4D9,A0A142Y7A9,A0A432MEQ5,A0A372DKU2,A0A4R3EV39,A0A1P8WP90,A0A222F7P0,A0A1C9VH88,A0A2T2YMB1,A0A329TD61,A0A101R2A0,A0A1E3XF49,A0A1U9ND56,A0A4R7BQC4,A0A1Q1FPH0,E0TGY3,A0A259TUP4,F6EYI8,A0A2S9Q9J0,A0A4Q2UIU6,A0A1H0LH25,A0A318LG42,H1YCU5,L0JS08,A0A1Q5ZS75,A0A345E7N0,M0AF24,A0A1W2A082,A0A1H3X247,A0A0C1XUA0,M0D2X3,A0A346PK63,A0A1H2RBI2,A0A1C3ZXN2,B9LVP8,M5RSF0,W0JW77,B7K585,F8D8G0,A0A343TL88,L0AJX6,A0A2A5QS34,A0A343JEE2,A0A3P3RGE5,A0A329TBQ3,A0A285N2A8,A0A0W1S8B8,A0A1V4C8L7,L9VRQ2,E4NRV1,A0A1I6HGN0,A0A1I0NI68,,",366,37
"882","C.H1.12","C.H1.8",340,175,165,2.94510822510823,"4F1N,4F3T,4KRE,5GUH,5VM9,6KR6,6OON,7KX7,7SWF,A0A163JTZ6,A0A0N4X8S8,A0A196SDB4,A0A2P6N8X7,A8BCK6,A2DPV7,A0A0G4H2S4,T1H8B3,S4RWI0,D2VMG4,A0A074TLL7,A0A0D1ZAJ4,Q1K660,F4PH46,A0A3M7S814,A0A164ZA52,A0A383WDW5,Q54G64,I0YVB2,R7QGN7,A0A2C5Z0M1,A0CB11,R9ACY5,D3BMP8,A0A1Z5TVE5,W7XD45,A0A1U7LLR0,A0A4S2MWZ7,K1VVQ6,A0A158P1R9,G7DVX0,V6R0U9,G4N9J3,E3KLI3,B7Q5I1,A0A1E3QC61,D5GGK8,S8ANP9,A0A139AUH8,L2GMR6,U4LBG4,A0A177URI1,O74957,A0A3N4IGK1,A6N7Y9,A0A0E9NDK5,T1KZ60,A0A250WXN5,A0A2G8JLH3,Q5KAT1,W2T741,A0A1W0E4B5,A0A2J7QB22,S4RYE2,A0A2K3CW87,A0A388KES6,A0A226EFL3,A0A3S3PD82,A0A0L0TEV1,A0A1S3J512,G0QTT2,A0A1J1HRI1,Q9JMB7,A0A075AN09,Q5TW24,U5HIG6,A0A401PRI6,Q96J94,A0A2B4RHN2,G2QEV0,A0A397UU01,A0A2T7PFL8,K7ISV0,A0A024FT57,H3HCL6,A0A0G4IME3,E9FUN9,A0A1S3CYL5,D7FQK3,A0A1Y1YHC8,T1GSU4,F4S231,A0A1D8PMK0,A0A2G5B1D8,Q5BD61,A0A1C7M8P2,A0A4D8YSQ3,A0A158PJG6,J9JZ66,A0A0C2XG51,A0A158QZT6,A0A165QYQ9,T0SAU8,R7YY92,A0A3S1A0C3,A0A074YJ47,A0A2K1J482,A0A1Q3ENA6,O04379,A0A371I3C8,M8AEW7,A8P0D4,A0A2K3NY65,F4NYW7,A0A409Y6G2,A0A0L0HAB7,D8PZT7,A0A1D1W4K0,A7RQ46,W4YU94,A7BJS5,D8SNM6,A0A1J8PPA3,X1WG39,M5FQK2,Q69VD5,A0A2R6NSC2,A0A0D8XL16,A0A016WPN3,Q9QZ81,G5EES3,A0A0K0EFP6,Q8CJG0,A0A1D5NTU6,V2WTL2,A0A0V0YLH8,A0A139WDH0,A0A0R3W9Q7,H3DS31,A0A1Y1HWP2,G4T5G9,B7QCC4,A0A0B2UV00,M7BCJ9,E9GN30,Q7PZ41,A0A077Z361,R7U9I3,A0A1X7V1N5,A0A0K0JDP1,A0A0N4UKJ1,A0A498N3A3,A0A3M0IQP5,A0A0L8GBV4,Q32KD4,A0A1J1JBJ0,E0W4C3,A0A482XDA9,A0A3P7EJD6,J9K2Z4,A0A2J7Q8V4,T1IBM6,V3ZRX0,A0A210QKF7,A0A423TSS1,K1PT78,A0A267E8R7,A0A1D2N447,A0A226D7A9,F6YK55,T1KTE4,A0A2C9JGZ6,A0A1V9X9F0,K5X5Z7,A0A3Q0KUG5,T1FY40,1YVU,1Z26,5AWH,5G5T,6QZK,7R8K,E8N0K8,A0A1I7IXT4,A0A2W1JZ37,A0A2S7WBN3,A0A328VKE4,A0A420DFE6,E0ST67,A0A4V1VDY2,A0A368P5I0,C4L1M1,A0A4R1RMM2,A0A1Y2RDH8,A0A1M5ZSR3,A0A0K8QX04,A0A0M2PXX3,A0A1I3LMA1,K9TPA9,A0A1L3JHM3,A0A1W6MIP2,A0A1C0UUC4,A0A2U2J9E0,A0A0F4NXW8,A0A142XB92,L8D0R3,A0A326U7G5,A0A3D8L290,K9U8J6,A0A097QRL6,K9RC91,A0A0D8ZUC0,A0A139XGN8,A0A1T4Y3A2,Q5P0R2,B6YTQ5,A0A0B0H9B4,A0YYT3,A0A2T1EFY0,G6FTN0,R6KUL9,A0A433NB65,A0A1Z4L0A1,K9UQR0,A0A2T1G8M7,K9VUN0,B7GJX9,A0A0P6X5X2,K9ZDE3,B0JXD6,A0A2T1LS63,A0A1Z4K1Y3,A0A2Z6E0R7,A0A1N6SSK9,A0A0P4UVI8,A0A0V7ZCG4,A0A1J0AGK2,K9PFF9,A0A2G9DT08,K9UEV4,Q9L1X1,A0A060HNJ0,A0A235B542,R5XQK4,A0A1H3LE92,A0A496APJ8,A0A062U2W9,H0HWQ5,A0A1V9G9U4,A0A1I2ZGP1,A0A317EJY3,A0A1I2BD20,F8ERC7,S7VLM7,A0A1A5X8H4,A0A1I2T6Q1,A0A1R3T9N6,A0A0Q2M2Z1,H8KXJ0,D3S0S6,A0A2D1U4H7,I3TE64,A0A0B7I4Z6,A0LL61,A0A139WY18,A0A2T1E1K4,A0A1Q8ZD62,A0A4Q6XKV6,A0A1Z3HNN4,A0A239JE83,A0A2N4XBY2,R5JEI2,A0A0Q0ZC47,A0A2T0XH18,A0A1V4CHV0,A0A1K1RQP7,A0A1N6LUI7,A0A0P0NGR6,A0A1X7IML5,A0A0A2LKJ7,K1L112,A0A0U3AL92,A0A1H3A054,A0A0C5JKF3,R5NJJ8,A5D4D9,A0A142Y7A9,A0A432MEQ5,A0A372DKU2,A0A3R7KLK4,C1F5Q7,A0A4R3EV39,A0A1P8WP90,A0A222F7P0,A0A1C9VH88,A0A2T2YMB1,A0A329TD61,A0A101R2A0,A0A1E3XF49,A0A1U9ND56,A0A4R7BQC4,A0A1H3DGN3,A0A1Q1FPH0,E0TGY3,A0A259TUP4,F6EYI8,A0A2S9Q9J0,A0A4Q2UIU6,A0A1H0LH25,A0A318LG42,H1YCU5,L0JS08,A0A1Q5ZS75,A0A345E7N0,M0AF24,A0A1W2A082,A0A1H3X247,A0A0C1XUA0,M0D2X3,A0A2R5G167,A0A346PK63,R7RTW6,A0A1H2RBI2,A0A1C3ZXN2,B9LVP8,M5RSF0,B7K585,F8D8G0,A0A343TL88,L0AJX6,A0A2A5QS34,A0A343JEE2,A0A3P3RGE5,A0A329TBQ3,A0A285N2A8,A0A0W1S8B8,A0A1V4C8L7,L9VRQ2,E4NRV1,A0A1I6HGN0,A0A1I0NI68,,",366,37
"883","C.H1.5","C.H1.8",314,175,139,3.64857142857143,"4F1N,4F3T,4KRE,5GUH,5VM9,6KR6,6OON,7KX7,7SWF,A0A163JTZ6,A0A0N4X8S8,A0A196SDB4,Q389P5,C4LVV2,A8BCK6,A2DPV7,A0A0G4H2S4,T1H8B3,S4RWI0,D2VMG4,A0A074TLL7,A0A0D1ZAJ4,Q1K660,F4PH46,A0A3M7S814,A0A164ZA52,A0A383WDW5,I0YVB2,R7QGN7,A0A2C5Z0M1,A0CB11,R9ACY5,D3BMP8,A0A1Z5TVE5,W7XD45,A0A1U7LLR0,A0A4S2MWZ7,K1VVQ6,A0A158P1R9,G7DVX0,V6R0U9,G4N9J3,E3KLI3,B7Q5I1,A0A1E3QC61,D5GGK8,S8ANP9,A0A139AUH8,L2GMR6,U4LBG4,A0A177URI1,O74957,A0A3N4IGK1,A6N7Y9,A0A0E9NDK5,T1KZ60,A0A250WXN5,A0A2G8JLH3,Q5KAT1,L2GUF2,W2T741,A0A1W0E4B5,A0A2J7QB22,S4RYE2,A0A2K3CW87,A0A388KES6,A0A226EFL3,A0A3S3PD82,A0A0L0TEV1,A0A1S3J512,G0QTT2,A0A1J1HRI1,Q9JMB7,A0A075AN09,Q5TW24,U5HIG6,A0A401PRI6,Q96J94,A0A2B4RHN2,G2QEV0,A0A397UU01,A0A2T7PFL8,K7ISV0,A0A024FT57,H3HCL6,A0A0G4IME3,E9FUN9,A0A1S3CYL5,D7FQK3,A0A1Y1YHC8,T1GSU4,F4S231,A0A1D8PMK0,A0A2G5B1D8,Q5BD61,A0A1C7M8P2,A0A4D8YSQ3,A0A158PJG6,J9JZ66,A0A0C2XG51,A0A158QZT6,A0A165QYQ9,T0SAU8,R7YY92,A0A3S1A0C3,A0A074YJ47,A0A2K1J482,A0A1Q3ENA6,O04379,A0A371I3C8,M8AEW7,A8P0D4,A0A2K3NY65,F4NYW7,A0A409Y6G2,A0A0L0HAB7,D8PZT7,A0A1D1W4K0,A7RQ46,W4YU94,A7BJS5,D8SNM6,A0A1J8PPA3,X1WG39,M5FQK2,Q69VD5,A0A2R6NSC2,A0A0D8XL16,A0A016WPN3,Q9QZ81,G5EES3,A0A0K0EFP6,Q8CJG0,A0A1D5NTU6,V2WTL2,A0A0V0YLH8,A0A139WDH0,A0A0R3W9Q7,H3DS31,A0A1Y1HWP2,G4T5G9,B7QCC4,A0A0B2UV00,M7BCJ9,E9GN30,Q7PZ41,A0A077Z361,R7U9I3,A0A1X7V1N5,A0A0K0JDP1,A0A0N4UKJ1,A0A498N3A3,A0A3M0IQP5,A0A0L8GBV4,Q32KD4,A0A1J1JBJ0,E0W4C3,A0A482XDA9,J9K2Z4,A0A2J7Q8V4,T1IBM6,V3ZRX0,A0A210QKF7,A0A423TSS1,K1PT78,A0A267E8R7,A0A1D2N447,A0A226D7A9,F6YK55,T1KTE4,A0A2C9JGZ6,A0A1V9X9F0,K5X5Z7,A0A3Q0KUG5,T1FY40,1YVU,1Z26,5AWH,5G5T,5I4A,6QZK,E8N0K8,A0A1I7IXT4,A0A2W1JZ37,A0A2S7WBN3,A0A328VKE4,A0A420DFE6,E0ST67,A0A4V1VDY2,A0A368P5I0,C4L1M1,A0A4R1RMM2,A0A1Y2RDH8,Q11QW7,A0A1M5ZSR3,A0A0K8QX04,A0A0M2PXX3,K9TPA9,A0A1L3JHM3,A0A1W6MIP2,A0A1C0UUC4,A0A2U2J9E0,A0A0F4NXW8,A0A142XB92,L8D0R3,A0A326U7G5,A0A3D8L290,A0A097QRL6,K9RC91,A0A1T4Y3A2,Q5P0R2,B6YTQ5,A0A0B0H9B4,A0YYT3,R6KUL9,K9UQR0,B7GJX9,A0A0P6X5X2,A0A2Z6E0R7,A0A1N6SSK9,A0A0V7ZCG4,A0A2G9DT08,K9UEV4,Q9L1X1,A0A060HNJ0,A0A235B542,R5XQK4,A0A496APJ8,A0A1V9G9U4,S7VLM7,A0A1A5X8H4,A0A1I2T6Q1,A0A1R3T9N6,A0A0Q2M2Z1,H8KXJ0,D3S0S6,A0A2D1U4H7,I3TE64,A0A0B7I4Z6,A0LL61,A0A139WY18,A0A2T1E1K4,A0A1Q8ZD62,A0A4Q6XKV6,A0A1Z3HNN4,A0A239JE83,A0A2N4XBY2,R5JEI2,A0A0Q0ZC47,A0A2T0XH18,A0A1V4CHV0,A0A1K1RQP7,A0A1N6LUI7,A0A0P0NGR6,A0A1X7IML5,A0A0A2LKJ7,K1L112,A0A0U3AL92,A0A1H3A054,A0A0C5JKF3,R5NJJ8,A5D4D9,A0A142Y7A9,A0A432MEQ5,A0A372DKU2,A0A3R7KLK4,C1F5Q7,A0A4R3EV39,A0A1P8WP90,A0A222F7P0,A0A1C9VH88,A0A2T2YMB1,A0A329TD61,A0A101R2A0,A0A1E3XF49,A0A1U9ND56,A0A4R7BQC4,A0A1H3DGN3,A0A1Q1FPH0,E0TGY3,A0A259TUP4,F6EYI8,A0A2S9Q9J0,A0A4Q2UIU6,A0A1H0LH25,A0A318LG42,H1YCU5,L0JS08,A0A1Q5ZS75,A0A345E7N0,M0AF24,A0A1W2A082,A0A1H3X247,A0A0C1XUA0,M0D2X3,A0A2R5G167,A0A346PK63,R7RTW6,A0A1H2RBI2,A0A1C3ZXN2,B9LVP8,M5RSF0,B7K585,A0A343TL88,L0AJX6,A0A2A5QS34,A0A343JEE2,A0A3P3RGE5,A0A329TBQ3,A0A0W1S8B8,A0A1V4C8L7,L9VRQ2,E4NRV1,A0A1I6HGN0,,",366,37
"896","C.L20.6","N.L2.1",310,175,135,3.82962962962963,"4F1N,4F3T,4KRE,5GUH,5VM9,6KR6,6OON,7KX7,7SWF,Q389P5,C4LVV2,A0A2P6N8X7,A8BCK6,A2DPV7,A0A0G4H2S4,T1H8B3,R1FDF0,S4RWI0,D2VMG4,A0A074TLL7,A0A0D1ZAJ4,Q1K660,F4PH46,A0A164ZA52,A0A383WDW5,Q54G64,S7WCF7,R7QGN7,C1DZY0,A0A2C5Z0M1,A0CB11,R9ACY5,D3BMP8,A0A1Z5TVE5,W7XD45,A0A1U7LLR0,A0A4S2MWZ7,A0A158P1R9,G7DVX0,V6R0U9,G4N9J3,E3KLI3,B7Q5I1,A0A1E3QC61,D5GGK8,S8ANP9,A0A139AUH8,L2GMR6,U4LBG4,A0A177URI1,O74957,A0A3N4IGK1,A6N7Y9,A0A0E9NDK5,T1KZ60,A0A250WXN5,A0A2G8JLH3,Q5KAT1,L2GUF2,A0A1W0E4B5,A0A2J7QB22,S4RYE2,A0A2K3CW87,A0A388KES6,A0A226EFL3,A0A3S3PD82,A0A0L0TEV1,A0A1S3J512,G0QTT2,A0A1J1HRI1,C4V9J2,Q9JMB7,A0A075AN09,Q5TW24,U5HIG6,A0A401PRI6,Q96J94,A0A2B4RHN2,G2QEV0,A0A397UU01,A0A2T7PFL8,K7ISV0,A0A024FT57,H3HCL6,A0A0G4IME3,E9FUN9,A0A1S3CYL5,D7FQK3,A0A1Y1YHC8,T1GSU4,F4S231,A0A1D8PMK0,A0A2G5B1D8,Q5BD61,A0A1C7M8P2,A0A4D8YSQ3,A0A158PJG6,J9JZ66,A0A0C2XG51,A0A158QZT6,A0A165QYQ9,T0SAU8,R7YY92,A0A3S1A0C3,A0A074YJ47,A0A2K1J482,A0A1Q3ENA6,O04379,A0A371I3C8,M8AEW7,A8P0D4,A0A2K3NY65,F4NYW7,A0A409Y6G2,A0A0L0HAB7,D8PZT7,A0A1D1W4K0,A7RQ46,W4YU94,A7BJS5,D8SNM6,A0A1J8PPA3,X1WG39,M5FQK2,Q69VD5,A0A2R6NSC2,A0A0D8XL16,A0A016WPN3,Q9QZ81,G5EES3,A0A0K0EFP6,Q8CJG0,A0A1D5NTU6,V2WTL2,A0A0V0YLH8,A0A139WDH0,A0A0R3W9Q7,H3DS31,A0A1Y1HWP2,G4T5G9,B7QCC4,A0A0B2UV00,M7BCJ9,E9GN30,Q7PZ41,A0A077Z361,R7U9I3,A0A1X7V1N5,A0A0K0JDP1,A0A0N4UKJ1,A0A498N3A3,A0A3M0IQP5,A0A0L8GBV4,Q32KD4,A0A1J1JBJ0,E0W4C3,A0A482XDA9,A0A3P7EJD6,J9K2Z4,A0A2J7Q8V4,T1IBM6,V3ZRX0,A0A210QKF7,A0A423TSS1,K1PT78,A0A267E8R7,A0A1D2N447,A0A226D7A9,F6YK55,T1KTE4,A0A2C9JGZ6,A0A1V9X9F0,K5X5Z7,A0A3Q0KUG5,T1FY40,1YVU,1Z26,3DLB,5AWH,5G5T,5I4A,6QZK,A0A1I7IXT4,A0A2W1JZ37,A0A2S7WBN3,A0A368P5I0,A0A1I3LMA1,A0A1W6MIP2,A0A2U2J9E0,A0A326U7G5,A0A3D8L290,H1KXR6,A0A1Q4R485,K9RC91,A0A0D8ZUC0,A0A139XGN8,A0A0B0H9B4,A0YYT3,A0A2T1EFY0,G6FTN0,R6KUL9,A0A433NB65,A0A1Z4L0A1,K9UQR0,A0A2T1G8M7,K9VUN0,B7GJX9,K9ZDE3,B0JXD6,A0A2T1LS63,A0A1Z4K1Y3,A0A1N6SSK9,A0A0P4UVI8,A0A0V7ZCG4,A0A1J0AGK2,K9PFF9,K9UEV4,A0A060HNJ0,A0A235B542,R5XQK4,H0HWQ5,A0A1I2BD20,F8ERC7,S7VLM7,A0A0Q2M2Z1,H8KXJ0,D3S0S6,A0A2D1U4H7,A0A0B7I4Z6,A0LL61,Q8DKB1,A0A1J1EK56,A0A4Q6XKV6,A0A239JE83,A0A2N4XBY2,Q53W94,R5JEI2,A0A0Q0ZC47,A0A2T0XH18,A0A1V4CHV0,A0A1K1RQP7,A0A2T1EKT1,A0A1N6LUI7,A0A0P0NGR6,A0A1X7IML5,A0A0A2LKJ7,K1L112,A0A0U3AL92,A0A1H3A054,E0UCX3,K9XZC6,A0A0C1VHB4,Q31N05,A0A0C5JKF3,R5NJJ8,A5D4D9,Q2JI93,A0A142Y7A9,A0A372DKU2,A0A3R7KLK4,C1F5Q7,A0A4R3EV39,A0A1P8WP90,A0A222F7P0,A0A1C9VH88,A0A2T2YMB1,A0A329TD61,A0A101R2A0,A0A1E3XF49,A0A1U9ND56,A0A4R7BQC4,A0A1H3DGN3,A0A1Q1FPH0,E0TGY3,A0A259TUP4,F6EYI8,A0A2S9Q9J0,A0A4Q2UIU6,A0A1H0LH25,A0A318LG42,H1YCU5,L0JS08,A0A1Q5ZS75,A0A345E7N0,M0AF24,A0A1H3X247,A0A0C1XUA0,M0D2X3,A0A2R5G167,A0A346PK63,R7RTW6,A0A1C3ZXN2,B9LVP8,M5RSF0,W0JW77,B7K585,F8D8G0,A0A343TL88,L0AJX6,A0A2A5QS34,A0A343JEE2,A0A3P3RGE5,A0A329TBQ3,A0A285N2A8,A0A0W1S8B8,A0A1V4C8L7,L9VRQ2,E4NRV1,A0A1I6HGN0,A0A1I0NI68,,",366,37
"901","C.S10.5","C.S9.3",214,175,39,2.3840293040293,"4F1N,4F3T,4KRE,5GUH,5VM9,6KR6,6OON,7SWF,A0A163JTZ6,J9D5G4,C4LVV2,A0A0G4H2S4,T1H8B3,R1FDF0,S4RWI0,D2VMG4,A0A0D1ZAJ4,Q1K660,F4PH46,A0A3M7S814,A0A164ZA52,A0A383WDW5,Q54G64,S7WCF7,I0YVB2,R7QGN7,C1DZY0,A0A2C5Z0M1,A0CB11,R9ACY5,D3BMP8,A0A1Z5TVE5,W7XD45,A0A1U7LLR0,A0A4S2MWZ7,K1VVQ6,A0A158P1R9,G7DVX0,V6R0U9,G4N9J3,E3KLI3,B7Q5I1,A0A1E3QC61,D5GGK8,S8ANP9,A0A139AUH8,L2GMR6,U4LBG4,A0A177URI1,O74957,A0A3N4IGK1,A6N7Y9,A0A0E9NDK5,T1KZ60,A0A250WXN5,A0A2G8JLH3,Q5KAT1,L2GUF2,W2T741,A0A1W0E4B5,A0A2J7QB22,S4RYE2,A0A2K3CW87,A0A388KES6,A0A226EFL3,A0A3S3PD82,A0A0L0TEV1,A0A1S3J512,G0QTT2,A0A1J1HRI1,C4V9J2,Q9JMB7,A0A075AN09,Q5TW24,U5HIG6,A0A401PRI6,Q96J94,A0A2B4RHN2,G2QEV0,A0A397UU01,A0A2T7PFL8,K7ISV0,A0A024FT57,H3HCL6,A0A0G4IME3,E9FUN9,A0A1S3CYL5,D7FQK3,A0A1Y1YHC8,T1GSU4,F4S231,A0A1D8PMK0,A0A2G5B1D8,Q5BD61,A0A1C7M8P2,A0A4D8YSQ3,A0A158PJG6,J9JZ66,A0A0C2XG51,A0A158QZT6,A0A165QYQ9,T0SAU8,R7YY92,A0A3S1A0C3,A0A074YJ47,A0A2K1J482,A0A1Q3ENA6,O04379,A0A371I3C8,M8AEW7,A8P0D4,A0A2K3NY65,F4NYW7,A0A409Y6G2,A0A0L0HAB7,D8PZT7,A0A1D1W4K0,A7RQ46,W4YU94,A7BJS5,D8SNM6,A0A1J8PPA3,X1WG39,M5FQK2,Q69VD5,A0A2R6NSC2,A0A0D8XL16,A0A016WPN3,Q9QZ81,G5EES3,A0A0K0EFP6,Q8CJG0,A0A1D5NTU6,V2WTL2,A0A0V0YLH8,A0A139WDH0,A0A0R3W9Q7,H3DS31,A0A1Y1HWP2,G4T5G9,B7QCC4,A0A0B2UV00,M7BCJ9,E9GN30,Q7PZ41,A0A077Z361,R7U9I3,A0A1X7V1N5,A0A0K0JDP1,A0A0N4UKJ1,A0A498N3A3,A0A3M0IQP5,A0A0L8GBV4,Q32KD4,A0A1J1JBJ0,E0W4C3,A0A482XDA9,A0A3P7EJD6,J9K2Z4,A0A2J7Q8V4,T1IBM6,V3ZRX0,A0A210QKF7,A0A423TSS1,K1PT78,A0A267E8R7,A0A1D2N447,A0A226D7A9,F6YK55,T1KTE4,A0A2C9JGZ6,A0A1V9X9F0,K5X5Z7,A0A3Q0KUG5,T1FY40,1YVU,3DLB,5G5T,5I4A,7R8K,E8N0K8,A0A328VKE4,A0A326U7G5,A0A1Q4R485,A0A139XGN8,A0A2T1EFY0,A0A1Z4L0A1,K9UQR0,K9UEV4,H0HWQ5,A0A1I2ZGP1,A0A317EJY3,A0A1I2BD20,F8ERC7,A0A139WY18,A0A2T1E1K4,A0A1Q8ZD62,A0A1Z3HNN4,A5D4D9,A0A1E3XF49,H1YCU5,A0A1Q5ZS75,A0A1W2A082,A0A0C1XUA0,A0A1H2RBI2,A0A1C3ZXN2,A0A343TL88,A0A3P3RGE5,A0A329TBQ3,A0A285N2A8,A0A0W1S8B8,L9VRQ2,E4NRV1,A0A1I6HGN0,,",366,37
"902","C.S11.1","C.S8.1",356,175,181,4.09146014206788,"4F3T,4KRE,5GUH,5VM9,6KR6,6OON,7KX7,7SWF,A0A163JTZ6,A0A196SDB4,J9D5G4,A8BCK6,A2DPV7,A0A0G4H2S4,T1H8B3,R1FDF0,S4RWI0,D2VMG4,A0A074TLL7,A0A0D1ZAJ4,Q1K660,F4PH46,A0A3M7S814,A0A164ZA52,Q54G64,S7WCF7,I0YVB2,R7QGN7,C1DZY0,A0A2C5Z0M1,A0CB11,R9ACY5,D3BMP8,A0A1Z5TVE5,W7XD45,A0A1U7LLR0,A0A4S2MWZ7,K1VVQ6,A0A158P1R9,G7DVX0,V6R0U9,G4N9J3,E3KLI3,B7Q5I1,A0A1E3QC61,D5GGK8,S8ANP9,A0A139AUH8,L2GMR6,U4LBG4,A0A177URI1,O74957,A0A3N4IGK1,A6N7Y9,A0A0E9NDK5,T1KZ60,A0A250WXN5,A0A2G8JLH3,Q5KAT1,L2GUF2,W2T741,A0A1W0E4B5,A0A2J7QB22,A0A2K3CW87,A0A226EFL3,A0A3S3PD82,A0A0L0TEV1,A0A1S3J512,G0QTT2,A0A1J1HRI1,C4V9J2,Q9JMB7,A0A075AN09,Q5TW24,U5HIG6,A0A401PRI6,Q96J94,A0A2B4RHN2,G2QEV0,A0A397UU01,A0A2T7PFL8,K7ISV0,A0A024FT57,H3HCL6,A0A0G4IME3,E9FUN9,A0A1S3CYL5,D7FQK3,A0A1Y1YHC8,T1GSU4,F4S231,A0A1D8PMK0,A0A2G5B1D8,Q5BD61,A0A1C7M8P2,A0A4D8YSQ3,A0A158PJG6,J9JZ66,A0A0C2XG51,A0A158QZT6,A0A165QYQ9,T0SAU8,R7YY92,A0A3S1A0C3,A0A074YJ47,A0A2K1J482,A0A1Q3ENA6,O04379,A0A371I3C8,M8AEW7,A8P0D4,A0A2K3NY65,F4NYW7,A0A409Y6G2,A0A0L0HAB7,D8PZT7,A0A1D1W4K0,A7RQ46,W4YU94,A7BJS5,D8SNM6,A0A1J8PPA3,X1WG39,M5FQK2,Q69VD5,A0A2R6NSC2,A0A0D8XL16,A0A016WPN3,Q9QZ81,G5EES3,A0A0K0EFP6,Q8CJG0,A0A1D5NTU6,V2WTL2,A0A0V0YLH8,A0A139WDH0,A0A0R3W9Q7,H3DS31,A0A1Y1HWP2,G4T5G9,B7QCC4,A0A0B2UV00,M7BCJ9,E9GN30,Q7PZ41,A0A077Z361,R7U9I3,A0A1X7V1N5,A0A0K0JDP1,A0A0N4UKJ1,A0A498N3A3,A0A3M0IQP5,A0A0L8GBV4,Q32KD4,A0A1J1JBJ0,E0W4C3,A0A482XDA9,A0A3P7EJD6,J9K2Z4,A0A2J7Q8V4,T1IBM6,V3ZRX0,A0A210QKF7,A0A423TSS1,K1PT78,A0A267E8R7,A0A1D2N447,A0A226D7A9,F6YK55,T1KTE4,A0A2C9JGZ6,A0A1V9X9F0,K5X5Z7,A0A3Q0KUG5,T1FY40,1YVU,1Z26,3DLB,5AWH,5G5T,5I4A,6QZK,7R8K,E8N0K8,A0A1I7IXT4,A0A2W1JZ37,A0A2S7WBN3,A0A328VKE4,A0A420DFE6,E0ST67,A0A4V1VDY2,A0A368P5I0,C4L1M1,A0A4R1RMM2,A0A1Y2RDH8,Q11QW7,A0A1M5ZSR3,A0A0K8QX04,A0A0M2PXX3,A0A1I3LMA1,K9TPA9,A0A1L3JHM3,A0A1W6MIP2,A0A1C0UUC4,A0A2U2J9E0,A0A2Z6E1D5,A0A0F4NXW8,A0A142XB92,L8D0R3,B1XJG0,A0A326U7G5,A0A3D8L290,H1KXR6,A0A1Q4R485,K9U8J6,A0A097QRL6,K9RC91,A0A0D8ZUC0,A0A139XGN8,A0A1T4Y3A2,Q5P0R2,B6YTQ5,A0A0B0H9B4,A0YYT3,A0A2T1EFY0,G6FTN0,R6KUL9,A0A433NB65,A0A1Z4L0A1,K9UQR0,A0A2T1G8M7,K9VUN0,B7GJX9,K9ZDE3,B0JXD6,A0A2T1LS63,A0A1Z4K1Y3,A0A2Z6E0R7,A0A1N6SSK9,A0A0P4UVI8,A0A0V7ZCG4,A0A1J0AGK2,K9PFF9,A0A2G9DT08,K9UEV4,Q9L1X1,A0A060HNJ0,A0A235B542,R5XQK4,A0A1H3LE92,A0A496APJ8,A0A062U2W9,H0HWQ5,A0A1V9G9U4,A0A1I2ZGP1,A0A317EJY3,A0A1I2BD20,F8ERC7,S7VLM7,A0A1A5X8H4,A0A1I2T6Q1,A0A1R3T9N6,A0A0Q2M2Z1,H8KXJ0,D3S0S6,A0A2D1U4H7,I3TE64,A0A0B7I4Z6,A0LL61,Q8DKB1,A0A139WY18,A0A1J1EK56,A0A2T1E1K4,A0A1Q8ZD62,A0A4Q6XKV6,A0A1Z3HNN4,A0A239JE83,A0A2N4XBY2,Q53W94,R5JEI2,A0A0Q0ZC47,A0A2T0XH18,A0A1V4CHV0,A0A1K1RQP7,A0A2T1EKT1,A0A1N6LUI7,A0A0P0NGR6,A0A1X7IML5,A0A0A2LKJ7,K1L112,A0A0U3AL92,A0A1H3A054,E0UCX3,K9XZC6,B9LVW4,A0A0C1VHB4,Q31N05,A0A0C5JKF3,R5NJJ8,A5D4D9,Q2JI93,A0A142Y7A9,A0A432MEQ5,A0A372DKU2,A0A3R7KLK4,C1F5Q7,A0A4R3EV39,A0A1P8WP90,A0A222F7P0,A0A1C9VH88,A0A2T2YMB1,A0A329TD61,A0A101R2A0,A0A1E3XF49,A0A1U9ND56,A0A4R7BQC4,A0A1H3DGN3,A0A1Q1FPH0,E0TGY3,A0A259TUP4,F6EYI8,A0A2S9Q9J0,A0A4Q2UIU6,A0A1H0LH25,A0A318LG42,H1YCU5,L0JS08,A0A1Q5ZS75,A0A345E7N0,M0AF24,A0A1W2A082,A0A1H3X247,A0A0C1XUA0,M0D2X3,A0A2R5G167,A0A346PK63,R7RTW6,A0A1H2RBI2,B9LVP8,M5RSF0,W0JW77,B7K585,F8D8G0,A0A343TL88,L0AJX6,A0A2A5QS34,A0A343JEE2,A0A3P3RGE5,A0A329TBQ3,A0A285N2A8,A0A0W1S8B8,A0A1V4C8L7,L9VRQ2,E4NRV1,A0A1I6HGN0,A0A1I0NI68,,",366,37
"912","N.H6.4","N.H6.6",251,175,76,2.01774436090226,"4F1N,4F3T,4KRE,5GUH,5VM9,6KR6,6OON,7KX7,A0A163JTZ6,A0A0N4X8S8,A0A196SDB4,J9D5G4,Q389P5,C4LVV2,A0A2P6N8X7,A2DPV7,A0A0G4H2S4,T1H8B3,R1FDF0,S4RWI0,D2VMG4,A0A074TLL7,A0A0D1ZAJ4,Q1K660,F4PH46,A0A3M7S814,A0A164ZA52,A0A383WDW5,Q54G64,S7WCF7,I0YVB2,R7QGN7,A0A2C5Z0M1,A0CB11,R9ACY5,D3BMP8,A0A1Z5TVE5,W7XD45,A0A1U7LLR0,A0A4S2MWZ7,K1VVQ6,A0A158P1R9,G7DVX0,V6R0U9,G4N9J3,E3KLI3,A0A1E3QC61,D5GGK8,S8ANP9,A0A139AUH8,L2GMR6,U4LBG4,A0A177URI1,O74957,A0A3N4IGK1,A6N7Y9,A0A0E9NDK5,T1KZ60,A0A250WXN5,A0A2G8JLH3,Q5KAT1,L2GUF2,W2T741,A0A1W0E4B5,A0A2J7QB22,S4RYE2,A0A2K3CW87,A0A388KES6,A0A226EFL3,A0A3S3PD82,A0A0L0TEV1,A0A1S3J512,G0QTT2,C4V9J2,Q9JMB7,A0A075AN09,Q5TW24,U5HIG6,A0A401PRI6,Q96J94,A0A2B4RHN2,G2QEV0,A0A397UU01,A0A2T7PFL8,K7ISV0,A0A024FT57,H3HCL6,A0A0G4IME3,E9FUN9,A0A1S3CYL5,D7FQK3,A0A1Y1YHC8,T1GSU4,F4S231,A0A1D8PMK0,A0A2G5B1D8,Q5BD61,A0A1C7M8P2,A0A4D8YSQ3,A0A158PJG6,J9JZ66,A0A158QZT6,T0SAU8,R7YY92,A0A3S1A0C3,A0A074YJ47,A0A2K1J482,A0A1Q3ENA6,O04379,A0A371I3C8,M8AEW7,A8P0D4,A0A2K3NY65,F4NYW7,A0A409Y6G2,A0A0L0HAB7,D8PZT7,A0A1D1W4K0,A7RQ46,A7BJS5,D8SNM6,A0A1J8PPA3,X1WG39,M5FQK2,Q69VD5,A0A2R6NSC2,A0A0D8XL16,A0A016WPN3,Q9QZ81,G5EES3,A0A0K0EFP6,Q8CJG0,A0A1D5NTU6,V2WTL2,A0A0V0YLH8,A0A139WDH0,A0A0R3W9Q7,H3DS31,A0A1Y1HWP2,G4T5G9,B7QCC4,A0A0B2UV00,M7BCJ9,E9GN30,Q7PZ41,A0A077Z361,R7U9I3,A0A1X7V1N5,A0A0K0JDP1,A0A0N4UKJ1,A0A498N3A3,A0A3M0IQP5,A0A0L8GBV4,Q32KD4,A0A1J1JBJ0,E0W4C3,A0A482XDA9,A0A3P7EJD6,J9K2Z4,A0A2J7Q8V4,T1IBM6,V3ZRX0,A0A210QKF7,A0A423TSS1,K1PT78,A0A267E8R7,A0A1D2N447,A0A226D7A9,F6YK55,T1KTE4,A0A2C9JGZ6,A0A1V9X9F0,K5X5Z7,A0A3Q0KUG5,T1FY40,1YVU,1Z26,3DLB,5G5T,6QZK,7R8K,A0A1I7IXT4,A0A2W1JZ37,A0A2S7WBN3,A0A420DFE6,E0ST67,A0A4V1VDY2,A0A368P5I0,C4L1M1,A0A0M2PXX3,A0A1I3LMA1,A0A1C0UUC4,B1XJG0,A0A097QRL6,B6YTQ5,A0A0B0H9B4,R6KUL9,B7GJX9,A0A1N6SSK9,A0A060HNJ0,A0A235B542,R5XQK4,A0A1H3LE92,A0A062U2W9,H0HWQ5,A0A1I2ZGP1,A0A317EJY3,A0A1I2BD20,F8ERC7,A0A0Q2M2Z1,D3S0S6,I3TE64,Q8DKB1,A0A1J1EK56,Q53W94,A0A2T1EKT1,E0UCX3,K9XZC6,A0A0C1VHB4,Q31N05,R5NJJ8,Q2JI93,A0A3R7KLK4,A0A1E3XF49,A0A1H3DGN3,A0A1Q1FPH0,H1YCU5,L0JS08,A0A1Q5ZS75,A0A345E7N0,M0AF24,A0A1W2A082,A0A1H3X247,A0A0C1XUA0,M0D2X3,A0A346PK63,R7RTW6,A0A1H2RBI2,A0A1C3ZXN2,B9LVP8,F8D8G0,A0A343TL88,A0A343JEE2,A0A3P3RGE5,A0A329TBQ3,A0A0W1S8B8,A0A1V4C8L7,L9VRQ2,E4NRV1,A0A1I6HGN0,A0A1I0NI68,,",366,37
"913","N.H6.4","N.H6.7",235,175,60,1.77595238095238,"4F1N,4F3T,4KRE,5GUH,5VM9,6KR6,7KX7,A0A163JTZ6,A0A0N4X8S8,A0A196SDB4,J9D5G4,Q389P5,C4LVV2,A0A2P6N8X7,A2DPV7,A0A0G4H2S4,T1H8B3,R1FDF0,S4RWI0,D2VMG4,A0A074TLL7,A0A0D1ZAJ4,Q1K660,F4PH46,A0A3M7S814,A0A164ZA52,A0A383WDW5,Q54G64,S7WCF7,I0YVB2,R7QGN7,A0A2C5Z0M1,A0CB11,R9ACY5,D3BMP8,A0A1Z5TVE5,W7XD45,A0A1U7LLR0,A0A4S2MWZ7,K1VVQ6,A0A158P1R9,G7DVX0,V6R0U9,G4N9J3,E3KLI3,A0A1E3QC61,D5GGK8,S8ANP9,A0A139AUH8,L2GMR6,U4LBG4,A0A177URI1,O74957,A0A3N4IGK1,A6N7Y9,A0A0E9NDK5,T1KZ60,A0A250WXN5,A0A2G8JLH3,Q5KAT1,L2GUF2,W2T741,A0A1W0E4B5,A0A2J7QB22,S4RYE2,A0A2K3CW87,A0A388KES6,A0A226EFL3,A0A3S3PD82,A0A0L0TEV1,A0A1S3J512,G0QTT2,A0A1J1HRI1,C4V9J2,Q9JMB7,A0A075AN09,Q5TW24,U5HIG6,A0A401PRI6,Q96J94,A0A2B4RHN2,G2QEV0,A0A397UU01,A0A2T7PFL8,K7ISV0,A0A024FT57,H3HCL6,A0A0G4IME3,E9FUN9,A0A1S3CYL5,D7FQK3,A0A1Y1YHC8,T1GSU4,F4S231,A0A1D8PMK0,A0A2G5B1D8,Q5BD61,A0A1C7M8P2,A0A4D8YSQ3,A0A158PJG6,J9JZ66,A0A158QZT6,T0SAU8,R7YY92,A0A3S1A0C3,A0A074YJ47,A0A2K1J482,A0A1Q3ENA6,O04379,A0A371I3C8,M8AEW7,A8P0D4,A0A2K3NY65,F4NYW7,A0A409Y6G2,A0A0L0HAB7,D8PZT7,A0A1D1W4K0,A7RQ46,A7BJS5,D8SNM6,A0A1J8PPA3,X1WG39,M5FQK2,Q69VD5,A0A2R6NSC2,A0A0D8XL16,A0A016WPN3,Q9QZ81,G5EES3,A0A0K0EFP6,Q8CJG0,A0A1D5NTU6,V2WTL2,A0A0V0YLH8,A0A139WDH0,A0A0R3W9Q7,H3DS31,A0A1Y1HWP2,G4T5G9,B7QCC4,A0A0B2UV00,M7BCJ9,E9GN30,Q7PZ41,A0A077Z361,R7U9I3,A0A1X7V1N5,A0A0K0JDP1,A0A0N4UKJ1,A0A498N3A3,A0A3M0IQP5,A0A0L8GBV4,Q32KD4,A0A1J1JBJ0,E0W4C3,A0A482XDA9,A0A3P7EJD6,J9K2Z4,A0A2J7Q8V4,T1IBM6,V3ZRX0,A0A210QKF7,A0A423TSS1,K1PT78,A0A267E8R7,A0A1D2N447,A0A226D7A9,F6YK55,T1KTE4,A0A2C9JGZ6,A0A1V9X9F0,K5X5Z7,A0A3Q0KUG5,T1FY40,1YVU,1Z26,5G5T,6QZK,7R8K,E0ST67,C4L1M1,A0A0K8QX04,A0A0M2PXX3,A0A1I3LMA1,A0A1C0UUC4,B1XJG0,A0A097QRL6,B6YTQ5,A0A0B0H9B4,R6KUL9,B7GJX9,A0A1N6SSK9,A0A060HNJ0,A0A235B542,R5XQK4,A0A062U2W9,H0HWQ5,A0A1I2ZGP1,A0A317EJY3,A0A1I2BD20,F8ERC7,D3S0S6,Q8DKB1,A0A1J1EK56,Q53W94,A0A2T1EKT1,E0UCX3,K9XZC6,A0A0C1VHB4,Q31N05,A0A3R7KLK4,A0A1E3XF49,A0A1H3DGN3,A0A1Q1FPH0,H1YCU5,L0JS08,A0A1Q5ZS75,A0A345E7N0,M0AF24,A0A1W2A082,A0A1H3X247,A0A0C1XUA0,M0D2X3,R7RTW6,A0A1H2RBI2,A0A1C3ZXN2,B9LVP8,A0A343TL88,A0A343JEE2,A0A3P3RGE5,A0A329TBQ3,L9VRQ2,E4NRV1,A0A1I6HGN0,,",366,37
"915","N.H8.11","N.H8.9",340,175,165,1.98164502164502,"4F1N,4F3T,4KRE,5GUH,5VM9,6KR6,6OON,7KX7,7SWF,A0A163JTZ6,J9D5G4,Q389P5,C4LVV2,A2DPV7,A0A0G4H2S4,T1H8B3,R1FDF0,S4RWI0,A0A074TLL7,A0A0D1ZAJ4,Q1K660,F4PH46,A0A3M7S814,A0A164ZA52,A0A383WDW5,Q54G64,S7WCF7,I0YVB2,R7QGN7,C1DZY0,A0A2C5Z0M1,A0CB11,R9ACY5,D3BMP8,A0A1Z5TVE5,W7XD45,A0A1U7LLR0,A0A4S2MWZ7,K1VVQ6,A0A158P1R9,V6R0U9,G4N9J3,E3KLI3,B7Q5I1,A0A1E3QC61,D5GGK8,S8ANP9,A0A139AUH8,L2GMR6,U4LBG4,A0A177URI1,O74957,A0A3N4IGK1,A6N7Y9,A0A0E9NDK5,T1KZ60,A0A250WXN5,A0A2G8JLH3,Q5KAT1,L2GUF2,W2T741,A0A1W0E4B5,A0A2J7QB22,S4RYE2,A0A388KES6,A0A226EFL3,A0A3S3PD82,A0A0L0TEV1,A0A1S3J512,G0QTT2,A0A1J1HRI1,C4V9J2,Q9JMB7,A0A075AN09,Q5TW24,U5HIG6,A0A401PRI6,Q96J94,A0A2B4RHN2,G2QEV0,A0A397UU01,A0A2T7PFL8,K7ISV0,A0A024FT57,H3HCL6,A0A0G4IME3,E9FUN9,A0A1S3CYL5,D7FQK3,A0A1Y1YHC8,T1GSU4,F4S231,A0A1D8PMK0,A0A2G5B1D8,Q5BD61,A0A1C7M8P2,A0A4D8YSQ3,A0A158PJG6,J9JZ66,A0A0C2XG51,A0A158QZT6,A0A165QYQ9,T0SAU8,R7YY92,A0A3S1A0C3,A0A2K1J482,A0A1Q3ENA6,O04379,A0A371I3C8,M8AEW7,A8P0D4,A0A2K3NY65,F4NYW7,A0A409Y6G2,A0A0L0HAB7,D8PZT7,A0A1D1W4K0,A7RQ46,W4YU94,A7BJS5,D8SNM6,A0A1J8PPA3,X1WG39,M5FQK2,Q69VD5,A0A2R6NSC2,A0A0D8XL16,A0A016WPN3,Q9QZ81,G5EES3,A0A0K0EFP6,Q8CJG0,A0A1D5NTU6,V2WTL2,A0A0V0YLH8,A0A139WDH0,A0A0R3W9Q7,H3DS31,A0A1Y1HWP2,G4T5G9,B7QCC4,A0A0B2UV00,M7BCJ9,E9GN30,Q7PZ41,A0A077Z361,R7U9I3,A0A1X7V1N5,A0A0K0JDP1,A0A0N4UKJ1,A0A498N3A3,A0A3M0IQP5,A0A0L8GBV4,Q32KD4,A0A1J1JBJ0,E0W4C3,A0A482XDA9,A0A3P7EJD6,J9K2Z4,A0A2J7Q8V4,T1IBM6,V3ZRX0,A0A210QKF7,A0A423TSS1,K1PT78,A0A267E8R7,A0A1D2N447,A0A226D7A9,F6YK55,T1KTE4,A0A2C9JGZ6,A0A1V9X9F0,K5X5Z7,A0A3Q0KUG5,T1FY40,1YVU,1Z26,3DLB,5AWH,5G5T,5I4A,6QZK,7R8K,E8N0K8,A0A1I7IXT4,A0A2W1JZ37,A0A2S7WBN3,A0A328VKE4,A0A420DFE6,E0ST67,A0A4V1VDY2,A0A368P5I0,A0A4R1RMM2,A0A1Y2RDH8,Q11QW7,K9TPA9,A0A1L3JHM3,A0A1W6MIP2,A0A2U2J9E0,A0A0F4NXW8,A0A142XB92,L8D0R3,B1XJG0,A0A326U7G5,H1KXR6,A0A1Q4R485,K9U8J6,K9RC91,A0A0D8ZUC0,A0A139XGN8,A0A1T4Y3A2,Q5P0R2,A0YYT3,A0A2T1EFY0,G6FTN0,A0A433NB65,A0A1Z4L0A1,K9UQR0,A0A2T1G8M7,K9VUN0,A0A0P6X5X2,K9ZDE3,B0JXD6,A0A2T1LS63,A0A1Z4K1Y3,A0A2Z6E0R7,A0A0P4UVI8,A0A0V7ZCG4,A0A1J0AGK2,K9PFF9,A0A2G9DT08,K9UEV4,Q9L1X1,A0A1H3LE92,A0A496APJ8,A0A062U2W9,H0HWQ5,A0A1V9G9U4,A0A1I2ZGP1,A0A317EJY3,A0A1I2BD20,F8ERC7,S7VLM7,A0A1A5X8H4,A0A1I2T6Q1,A0A1R3T9N6,A0A0Q2M2Z1,H8KXJ0,A0A2D1U4H7,I3TE64,A0A0B7I4Z6,A0LL61,Q8DKB1,A0A139WY18,A0A1J1EK56,A0A2T1E1K4,A0A1Q8ZD62,A0A4Q6XKV6,A0A1Z3HNN4,A0A239JE83,A0A2N4XBY2,Q53W94,R5JEI2,A0A0Q0ZC47,A0A2T0XH18,A0A1V4CHV0,A0A1K1RQP7,A0A2T1EKT1,A0A1N6LUI7,A0A0P0NGR6,A0A1X7IML5,A0A0A2LKJ7,K1L112,A0A0U3AL92,A0A1H3A054,E0UCX3,K9XZC6,B9LVW4,A0A0C1VHB4,Q31N05,A0A0C5JKF3,R5NJJ8,A5D4D9,Q2JI93,A0A142Y7A9,A0A432MEQ5,A0A372DKU2,A0A3R7KLK4,C1F5Q7,A0A4R3EV39,A0A1P8WP90,A0A222F7P0,A0A1C9VH88,A0A2T2YMB1,A0A329TD61,A0A101R2A0,A0A1E3XF49,A0A1U9ND56,A0A4R7BQC4,A0A1H3DGN3,A0A1Q1FPH0,E0TGY3,A0A259TUP4,F6EYI8,A0A2S9Q9J0,A0A4Q2UIU6,A0A1H0LH25,A0A318LG42,H1YCU5,L0JS08,A0A1Q5ZS75,A0A345E7N0,M0AF24,A0A1W2A082,A0A1H3X247,A0A0C1XUA0,M0D2X3,A0A2R5G167,A0A346PK63,R7RTW6,A0A1H2RBI2,A0A1C3ZXN2,B9LVP8,M5RSF0,W0JW77,B7K585,F8D8G0,A0A343TL88,L0AJX6,A0A2A5QS34,A0A343JEE2,A0A3P3RGE5,A0A329TBQ3,A0A285N2A8,A0A0W1S8B8,A0A1V4C8L7,L9VRQ2,E4NRV1,A0A1I6HGN0,A0A1I0NI68,,",366,37
"917","N.L16.2","N.S14.4",299,175,124,2.50585253456221,"4F1N,4F3T,4KRE,5GUH,5VM9,6KR6,6OON,7KX7,7SWF,A0A163JTZ6,A0A196SDB4,J9D5G4,Q389P5,A0A2P6N8X7,A0A0G4H2S4,T1H8B3,S4RWI0,D2VMG4,Q1K660,F4PH46,A0A3M7S814,A0A164ZA52,A0A383WDW5,Q54G64,S7WCF7,I0YVB2,R7QGN7,C1DZY0,A0A2C5Z0M1,A0CB11,R9ACY5,D3BMP8,A0A1Z5TVE5,W7XD45,A0A1U7LLR0,A0A4S2MWZ7,K1VVQ6,A0A158P1R9,G7DVX0,V6R0U9,G4N9J3,E3KLI3,B7Q5I1,A0A1E3QC61,D5GGK8,S8ANP9,A0A139AUH8,L2GMR6,U4LBG4,A0A177URI1,O74957,A0A3N4IGK1,A6N7Y9,A0A0E9NDK5,T1KZ60,A0A250WXN5,A0A2G8JLH3,Q5KAT1,L2GUF2,W2T741,A0A1W0E4B5,A0A2J7QB22,S4RYE2,A0A2K3CW87,A0A388KES6,A0A226EFL3,A0A3S3PD82,A0A0L0TEV1,A0A1S3J512,G0QTT2,A0A1J1HRI1,C4V9J2,Q9JMB7,A0A075AN09,Q5TW24,U5HIG6,A0A401PRI6,Q96J94,A0A2B4RHN2,G2QEV0,A0A397UU01,A0A2T7PFL8,K7ISV0,A0A024FT57,H3HCL6,A0A0G4IME3,E9FUN9,A0A1S3CYL5,D7FQK3,A0A1Y1YHC8,T1GSU4,F4S231,A0A1D8PMK0,Q5BD61,A0A1C7M8P2,A0A4D8YSQ3,A0A158PJG6,J9JZ66,A0A0C2XG51,A0A158QZT6,A0A165QYQ9,T0SAU8,R7YY92,A0A3S1A0C3,A0A074YJ47,A0A2K1J482,A0A1Q3ENA6,O04379,A0A371I3C8,M8AEW7,A8P0D4,A0A2K3NY65,F4NYW7,A0A409Y6G2,A0A0L0HAB7,D8PZT7,A0A1D1W4K0,A7RQ46,W4YU94,A7BJS5,D8SNM6,A0A1J8PPA3,X1WG39,M5FQK2,Q69VD5,A0A2R6NSC2,A0A0D8XL16,A0A016WPN3,Q9QZ81,G5EES3,A0A0K0EFP6,Q8CJG0,A0A1D5NTU6,V2WTL2,A0A0V0YLH8,A0A139WDH0,A0A0R3W9Q7,H3DS31,A0A1Y1HWP2,G4T5G9,B7QCC4,A0A0B2UV00,M7BCJ9,E9GN30,Q7PZ41,A0A077Z361,R7U9I3,A0A1X7V1N5,A0A0K0JDP1,A0A0N4UKJ1,A0A498N3A3,A0A3M0IQP5,A0A0L8GBV4,Q32KD4,A0A1J1JBJ0,E0W4C3,A0A482XDA9,A0A3P7EJD6,J9K2Z4,A0A2J7Q8V4,T1IBM6,V3ZRX0,A0A210QKF7,A0A423TSS1,K1PT78,A0A267E8R7,A0A1D2N447,A0A226D7A9,F6YK55,T1KTE4,A0A2C9JGZ6,A0A1V9X9F0,K5X5Z7,A0A3Q0KUG5,T1FY40,1YVU,1Z26,3DLB,5AWH,5G5T,5I4A,6QZK,7R8K,E0ST67,C4L1M1,A0A1I3LMA1,B1XJG0,A0A326U7G5,A0A1T4Y3A2,A0A0B0H9B4,R6KUL9,B7GJX9,A0A1N6SSK9,A0A2G9DT08,Q9L1X1,A0A060HNJ0,A0A235B542,R5XQK4,A0A1H3LE92,A0A496APJ8,A0A062U2W9,H0HWQ5,A0A1V9G9U4,A0A1I2ZGP1,A0A317EJY3,A0A1I2BD20,S7VLM7,A0A1A5X8H4,A0A1I2T6Q1,A0A1R3T9N6,H8KXJ0,A0A2D1U4H7,A0A0B7I4Z6,A0LL61,Q8DKB1,A0A139WY18,A0A1J1EK56,A0A2T1E1K4,A0A1Q8ZD62,A0A4Q6XKV6,A0A1Z3HNN4,A0A239JE83,A0A2N4XBY2,Q53W94,R5JEI2,A0A0Q0ZC47,A0A2T0XH18,A0A1V4CHV0,A0A1K1RQP7,A0A2T1EKT1,A0A1N6LUI7,A0A0P0NGR6,A0A1X7IML5,A0A0A2LKJ7,K1L112,A0A0U3AL92,A0A1H3A054,E0UCX3,K9XZC6,B9LVW4,A0A0C1VHB4,Q31N05,A0A0C5JKF3,R5NJJ8,A5D4D9,Q2JI93,A0A142Y7A9,A0A432MEQ5,A0A372DKU2,A0A3R7KLK4,C1F5Q7,A0A4R3EV39,A0A1P8WP90,A0A222F7P0,A0A1C9VH88,A0A2T2YMB1,A0A101R2A0,A0A1E3XF49,A0A1U9ND56,A0A4R7BQC4,A0A1H3DGN3,E0TGY3,A0A259TUP4,F6EYI8,A0A2S9Q9J0,A0A4Q2UIU6,A0A1H0LH25,A0A318LG42,H1YCU5,L0JS08,A0A1Q5ZS75,M0AF24,A0A1W2A082,A0A1H3X247,A0A0C1XUA0,M0D2X3,A0A2R5G167,A0A346PK63,R7RTW6,A0A1H2RBI2,A0A1C3ZXN2,B9LVP8,M5RSF0,W0JW77,B7K585,F8D8G0,A0A343TL88,L0AJX6,A0A2A5QS34,A0A343JEE2,A0A3P3RGE5,A0A329TBQ3,A0A285N2A8,A0A0W1S8B8,A0A1V4C8L7,L9VRQ2,E4NRV1,A0A1I6HGN0,A0A1I0NI68,,",366,37
"921","N.S12.2","N.S2.2",302,175,127,2.46269966254218,"4F1N,4F3T,4KRE,5GUH,5VM9,6KR6,6OON,7KX7,7SWF,Q389P5,C4LVV2,A0A2P6N8X7,A8BCK6,A2DPV7,A0A0G4H2S4,T1H8B3,R1FDF0,S4RWI0,D2VMG4,A0A0D1ZAJ4,Q1K660,F4PH46,A0A164ZA52,A0A383WDW5,Q54G64,S7WCF7,R7QGN7,C1DZY0,A0A2C5Z0M1,A0CB11,R9ACY5,D3BMP8,A0A1Z5TVE5,W7XD45,A0A1U7LLR0,A0A4S2MWZ7,K1VVQ6,A0A158P1R9,G7DVX0,V6R0U9,G4N9J3,E3KLI3,B7Q5I1,A0A1E3QC61,D5GGK8,S8ANP9,A0A139AUH8,L2GMR6,U4LBG4,A0A177URI1,O74957,A0A3N4IGK1,A6N7Y9,A0A0E9NDK5,T1KZ60,A0A250WXN5,A0A2G8JLH3,Q5KAT1,L2GUF2,A0A1W0E4B5,A0A2J7QB22,S4RYE2,A0A2K3CW87,A0A388KES6,A0A226EFL3,A0A3S3PD82,A0A0L0TEV1,A0A1S3J512,G0QTT2,A0A1J1HRI1,C4V9J2,Q9JMB7,A0A075AN09,Q5TW24,U5HIG6,A0A401PRI6,Q96J94,A0A2B4RHN2,G2QEV0,A0A397UU01,A0A2T7PFL8,K7ISV0,A0A024FT57,H3HCL6,A0A0G4IME3,E9FUN9,A0A1S3CYL5,D7FQK3,A0A1Y1YHC8,T1GSU4,F4S231,A0A1D8PMK0,A0A2G5B1D8,Q5BD61,A0A1C7M8P2,A0A4D8YSQ3,A0A158PJG6,J9JZ66,A0A0C2XG51,A0A158QZT6,A0A165QYQ9,T0SAU8,R7YY92,A0A3S1A0C3,A0A074YJ47,A0A2K1J482,A0A1Q3ENA6,O04379,A0A371I3C8,M8AEW7,A8P0D4,A0A2K3NY65,F4NYW7,A0A409Y6G2,A0A0L0HAB7,D8PZT7,A0A1D1W4K0,A7RQ46,W4YU94,A7BJS5,D8SNM6,A0A1J8PPA3,X1WG39,M5FQK2,Q69VD5,A0A2R6NSC2,A0A0D8XL16,A0A016WPN3,Q9QZ81,G5EES3,A0A0K0EFP6,Q8CJG0,A0A1D5NTU6,V2WTL2,A0A0V0YLH8,A0A139WDH0,A0A0R3W9Q7,H3DS31,A0A1Y1HWP2,G4T5G9,B7QCC4,A0A0B2UV00,M7BCJ9,E9GN30,Q7PZ41,A0A077Z361,R7U9I3,A0A1X7V1N5,A0A0K0JDP1,A0A0N4UKJ1,A0A498N3A3,A0A3M0IQP5,A0A0L8GBV4,Q32KD4,A0A1J1JBJ0,E0W4C3,A0A482XDA9,A0A3P7EJD6,J9K2Z4,A0A2J7Q8V4,T1IBM6,V3ZRX0,A0A210QKF7,A0A423TSS1,K1PT78,A0A267E8R7,A0A1D2N447,A0A226D7A9,F6YK55,T1KTE4,A0A2C9JGZ6,A0A1V9X9F0,K5X5Z7,A0A3Q0KUG5,T1FY40,1YVU,3DLB,5AWH,5G5T,5I4A,6QZK,7R8K,A0A1I3LMA1,A0A326U7G5,A0A3D8L290,A0A1Q4R485,K9U8J6,K9RC91,A0A0D8ZUC0,A0A139XGN8,A0A0B0H9B4,A0YYT3,A0A2T1EFY0,G6FTN0,R6KUL9,A0A433NB65,A0A1Z4L0A1,K9UQR0,A0A2T1G8M7,K9VUN0,B7GJX9,K9ZDE3,B0JXD6,A0A2T1LS63,A0A1Z4K1Y3,A0A1N6SSK9,A0A0P4UVI8,A0A0V7ZCG4,A0A1J0AGK2,K9PFF9,K9UEV4,A0A060HNJ0,A0A235B542,R5XQK4,H0HWQ5,A0A317EJY3,A0A1I2BD20,F8ERC7,S7VLM7,A0A0Q2M2Z1,H8KXJ0,A0A2D1U4H7,A0A0B7I4Z6,A0LL61,Q8DKB1,A0A1J1EK56,A0A4Q6XKV6,A0A239JE83,A0A2N4XBY2,Q53W94,R5JEI2,A0A0Q0ZC47,A0A2T0XH18,A0A1V4CHV0,A0A1K1RQP7,A0A2T1EKT1,A0A1N6LUI7,A0A0P0NGR6,A0A1X7IML5,A0A0A2LKJ7,K1L112,A0A0U3AL92,A0A1H3A054,E0UCX3,K9XZC6,A0A0C1VHB4,Q31N05,A0A0C5JKF3,R5NJJ8,A5D4D9,Q2JI93,A0A142Y7A9,A0A372DKU2,A0A3R7KLK4,C1F5Q7,A0A4R3EV39,A0A1P8WP90,A0A222F7P0,A0A1C9VH88,A0A329TD61,A0A101R2A0,A0A1E3XF49,A0A1U9ND56,A0A4R7BQC4,A0A1H3DGN3,A0A1Q1FPH0,E0TGY3,A0A259TUP4,F6EYI8,A0A2S9Q9J0,A0A4Q2UIU6,A0A1H0LH25,A0A318LG42,H1YCU5,L0JS08,A0A1Q5ZS75,A0A345E7N0,M0AF24,A0A1H3X247,A0A0C1XUA0,M0D2X3,A0A2R5G167,A0A346PK63,R7RTW6,A0A1C3ZXN2,B9LVP8,M5RSF0,W0JW77,B7K585,F8D8G0,A0A343TL88,L0AJX6,A0A2A5QS34,A0A343JEE2,A0A3P3RGE5,A0A329TBQ3,A0A0W1S8B8,A0A1V4C8L7,L9VRQ2,E4NRV1,A0A1I6HGN0,A0A1I0NI68,,",366,37
"922","N.S12.3","N.S2.2",305,175,130,3.83296703296703,"4F1N,4F3T,4KRE,5GUH,5VM9,6KR6,6OON,7KX7,7SWF,Q389P5,C4LVV2,A0A2P6N8X7,A8BCK6,A2DPV7,A0A0G4H2S4,T1H8B3,R1FDF0,S4RWI0,D2VMG4,A0A0D1ZAJ4,Q1K660,F4PH46,A0A164ZA52,A0A383WDW5,Q54G64,S7WCF7,R7QGN7,C1DZY0,A0A2C5Z0M1,A0CB11,R9ACY5,D3BMP8,A0A1Z5TVE5,W7XD45,A0A1U7LLR0,A0A4S2MWZ7,K1VVQ6,A0A158P1R9,G7DVX0,V6R0U9,G4N9J3,E3KLI3,B7Q5I1,A0A1E3QC61,D5GGK8,S8ANP9,A0A139AUH8,L2GMR6,U4LBG4,A0A177URI1,O74957,A0A3N4IGK1,A6N7Y9,A0A0E9NDK5,T1KZ60,A0A250WXN5,A0A2G8JLH3,Q5KAT1,L2GUF2,A0A1W0E4B5,A0A2J7QB22,S4RYE2,A0A2K3CW87,A0A388KES6,A0A226EFL3,A0A3S3PD82,A0A0L0TEV1,A0A1S3J512,G0QTT2,A0A1J1HRI1,C4V9J2,Q9JMB7,A0A075AN09,Q5TW24,U5HIG6,A0A401PRI6,Q96J94,A0A2B4RHN2,G2QEV0,A0A397UU01,A0A2T7PFL8,K7ISV0,A0A024FT57,H3HCL6,A0A0G4IME3,E9FUN9,A0A1S3CYL5,D7FQK3,A0A1Y1YHC8,T1GSU4,F4S231,A0A1D8PMK0,A0A2G5B1D8,Q5BD61,A0A1C7M8P2,A0A4D8YSQ3,A0A158PJG6,J9JZ66,A0A0C2XG51,A0A158QZT6,A0A165QYQ9,T0SAU8,R7YY92,A0A3S1A0C3,A0A074YJ47,A0A2K1J482,A0A1Q3ENA6,O04379,A0A371I3C8,M8AEW7,A8P0D4,A0A2K3NY65,F4NYW7,A0A409Y6G2,A0A0L0HAB7,D8PZT7,A0A1D1W4K0,A7RQ46,W4YU94,A7BJS5,D8SNM6,A0A1J8PPA3,X1WG39,M5FQK2,Q69VD5,A0A2R6NSC2,A0A0D8XL16,A0A016WPN3,Q9QZ81,G5EES3,A0A0K0EFP6,Q8CJG0,A0A1D5NTU6,V2WTL2,A0A0V0YLH8,A0A139WDH0,A0A0R3W9Q7,H3DS31,A0A1Y1HWP2,G4T5G9,B7QCC4,A0A0B2UV00,M7BCJ9,E9GN30,Q7PZ41,A0A077Z361,R7U9I3,A0A1X7V1N5,A0A0K0JDP1,A0A0N4UKJ1,A0A498N3A3,A0A3M0IQP5,A0A0L8GBV4,Q32KD4,A0A1J1JBJ0,E0W4C3,A0A482XDA9,A0A3P7EJD6,J9K2Z4,A0A2J7Q8V4,T1IBM6,V3ZRX0,A0A210QKF7,A0A423TSS1,K1PT78,A0A267E8R7,A0A1D2N447,A0A226D7A9,F6YK55,T1KTE4,A0A2C9JGZ6,A0A1V9X9F0,K5X5Z7,A0A3Q0KUG5,T1FY40,1YVU,1Z26,3DLB,5AWH,5G5T,5I4A,6QZK,7R8K,A0A1I3LMA1,A0A326U7G5,A0A3D8L290,A0A1Q4R485,K9U8J6,K9RC91,A0A0D8ZUC0,A0A139XGN8,A0A0B0H9B4,A0YYT3,A0A2T1EFY0,G6FTN0,R6KUL9,A0A433NB65,A0A1Z4L0A1,K9UQR0,A0A2T1G8M7,K9VUN0,B7GJX9,K9ZDE3,B0JXD6,A0A2T1LS63,A0A1Z4K1Y3,A0A1N6SSK9,A0A0P4UVI8,A0A0V7ZCG4,A0A1J0AGK2,K9PFF9,K9UEV4,A0A060HNJ0,A0A235B542,R5XQK4,H0HWQ5,A0A317EJY3,A0A1I2BD20,F8ERC7,S7VLM7,A0A0Q2M2Z1,H8KXJ0,D3S0S6,A0A2D1U4H7,A0A0B7I4Z6,A0LL61,Q8DKB1,A0A1J1EK56,A0A4Q6XKV6,A0A239JE83,A0A2N4XBY2,Q53W94,R5JEI2,A0A0Q0ZC47,A0A2T0XH18,A0A1V4CHV0,A0A1K1RQP7,A0A2T1EKT1,A0A1N6LUI7,A0A0P0NGR6,A0A1X7IML5,A0A0A2LKJ7,K1L112,A0A0U3AL92,A0A1H3A054,E0UCX3,K9XZC6,A0A0C1VHB4,Q31N05,A0A0C5JKF3,R5NJJ8,A5D4D9,Q2JI93,A0A142Y7A9,A0A372DKU2,A0A3R7KLK4,C1F5Q7,A0A4R3EV39,A0A1P8WP90,A0A222F7P0,A0A1C9VH88,A0A329TD61,A0A101R2A0,A0A1E3XF49,A0A1U9ND56,A0A4R7BQC4,A0A1H3DGN3,A0A1Q1FPH0,E0TGY3,A0A259TUP4,F6EYI8,A0A2S9Q9J0,A0A4Q2UIU6,A0A1H0LH25,A0A318LG42,H1YCU5,L0JS08,A0A1Q5ZS75,A0A345E7N0,M0AF24,A0A1H3X247,A0A0C1XUA0,M0D2X3,A0A2R5G167,A0A346PK63,R7RTW6,A0A1C3ZXN2,B9LVP8,M5RSF0,W0JW77,B7K585,F8D8G0,A0A343TL88,L0AJX6,A0A2A5QS34,A0A343JEE2,A0A3P3RGE5,A0A329TBQ3,A0A285N2A8,A0A0W1S8B8,A0A1V4C8L7,L9VRQ2,E4NRV1,A0A1I6HGN0,A0A1I0NI68,,",366,37
"925","N.S17.3","N.S18.2",287,175,112,2.16767857142857,"4F1N,4F3T,4KRE,5GUH,5VM9,6KR6,6OON,7KX7,7SWF,A0A163JTZ6,A0A0N4X8S8,A0A196SDB4,J9D5G4,Q389P5,C4LVV2,A0A2P6N8X7,T1H8B3,S4RWI0,D2VMG4,A0A074TLL7,A0A0D1ZAJ4,Q1K660,F4PH46,A0A3M7S814,A0A164ZA52,A0A383WDW5,Q54G64,S7WCF7,I0YVB2,R7QGN7,C1DZY0,A0A2C5Z0M1,A0CB11,R9ACY5,D3BMP8,A0A1Z5TVE5,W7XD45,A0A4S2MWZ7,A0A158P1R9,G7DVX0,V6R0U9,G4N9J3,E3KLI3,A0A1E3QC61,D5GGK8,S8ANP9,A0A139AUH8,L2GMR6,U4LBG4,A0A177URI1,O74957,A0A3N4IGK1,A6N7Y9,A0A0E9NDK5,T1KZ60,A0A250WXN5,A0A2G8JLH3,Q5KAT1,L2GUF2,W2T741,A0A1W0E4B5,A0A2J7QB22,S4RYE2,A0A2K3CW87,A0A388KES6,A0A226EFL3,A0A3S3PD82,A0A0L0TEV1,A0A1S3J512,G0QTT2,A0A1J1HRI1,C4V9J2,Q9JMB7,A0A075AN09,Q5TW24,U5HIG6,A0A401PRI6,Q96J94,A0A2B4RHN2,G2QEV0,A0A397UU01,A0A2T7PFL8,K7ISV0,A0A024FT57,H3HCL6,A0A0G4IME3,E9FUN9,A0A1S3CYL5,D7FQK3,A0A1Y1YHC8,T1GSU4,F4S231,A0A1D8PMK0,A0A2G5B1D8,Q5BD61,A0A1C7M8P2,A0A4D8YSQ3,A0A158PJG6,J9JZ66,A0A158QZT6,A0A165QYQ9,T0SAU8,R7YY92,A0A3S1A0C3,A0A074YJ47,A0A2K1J482,A0A1Q3ENA6,O04379,A0A371I3C8,M8AEW7,A8P0D4,A0A2K3NY65,F4NYW7,A0A409Y6G2,A0A0L0HAB7,D8PZT7,A0A1D1W4K0,A7RQ46,W4YU94,A7BJS5,D8SNM6,A0A1J8PPA3,X1WG39,M5FQK2,Q69VD5,A0A2R6NSC2,A0A0D8XL16,A0A016WPN3,Q9QZ81,G5EES3,A0A0K0EFP6,Q8CJG0,A0A1D5NTU6,V2WTL2,A0A0V0YLH8,A0A139WDH0,A0A0R3W9Q7,H3DS31,A0A1Y1HWP2,G4T5G9,B7QCC4,A0A0B2UV00,M7BCJ9,E9GN30,Q7PZ41,A0A077Z361,R7U9I3,A0A1X7V1N5,A0A0K0JDP1,A0A0N4UKJ1,A0A498N3A3,A0A3M0IQP5,A0A0L8GBV4,Q32KD4,A0A1J1JBJ0,E0W4C3,A0A482XDA9,A0A3P7EJD6,J9K2Z4,A0A2J7Q8V4,T1IBM6,V3ZRX0,A0A210QKF7,A0A423TSS1,K1PT78,A0A267E8R7,A0A1D2N447,A0A226D7A9,F6YK55,T1KTE4,A0A2C9JGZ6,A0A1V9X9F0,K5X5Z7,A0A3Q0KUG5,T1FY40,1YVU,1Z26,5AWH,5I4A,E0ST67,C4L1M1,A0A0M2PXX3,A0A1I3LMA1,A0A1C0UUC4,B1XJG0,H1KXR6,A0A1T4Y3A2,A0A0B0H9B4,R6KUL9,B7GJX9,A0A1N6SSK9,A0A2G9DT08,Q9L1X1,A0A060HNJ0,A0A235B542,R5XQK4,A0A496APJ8,A0A1V9G9U4,S7VLM7,A0A1A5X8H4,A0A1I2T6Q1,A0A1R3T9N6,H8KXJ0,A0A2D1U4H7,I3TE64,A0A0B7I4Z6,A0LL61,Q8DKB1,A0A139WY18,A0A1J1EK56,A0A2T1E1K4,A0A1Q8ZD62,A0A4Q6XKV6,A0A1Z3HNN4,A0A239JE83,A0A2N4XBY2,Q53W94,R5JEI2,A0A0Q0ZC47,A0A2T0XH18,A0A1V4CHV0,A0A1K1RQP7,A0A2T1EKT1,A0A1N6LUI7,A0A0P0NGR6,A0A1X7IML5,A0A0A2LKJ7,K1L112,A0A0U3AL92,A0A1H3A054,E0UCX3,K9XZC6,A0A0C1VHB4,Q31N05,A0A0C5JKF3,R5NJJ8,A5D4D9,Q2JI93,A0A142Y7A9,A0A432MEQ5,A0A372DKU2,A0A3R7KLK4,C1F5Q7,A0A4R3EV39,A0A1P8WP90,A0A222F7P0,A0A1C9VH88,A0A2T2YMB1,A0A329TD61,A0A101R2A0,A0A1U9ND56,A0A4R7BQC4,A0A1H3DGN3,A0A1Q1FPH0,E0TGY3,A0A259TUP4,F6EYI8,A0A2S9Q9J0,A0A1H0LH25,A0A318LG42,H1YCU5,L0JS08,A0A1Q5ZS75,A0A345E7N0,M0AF24,A0A1W2A082,A0A1H3X247,M0D2X3,A0A2R5G167,A0A346PK63,R7RTW6,A0A1H2RBI2,A0A1C3ZXN2,B9LVP8,M5RSF0,B7K585,F8D8G0,A0A343TL88,A0A343JEE2,A0A3P3RGE5,A0A329TBQ3,A0A0W1S8B8,A0A1V4C8L7,L9VRQ2,E4NRV1,A0A1I6HGN0,A0A1I0NI68,,",366,37
"926","C.H1.11","C.H1.8",341,176,165,3.5844696969697,"4F1N,4F3T,4KRE,5GUH,5VM9,6KR6,6OON,7KX7,7SWF,A0A163JTZ6,A0A0N4X8S8,A0A196SDB4,A0A2P6N8X7,A8BCK6,A2DPV7,A0A0G4H2S4,T1H8B3,S4RWI0,D2VMG4,A0A074TLL7,A0A0D1ZAJ4,Q1K660,F4PH46,A0A3M7S814,A0A164ZA52,A0A383WDW5,Q54G64,I0YVB2,R7QGN7,A0A2C5Z0M1,A0CB11,R9ACY5,D3BMP8,A0A1Z5TVE5,W7XD45,A0A1U7LLR0,A0A4S2MWZ7,K1VVQ6,A0A158P1R9,G7DVX0,V6R0U9,G4N9J3,E3KLI3,B7Q5I1,A0A1E3QC61,D5GGK8,S8ANP9,A0A139AUH8,L2GMR6,U4LBG4,A0A177URI1,O74957,A0A3N4IGK1,A6N7Y9,A0A0E9NDK5,T1KZ60,A0A250WXN5,A0A2G8JLH3,Q5KAT1,L2GUF2,W2T741,A0A1W0E4B5,A0A2J7QB22,S4RYE2,A0A2K3CW87,A0A388KES6,A0A226EFL3,A0A3S3PD82,A0A0L0TEV1,A0A1S3J512,G0QTT2,A0A1J1HRI1,Q9JMB7,A0A075AN09,Q5TW24,U5HIG6,A0A401PRI6,Q96J94,A0A2B4RHN2,G2QEV0,A0A397UU01,A0A2T7PFL8,K7ISV0,A0A024FT57,H3HCL6,A0A0G4IME3,E9FUN9,A0A1S3CYL5,D7FQK3,A0A1Y1YHC8,T1GSU4,F4S231,A0A1D8PMK0,A0A2G5B1D8,Q5BD61,A0A1C7M8P2,A0A4D8YSQ3,A0A158PJG6,J9JZ66,A0A0C2XG51,A0A158QZT6,A0A165QYQ9,T0SAU8,R7YY92,A0A3S1A0C3,A0A074YJ47,A0A2K1J482,A0A1Q3ENA6,O04379,A0A371I3C8,M8AEW7,A8P0D4,A0A2K3NY65,F4NYW7,A0A409Y6G2,A0A0L0HAB7,D8PZT7,A0A1D1W4K0,A7RQ46,W4YU94,A7BJS5,D8SNM6,A0A1J8PPA3,X1WG39,M5FQK2,Q69VD5,A0A2R6NSC2,A0A0D8XL16,A0A016WPN3,Q9QZ81,G5EES3,A0A0K0EFP6,Q8CJG0,A0A1D5NTU6,V2WTL2,A0A0V0YLH8,A0A139WDH0,A0A0R3W9Q7,H3DS31,A0A1Y1HWP2,G4T5G9,B7QCC4,A0A0B2UV00,M7BCJ9,E9GN30,Q7PZ41,A0A077Z361,R7U9I3,A0A1X7V1N5,A0A0K0JDP1,A0A0N4UKJ1,A0A498N3A3,A0A3M0IQP5,A0A0L8GBV4,Q32KD4,A0A1J1JBJ0,E0W4C3,A0A482XDA9,A0A3P7EJD6,J9K2Z4,A0A2J7Q8V4,T1IBM6,V3ZRX0,A0A210QKF7,A0A423TSS1,K1PT78,A0A267E8R7,A0A1D2N447,A0A226D7A9,F6YK55,T1KTE4,A0A2C9JGZ6,A0A1V9X9F0,K5X5Z7,A0A3Q0KUG5,T1FY40,1YVU,1Z26,5AWH,6QZK,7R8K,E8N0K8,A0A1I7IXT4,A0A2W1JZ37,A0A2S7WBN3,A0A328VKE4,A0A420DFE6,E0ST67,A0A4V1VDY2,A0A368P5I0,C4L1M1,A0A4R1RMM2,A0A1Y2RDH8,A0A1M5ZSR3,A0A0K8QX04,A0A0M2PXX3,A0A1I3LMA1,K9TPA9,A0A1L3JHM3,A0A1W6MIP2,A0A1C0UUC4,A0A2U2J9E0,A0A0F4NXW8,A0A142XB92,L8D0R3,A0A326U7G5,A0A3D8L290,K9U8J6,A0A097QRL6,K9RC91,A0A0D8ZUC0,A0A139XGN8,A0A1T4Y3A2,Q5P0R2,B6YTQ5,A0A0B0H9B4,A0YYT3,A0A2T1EFY0,G6FTN0,R6KUL9,A0A433NB65,A0A1Z4L0A1,K9UQR0,A0A2T1G8M7,K9VUN0,B7GJX9,A0A0P6X5X2,K9ZDE3,B0JXD6,A0A2T1LS63,A0A1Z4K1Y3,A0A2Z6E0R7,A0A1N6SSK9,A0A0P4UVI8,A0A0V7ZCG4,A0A1J0AGK2,K9PFF9,A0A2G9DT08,K9UEV4,Q9L1X1,A0A060HNJ0,A0A235B542,R5XQK4,A0A1H3LE92,A0A496APJ8,A0A062U2W9,H0HWQ5,A0A1V9G9U4,A0A1I2ZGP1,A0A317EJY3,A0A1I2BD20,F8ERC7,S7VLM7,A0A1A5X8H4,A0A1I2T6Q1,A0A1R3T9N6,A0A0Q2M2Z1,H8KXJ0,D3S0S6,A0A2D1U4H7,I3TE64,A0A0B7I4Z6,A0LL61,A0A139WY18,A0A2T1E1K4,A0A1Q8ZD62,A0A4Q6XKV6,A0A1Z3HNN4,A0A239JE83,A0A2N4XBY2,R5JEI2,A0A0Q0ZC47,A0A2T0XH18,A0A1V4CHV0,A0A1K1RQP7,A0A1N6LUI7,A0A0P0NGR6,A0A1X7IML5,A0A0A2LKJ7,K1L112,A0A0U3AL92,A0A1H3A054,B9LVW4,A0A0C5JKF3,R5NJJ8,A5D4D9,A0A142Y7A9,A0A432MEQ5,A0A372DKU2,A0A3R7KLK4,C1F5Q7,A0A4R3EV39,A0A1P8WP90,A0A222F7P0,A0A1C9VH88,A0A2T2YMB1,A0A329TD61,A0A101R2A0,A0A1E3XF49,A0A1U9ND56,A0A4R7BQC4,A0A1H3DGN3,A0A1Q1FPH0,E0TGY3,A0A259TUP4,F6EYI8,A0A2S9Q9J0,A0A4Q2UIU6,A0A1H0LH25,A0A318LG42,H1YCU5,L0JS08,A0A1Q5ZS75,A0A345E7N0,M0AF24,A0A1W2A082,A0A1H3X247,A0A0C1XUA0,M0D2X3,A0A2R5G167,A0A346PK63,R7RTW6,A0A1H2RBI2,A0A1C3ZXN2,B9LVP8,M5RSF0,B7K585,F8D8G0,A0A343TL88,L0AJX6,A0A2A5QS34,A0A343JEE2,A0A3P3RGE5,A0A329TBQ3,A0A285N2A8,A0A0W1S8B8,A0A1V4C8L7,L9VRQ2,E4NRV1,A0A1I6HGN0,A0A1I0NI68,,",366,37
"928","C.H10.3","C.H10.7",328,176,152,1.93316387559809,"4F1N,4F3T,4KRE,5GUH,5VM9,6KR6,6OON,7KX7,A0A163JTZ6,J9D5G4,C4LVV2,A0A2P6N8X7,A8BCK6,A2DPV7,A0A0G4H2S4,R1FDF0,D2VMG4,A0A074TLL7,A0A0D1ZAJ4,Q1K660,F4PH46,A0A3M7S814,A0A164ZA52,Q54G64,S7WCF7,I0YVB2,R7QGN7,C1DZY0,A0A2C5Z0M1,A0CB11,R9ACY5,D3BMP8,A0A1Z5TVE5,W7XD45,A0A1U7LLR0,A0A4S2MWZ7,K1VVQ6,A0A158P1R9,G7DVX0,V6R0U9,G4N9J3,E3KLI3,B7Q5I1,A0A1E3QC61,D5GGK8,S8ANP9,A0A139AUH8,L2GMR6,U4LBG4,A0A177URI1,O74957,A0A3N4IGK1,A6N7Y9,A0A0E9NDK5,T1KZ60,A0A250WXN5,A0A2G8JLH3,Q5KAT1,L2GUF2,W2T741,A0A1W0E4B5,A0A2J7QB22,S4RYE2,A0A2K3CW87,A0A388KES6,A0A226EFL3,A0A3S3PD82,A0A0L0TEV1,A0A1S3J512,G0QTT2,A0A1J1HRI1,C4V9J2,Q9JMB7,A0A075AN09,Q5TW24,U5HIG6,A0A401PRI6,Q96J94,A0A2B4RHN2,G2QEV0,A0A397UU01,A0A2T7PFL8,K7ISV0,A0A024FT57,H3HCL6,A0A0G4IME3,E9FUN9,A0A1S3CYL5,D7FQK3,A0A1Y1YHC8,T1GSU4,F4S231,A0A1D8PMK0,A0A2G5B1D8,Q5BD61,A0A1C7M8P2,A0A4D8YSQ3,A0A158PJG6,J9JZ66,A0A0C2XG51,A0A158QZT6,A0A165QYQ9,T0SAU8,R7YY92,A0A3S1A0C3,A0A074YJ47,A0A2K1J482,A0A1Q3ENA6,O04379,A0A371I3C8,M8AEW7,A8P0D4,A0A2K3NY65,F4NYW7,A0A409Y6G2,A0A0L0HAB7,D8PZT7,A0A1D1W4K0,A7RQ46,W4YU94,A7BJS5,D8SNM6,A0A1J8PPA3,X1WG39,M5FQK2,Q69VD5,A0A2R6NSC2,A0A0D8XL16,A0A016WPN3,Q9QZ81,G5EES3,A0A0K0EFP6,Q8CJG0,A0A1D5NTU6,V2WTL2,A0A0V0YLH8,A0A139WDH0,A0A0R3W9Q7,H3DS31,A0A1Y1HWP2,G4T5G9,B7QCC4,A0A0B2UV00,M7BCJ9,E9GN30,Q7PZ41,A0A077Z361,R7U9I3,A0A1X7V1N5,A0A0K0JDP1,A0A0N4UKJ1,A0A498N3A3,A0A3M0IQP5,A0A0L8GBV4,Q32KD4,A0A1J1JBJ0,E0W4C3,A0A482XDA9,A0A3P7EJD6,J9K2Z4,A0A2J7Q8V4,T1IBM6,V3ZRX0,A0A210QKF7,A0A423TSS1,K1PT78,A0A267E8R7,A0A1D2N447,A0A226D7A9,F6YK55,T1KTE4,A0A2C9JGZ6,A0A1V9X9F0,K5X5Z7,A0A3Q0KUG5,T1FY40,1Z26,5AWH,5G5T,5I4A,7R8K,A0A1I7IXT4,A0A2W1JZ37,A0A2S7WBN3,A0A420DFE6,A0A4V1VDY2,A0A368P5I0,C4L1M1,A0A4R1RMM2,A0A1Y2RDH8,Q11QW7,A0A1M5ZSR3,A0A0K8QX04,A0A0M2PXX3,A0A1L3JHM3,A0A1W6MIP2,A0A1C0UUC4,A0A2U2J9E0,A0A2Z6E1D5,A0A0F4NXW8,A0A142XB92,L8D0R3,B1XJG0,A0A3D8L290,H1KXR6,A0A097QRL6,K9RC91,A0A1T4Y3A2,B6YTQ5,A0A0B0H9B4,A0A2T1EFY0,R6KUL9,A0A433NB65,K9UQR0,B7GJX9,B0JXD6,A0A1Z4K1Y3,A0A2Z6E0R7,A0A1N6SSK9,A0A0P4UVI8,A0A1J0AGK2,A0A2G9DT08,K9UEV4,Q9L1X1,A0A060HNJ0,A0A235B542,R5XQK4,A0A1H3LE92,A0A496APJ8,A0A062U2W9,H0HWQ5,A0A1V9G9U4,A0A1I2ZGP1,A0A317EJY3,A0A1I2BD20,F8ERC7,A0A1I2T6Q1,A0A1R3T9N6,A0A0Q2M2Z1,H8KXJ0,D3S0S6,A0A2D1U4H7,I3TE64,A0A0B7I4Z6,A0LL61,Q8DKB1,A0A139WY18,A0A1J1EK56,A0A2T1E1K4,A0A1Q8ZD62,A0A4Q6XKV6,A0A1Z3HNN4,A0A239JE83,A0A2N4XBY2,Q53W94,R5JEI2,A0A0Q0ZC47,A0A2T0XH18,A0A1V4CHV0,A0A1K1RQP7,A0A2T1EKT1,A0A1N6LUI7,A0A0P0NGR6,A0A1X7IML5,A0A0A2LKJ7,K1L112,A0A0U3AL92,A0A1H3A054,E0UCX3,K9XZC6,A0A0C1VHB4,Q31N05,A0A0C5JKF3,R5NJJ8,A5D4D9,Q2JI93,A0A142Y7A9,A0A432MEQ5,A0A372DKU2,A0A3R7KLK4,C1F5Q7,A0A4R3EV39,A0A1P8WP90,A0A222F7P0,A0A1C9VH88,A0A2T2YMB1,A0A329TD61,A0A101R2A0,A0A1E3XF49,A0A1U9ND56,A0A4R7BQC4,A0A1H3DGN3,A0A1Q1FPH0,E0TGY3,F6EYI8,A0A2S9Q9J0,A0A4Q2UIU6,A0A1H0LH25,A0A318LG42,L0JS08,A0A345E7N0,M0AF24,A0A1W2A082,A0A1H3X247,M0D2X3,A0A2R5G167,A0A346PK63,R7RTW6,A0A1H2RBI2,A0A1C3ZXN2,B9LVP8,M5RSF0,W0JW77,B7K585,F8D8G0,A0A343TL88,L0AJX6,A0A2A5QS34,A0A343JEE2,A0A3P3RGE5,A0A329TBQ3,A0A285N2A8,A0A0W1S8B8,A0A1V4C8L7,L9VRQ2,E4NRV1,A0A1I6HGN0,A0A1I0NI68,,",366,37
"929","C.H10.4","C.H10.7",345,176,169,2.91191500806885,"4F1N,4F3T,4KRE,5GUH,6KR6,6OON,7KX7,A0A163JTZ6,J9D5G4,C4LVV2,A0A2P6N8X7,A8BCK6,A2DPV7,A0A0G4H2S4,R1FDF0,D2VMG4,A0A074TLL7,A0A0D1ZAJ4,Q1K660,F4PH46,A0A3M7S814,A0A164ZA52,A0A383WDW5,Q54G64,S7WCF7,I0YVB2,R7QGN7,C1DZY0,A0A2C5Z0M1,A0CB11,R9ACY5,D3BMP8,A0A1Z5TVE5,W7XD45,A0A1U7LLR0,A0A4S2MWZ7,K1VVQ6,A0A158P1R9,G7DVX0,V6R0U9,G4N9J3,E3KLI3,B7Q5I1,A0A1E3QC61,D5GGK8,S8ANP9,A0A139AUH8,L2GMR6,U4LBG4,A0A177URI1,O74957,A0A3N4IGK1,A6N7Y9,A0A0E9NDK5,T1KZ60,A0A250WXN5,A0A2G8JLH3,Q5KAT1,L2GUF2,W2T741,A0A1W0E4B5,A0A2J7QB22,S4RYE2,A0A2K3CW87,A0A388KES6,A0A226EFL3,A0A3S3PD82,A0A0L0TEV1,A0A1S3J512,G0QTT2,A0A1J1HRI1,C4V9J2,Q9JMB7,A0A075AN09,Q5TW24,U5HIG6,A0A401PRI6,Q96J94,A0A2B4RHN2,G2QEV0,A0A397UU01,A0A2T7PFL8,K7ISV0,A0A024FT57,H3HCL6,A0A0G4IME3,E9FUN9,A0A1S3CYL5,D7FQK3,A0A1Y1YHC8,T1GSU4,F4S231,A0A1D8PMK0,A0A2G5B1D8,Q5BD61,A0A1C7M8P2,A0A4D8YSQ3,A0A158PJG6,J9JZ66,A0A0C2XG51,A0A158QZT6,A0A165QYQ9,T0SAU8,R7YY92,A0A3S1A0C3,A0A074YJ47,A0A2K1J482,A0A1Q3ENA6,O04379,A0A371I3C8,M8AEW7,A8P0D4,A0A2K3NY65,F4NYW7,A0A409Y6G2,A0A0L0HAB7,D8PZT7,A0A1D1W4K0,A7RQ46,W4YU94,A7BJS5,D8SNM6,A0A1J8PPA3,X1WG39,M5FQK2,Q69VD5,A0A2R6NSC2,A0A0D8XL16,A0A016WPN3,Q9QZ81,G5EES3,A0A0K0EFP6,Q8CJG0,A0A1D5NTU6,V2WTL2,A0A0V0YLH8,A0A139WDH0,A0A0R3W9Q7,H3DS31,A0A1Y1HWP2,G4T5G9,B7QCC4,A0A0B2UV00,M7BCJ9,E9GN30,Q7PZ41,A0A077Z361,R7U9I3,A0A1X7V1N5,A0A0K0JDP1,A0A0N4UKJ1,A0A498N3A3,A0A3M0IQP5,A0A0L8GBV4,Q32KD4,A0A1J1JBJ0,E0W4C3,A0A482XDA9,A0A3P7EJD6,J9K2Z4,A0A2J7Q8V4,T1IBM6,V3ZRX0,A0A210QKF7,A0A423TSS1,K1PT78,A0A267E8R7,A0A1D2N447,A0A226D7A9,F6YK55,T1KTE4,A0A2C9JGZ6,A0A1V9X9F0,K5X5Z7,A0A3Q0KUG5,T1FY40,1YVU,1Z26,5AWH,5G5T,5I4A,6QZK,7R8K,A0A1I7IXT4,A0A2W1JZ37,A0A2S7WBN3,A0A328VKE4,A0A420DFE6,A0A4V1VDY2,A0A368P5I0,C4L1M1,A0A4R1RMM2,A0A1Y2RDH8,Q11QW7,A0A1M5ZSR3,A0A0K8QX04,A0A0M2PXX3,K9TPA9,A0A1L3JHM3,A0A1W6MIP2,A0A1C0UUC4,A0A2U2J9E0,A0A2Z6E1D5,A0A0F4NXW8,A0A142XB92,L8D0R3,B1XJG0,A0A326U7G5,H1KXR6,A0A1Q4R485,K9U8J6,A0A097QRL6,K9RC91,A0A0D8ZUC0,A0A139XGN8,A0A1T4Y3A2,B6YTQ5,A0A0B0H9B4,A0YYT3,A0A2T1EFY0,G6FTN0,R6KUL9,A0A433NB65,K9UQR0,A0A2T1G8M7,K9VUN0,B7GJX9,K9ZDE3,B0JXD6,A0A2T1LS63,A0A1Z4K1Y3,A0A2Z6E0R7,A0A1N6SSK9,A0A0P4UVI8,A0A0V7ZCG4,A0A1J0AGK2,A0A2G9DT08,K9UEV4,Q9L1X1,A0A235B542,R5XQK4,A0A1H3LE92,A0A496APJ8,A0A062U2W9,H0HWQ5,A0A1V9G9U4,A0A1I2ZGP1,A0A317EJY3,A0A1I2BD20,F8ERC7,A0A1A5X8H4,A0A1I2T6Q1,A0A1R3T9N6,A0A0Q2M2Z1,H8KXJ0,D3S0S6,A0A2D1U4H7,I3TE64,A0A0B7I4Z6,A0LL61,Q8DKB1,A0A139WY18,A0A1J1EK56,A0A2T1E1K4,A0A1Q8ZD62,A0A4Q6XKV6,A0A1Z3HNN4,A0A239JE83,A0A2N4XBY2,Q53W94,R5JEI2,A0A0Q0ZC47,A0A2T0XH18,A0A1V4CHV0,A0A1K1RQP7,A0A2T1EKT1,A0A1N6LUI7,A0A0P0NGR6,A0A1X7IML5,A0A0A2LKJ7,K1L112,A0A0U3AL92,A0A1H3A054,E0UCX3,K9XZC6,A0A0C1VHB4,Q31N05,A0A0C5JKF3,R5NJJ8,A5D4D9,Q2JI93,A0A142Y7A9,A0A432MEQ5,A0A372DKU2,A0A3R7KLK4,C1F5Q7,A0A4R3EV39,A0A1P8WP90,A0A222F7P0,A0A1C9VH88,A0A2T2YMB1,A0A329TD61,A0A101R2A0,A0A1E3XF49,A0A1U9ND56,A0A4R7BQC4,A0A1H3DGN3,A0A1Q1FPH0,E0TGY3,A0A259TUP4,F6EYI8,A0A2S9Q9J0,A0A4Q2UIU6,A0A1H0LH25,A0A318LG42,L0JS08,A0A345E7N0,M0AF24,A0A1W2A082,A0A1H3X247,A0A0C1XUA0,M0D2X3,A0A2R5G167,A0A346PK63,R7RTW6,A0A1H2RBI2,A0A1C3ZXN2,B9LVP8,M5RSF0,W0JW77,B7K585,F8D8G0,A0A343TL88,L0AJX6,A0A2A5QS34,A0A343JEE2,A0A3P3RGE5,A0A329TBQ3,A0A285N2A8,A0A0W1S8B8,A0A1V4C8L7,L9VRQ2,E4NRV1,A0A1I6HGN0,A0A1I0NI68,,",366,37
"930","C.H10.6","C.L25.3",277,176,101,3.83947457245725,"4F1N,4F3T,4KRE,5GUH,5VM9,6KR6,6OON,7KX7,7SWF,A0A163JTZ6,A0A196SDB4,J9D5G4,A0A2P6N8X7,A2DPV7,A0A0G4H2S4,R1FDF0,D2VMG4,A0A074TLL7,A0A0D1ZAJ4,Q1K660,F4PH46,A0A3M7S814,A0A164ZA52,A0A383WDW5,Q54G64,S7WCF7,I0YVB2,R7QGN7,C1DZY0,A0A2C5Z0M1,A0CB11,R9ACY5,D3BMP8,A0A1Z5TVE5,W7XD45,A0A1U7LLR0,A0A4S2MWZ7,K1VVQ6,A0A158P1R9,G7DVX0,V6R0U9,G4N9J3,E3KLI3,B7Q5I1,A0A1E3QC61,D5GGK8,S8ANP9,A0A139AUH8,L2GMR6,U4LBG4,A0A177URI1,O74957,A0A3N4IGK1,A6N7Y9,A0A0E9NDK5,T1KZ60,A0A250WXN5,A0A2G8JLH3,Q5KAT1,L2GUF2,W2T741,A0A1W0E4B5,A0A2J7QB22,S4RYE2,A0A2K3CW87,A0A388KES6,A0A226EFL3,A0A3S3PD82,A0A0L0TEV1,A0A1S3J512,G0QTT2,A0A1J1HRI1,C4V9J2,Q9JMB7,A0A075AN09,Q5TW24,U5HIG6,A0A401PRI6,Q96J94,A0A2B4RHN2,G2QEV0,A0A397UU01,A0A2T7PFL8,K7ISV0,A0A024FT57,H3HCL6,A0A0G4IME3,E9FUN9,A0A1S3CYL5,D7FQK3,A0A1Y1YHC8,T1GSU4,F4S231,A0A1D8PMK0,A0A2G5B1D8,Q5BD61,A0A1C7M8P2,A0A4D8YSQ3,A0A158PJG6,A0A0C2XG51,A0A158QZT6,A0A165QYQ9,T0SAU8,R7YY92,A0A3S1A0C3,A0A074YJ47,A0A2K1J482,A0A1Q3ENA6,O04379,A0A371I3C8,M8AEW7,A8P0D4,A0A2K3NY65,F4NYW7,A0A409Y6G2,A0A0L0HAB7,D8PZT7,A0A1D1W4K0,A7RQ46,W4YU94,A7BJS5,D8SNM6,A0A1J8PPA3,X1WG39,M5FQK2,Q69VD5,A0A2R6NSC2,A0A0D8XL16,A0A016WPN3,Q9QZ81,G5EES3,A0A0K0EFP6,Q8CJG0,A0A1D5NTU6,V2WTL2,A0A0V0YLH8,A0A139WDH0,A0A0R3W9Q7,H3DS31,A0A1Y1HWP2,G4T5G9,B7QCC4,A0A0B2UV00,M7BCJ9,E9GN30,Q7PZ41,A0A077Z361,R7U9I3,A0A1X7V1N5,A0A0K0JDP1,A0A0N4UKJ1,A0A498N3A3,A0A3M0IQP5,A0A0L8GBV4,Q32KD4,A0A1J1JBJ0,E0W4C3,A0A482XDA9,A0A3P7EJD6,J9K2Z4,A0A2J7Q8V4,T1IBM6,V3ZRX0,A0A210QKF7,A0A423TSS1,K1PT78,A0A267E8R7,A0A1D2N447,A0A226D7A9,F6YK55,T1KTE4,A0A2C9JGZ6,A0A1V9X9F0,K5X5Z7,A0A3Q0KUG5,T1FY40,1Z26,5AWH,6QZK,A0A328VKE4,C4L1M1,A0A4R1RMM2,A0A1Y2RDH8,A0A1M5ZSR3,A0A0K8QX04,A0A0M2PXX3,A0A1L3JHM3,A0A1W6MIP2,A0A1C0UUC4,A0A2U2J9E0,A0A0F4NXW8,B1XJG0,A0A3D8L290,A0A1Q4R485,A0A0B0H9B4,R6KUL9,B7GJX9,A0A2Z6E0R7,A0A1N6SSK9,Q9L1X1,A0A060HNJ0,A0A235B542,R5XQK4,A0A1H3LE92,A0A496APJ8,A0A1V9G9U4,A0A1A5X8H4,A0A1I2T6Q1,A0A1R3T9N6,H8KXJ0,D3S0S6,A0A2D1U4H7,A0A0B7I4Z6,A0LL61,A0A139WY18,A0A2T1E1K4,A0A1Q8ZD62,A0A4Q6XKV6,A0A1Z3HNN4,A0A239JE83,A0A2N4XBY2,R5JEI2,A0A0Q0ZC47,A0A2T0XH18,A0A1V4CHV0,A0A1K1RQP7,A0A1N6LUI7,A0A0P0NGR6,A0A1X7IML5,A0A0A2LKJ7,K1L112,A0A0U3AL92,A0A1H3A054,A0A0C1VHB4,A0A0C5JKF3,R5NJJ8,A5D4D9,A0A142Y7A9,A0A432MEQ5,A0A372DKU2,C1F5Q7,A0A4R3EV39,A0A1P8WP90,A0A222F7P0,A0A1C9VH88,A0A2T2YMB1,A0A1U9ND56,A0A4R7BQC4,E0TGY3,A0A259TUP4,F6EYI8,A0A2S9Q9J0,A0A4Q2UIU6,A0A1H0LH25,A0A318LG42,L0JS08,M0AF24,M0D2X3,A0A2R5G167,A0A346PK63,R7RTW6,M5RSF0,W0JW77,B7K585,F8D8G0,A0A343TL88,L0AJX6,A0A2A5QS34,A0A343JEE2,A0A3P3RGE5,A0A329TBQ3,A0A285N2A8,A0A0W1S8B8,A0A1V4C8L7,L9VRQ2,E4NRV1,A0A1I6HGN0,,",366,37
"943","C.L21.16","C.S14.2",298,176,122,1.74143070044709,"4F1N,4F3T,4KRE,5GUH,6OON,7SWF,A0A163JTZ6,A0A0N4X8S8,A0A196SDB4,J9D5G4,Q389P5,C4LVV2,A2DPV7,T1H8B3,R1FDF0,D2VMG4,A0A074TLL7,A0A0D1ZAJ4,Q1K660,F4PH46,A0A3M7S814,A0A164ZA52,A0A383WDW5,Q54G64,S7WCF7,I0YVB2,R7QGN7,C1DZY0,A0A2C5Z0M1,A0CB11,R9ACY5,D3BMP8,A0A1Z5TVE5,W7XD45,A0A1U7LLR0,A0A4S2MWZ7,K1VVQ6,A0A158P1R9,G7DVX0,V6R0U9,G4N9J3,E3KLI3,B7Q5I1,A0A1E3QC61,D5GGK8,S8ANP9,A0A139AUH8,L2GMR6,U4LBG4,A0A177URI1,O74957,A0A3N4IGK1,A6N7Y9,A0A0E9NDK5,T1KZ60,A0A250WXN5,A0A2G8JLH3,Q5KAT1,L2GUF2,W2T741,A0A1W0E4B5,A0A2J7QB22,S4RYE2,A0A2K3CW87,A0A388KES6,A0A226EFL3,A0A3S3PD82,A0A0L0TEV1,A0A1S3J512,G0QTT2,A0A1J1HRI1,C4V9J2,Q9JMB7,A0A075AN09,Q5TW24,U5HIG6,A0A401PRI6,Q96J94,A0A2B4RHN2,G2QEV0,A0A397UU01,A0A2T7PFL8,K7ISV0,A0A024FT57,H3HCL6,A0A0G4IME3,E9FUN9,A0A1S3CYL5,D7FQK3,A0A1Y1YHC8,T1GSU4,F4S231,A0A1D8PMK0,A0A2G5B1D8,Q5BD61,A0A1C7M8P2,A0A4D8YSQ3,A0A158PJG6,J9JZ66,A0A0C2XG51,A0A158QZT6,A0A165QYQ9,T0SAU8,R7YY92,A0A3S1A0C3,A0A074YJ47,A0A2K1J482,A0A1Q3ENA6,O04379,A0A371I3C8,M8AEW7,A8P0D4,A0A2K3NY65,F4NYW7,A0A409Y6G2,A0A0L0HAB7,D8PZT7,A0A1D1W4K0,A7RQ46,W4YU94,A7BJS5,D8SNM6,A0A1J8PPA3,X1WG39,M5FQK2,Q69VD5,A0A2R6NSC2,A0A0D8XL16,A0A016WPN3,Q9QZ81,G5EES3,A0A0K0EFP6,Q8CJG0,A0A1D5NTU6,V2WTL2,A0A0V0YLH8,A0A139WDH0,A0A0R3W9Q7,H3DS31,A0A1Y1HWP2,G4T5G9,B7QCC4,A0A0B2UV00,M7BCJ9,E9GN30,Q7PZ41,A0A077Z361,R7U9I3,A0A1X7V1N5,A0A0K0JDP1,A0A0N4UKJ1,A0A498N3A3,A0A3M0IQP5,A0A0L8GBV4,Q32KD4,A0A1J1JBJ0,E0W4C3,A0A482XDA9,A0A3P7EJD6,J9K2Z4,A0A2J7Q8V4,T1IBM6,V3ZRX0,A0A210QKF7,A0A423TSS1,K1PT78,A0A267E8R7,A0A1D2N447,A0A226D7A9,F6YK55,T1KTE4,A0A2C9JGZ6,A0A1V9X9F0,K5X5Z7,A0A3Q0KUG5,T1FY40,1YVU,5AWH,7R8K,A0A1I7IXT4,A0A2W1JZ37,A0A2S7WBN3,A0A328VKE4,A0A420DFE6,A0A4V1VDY2,A0A368P5I0,A0A4R1RMM2,A0A1Y2RDH8,Q11QW7,A0A1M5ZSR3,K9TPA9,A0A1L3JHM3,A0A2U2J9E0,A0A2Z6E1D5,B1XJG0,A0A1Q4R485,K9U8J6,K9RC91,A0A0D8ZUC0,A0A1T4Y3A2,Q5P0R2,A0YYT3,A0A2T1EFY0,G6FTN0,A0A433NB65,A0A1Z4L0A1,K9UQR0,A0A2T1G8M7,K9VUN0,A0A0P6X5X2,B0JXD6,A0A2T1LS63,A0A1Z4K1Y3,A0A2Z6E0R7,A0A0P4UVI8,A0A0V7ZCG4,A0A1J0AGK2,K9PFF9,A0A2G9DT08,Q9L1X1,A0A062U2W9,H0HWQ5,A0A1I2ZGP1,F8ERC7,S7VLM7,A0A1A5X8H4,A0A1I2T6Q1,A0A1R3T9N6,H8KXJ0,A0A2D1U4H7,A0A0B7I4Z6,A0LL61,Q8DKB1,A0A1J1EK56,A0A4Q6XKV6,A0A239JE83,A0A2N4XBY2,Q53W94,R5JEI2,A0A0Q0ZC47,A0A2T0XH18,A0A1V4CHV0,A0A1K1RQP7,A0A2T1EKT1,A0A1N6LUI7,A0A0P0NGR6,A0A1X7IML5,A0A0A2LKJ7,K1L112,A0A0U3AL92,A0A1H3A054,A0A0C5JKF3,R5NJJ8,A5D4D9,Q2JI93,A0A142Y7A9,A0A432MEQ5,A0A372DKU2,A0A3R7KLK4,C1F5Q7,A0A4R3EV39,A0A222F7P0,A0A1C9VH88,A0A2T2YMB1,A0A329TD61,A0A101R2A0,A0A1E3XF49,A0A1U9ND56,A0A4R7BQC4,A0A1Q1FPH0,E0TGY3,A0A259TUP4,F6EYI8,A0A2S9Q9J0,A0A4Q2UIU6,A0A1H0LH25,A0A318LG42,H1YCU5,L0JS08,A0A1Q5ZS75,A0A345E7N0,M0AF24,A0A1W2A082,A0A1H3X247,A0A0C1XUA0,M0D2X3,A0A2R5G167,A0A346PK63,R7RTW6,A0A1H2RBI2,A0A1C3ZXN2,B9LVP8,M5RSF0,B7K585,L0AJX6,A0A2A5QS34,A0A343JEE2,A0A285N2A8,,",366,37
"946","C.S16.5","C.S16.7",232,176,56,1.79220779220779,"4F1N,4F3T,4KRE,5GUH,5VM9,6KR6,6OON,7KX7,A0A163JTZ6,A0A0N4X8S8,J9D5G4,A0A2P6N8X7,A8BCK6,A2DPV7,R1FDF0,D2VMG4,A0A074TLL7,A0A0D1ZAJ4,Q1K660,F4PH46,A0A3M7S814,A0A164ZA52,A0A383WDW5,Q54G64,S7WCF7,I0YVB2,R7QGN7,C1DZY0,A0A2C5Z0M1,A0CB11,R9ACY5,D3BMP8,A0A1Z5TVE5,W7XD45,A0A1U7LLR0,A0A4S2MWZ7,K1VVQ6,A0A158P1R9,G7DVX0,V6R0U9,G4N9J3,E3KLI3,B7Q5I1,A0A1E3QC61,D5GGK8,S8ANP9,A0A139AUH8,L2GMR6,U4LBG4,A0A177URI1,O74957,A0A3N4IGK1,A6N7Y9,A0A0E9NDK5,T1KZ60,A0A250WXN5,A0A2G8JLH3,Q5KAT1,L2GUF2,W2T741,A0A1W0E4B5,A0A2J7QB22,S4RYE2,A0A2K3CW87,A0A388KES6,A0A226EFL3,A0A3S3PD82,A0A0L0TEV1,A0A1S3J512,G0QTT2,A0A1J1HRI1,C4V9J2,Q9JMB7,A0A075AN09,Q5TW24,U5HIG6,A0A401PRI6,Q96J94,A0A2B4RHN2,G2QEV0,A0A397UU01,A0A2T7PFL8,K7ISV0,A0A024FT57,H3HCL6,A0A0G4IME3,E9FUN9,A0A1S3CYL5,D7FQK3,A0A1Y1YHC8,T1GSU4,F4S231,A0A1D8PMK0,A0A2G5B1D8,Q5BD61,A0A1C7M8P2,A0A4D8YSQ3,A0A158PJG6,J9JZ66,A0A0C2XG51,A0A158QZT6,A0A165QYQ9,T0SAU8,R7YY92,A0A3S1A0C3,A0A074YJ47,A0A2K1J482,A0A1Q3ENA6,O04379,A0A371I3C8,M8AEW7,A8P0D4,A0A2K3NY65,F4NYW7,A0A409Y6G2,A0A0L0HAB7,D8PZT7,A0A1D1W4K0,A7RQ46,W4YU94,A7BJS5,D8SNM6,A0A1J8PPA3,X1WG39,M5FQK2,Q69VD5,A0A2R6NSC2,A0A0D8XL16,A0A016WPN3,Q9QZ81,G5EES3,A0A0K0EFP6,Q8CJG0,A0A1D5NTU6,V2WTL2,A0A0V0YLH8,A0A139WDH0,A0A0R3W9Q7,H3DS31,A0A1Y1HWP2,G4T5G9,B7QCC4,A0A0B2UV00,M7BCJ9,E9GN30,Q7PZ41,A0A077Z361,R7U9I3,A0A1X7V1N5,A0A0K0JDP1,A0A0N4UKJ1,A0A498N3A3,A0A3M0IQP5,A0A0L8GBV4,Q32KD4,A0A1J1JBJ0,E0W4C3,A0A482XDA9,A0A3P7EJD6,J9K2Z4,A0A2J7Q8V4,T1IBM6,V3ZRX0,A0A210QKF7,A0A423TSS1,K1PT78,A0A267E8R7,A0A1D2N447,A0A226D7A9,F6YK55,T1KTE4,A0A2C9JGZ6,A0A1V9X9F0,K5X5Z7,A0A3Q0KUG5,T1FY40,1YVU,3DLB,5AWH,5I4A,6QZK,B1XJG0,A0A1H3LE92,A0A496APJ8,H8KXJ0,A0A2D1U4H7,Q8DKB1,A0A1J1EK56,Q53W94,A0A2T1EKT1,K9XZC6,A0A0C1VHB4,Q31N05,A0A0C5JKF3,R5NJJ8,A5D4D9,Q2JI93,A0A432MEQ5,C1F5Q7,A0A4R3EV39,A0A1P8WP90,A0A329TD61,A0A1E3XF49,A0A1Q1FPH0,L0JS08,A0A345E7N0,M0AF24,A0A1W2A082,A0A1H3X247,A0A0C1XUA0,M0D2X3,A0A2R5G167,A0A346PK63,R7RTW6,A0A1H2RBI2,A0A1C3ZXN2,B9LVP8,W0JW77,B7K585,A0A343TL88,L0AJX6,A0A2A5QS34,A0A343JEE2,A0A3P3RGE5,A0A329TBQ3,A0A285N2A8,A0A0W1S8B8,A0A1V4C8L7,L9VRQ2,E4NRV1,A0A1I6HGN0,A0A1I0NI68,,",366,37
"949","N.H3.10","N.H3.12",350,176,174,1.95141065830721,"4F1N,4F3T,4KRE,5GUH,5VM9,6KR6,6OON,7KX7,7SWF,A0A0N4X8S8,A0A196SDB4,Q389P5,C4LVV2,A0A0G4H2S4,T1H8B3,S4RWI0,D2VMG4,A0A074TLL7,A0A0D1ZAJ4,Q1K660,F4PH46,A0A3M7S814,A0A164ZA52,Q54G64,S7WCF7,I0YVB2,R7QGN7,C1DZY0,A0A2C5Z0M1,A0CB11,R9ACY5,D3BMP8,A0A1Z5TVE5,W7XD45,A0A1U7LLR0,A0A4S2MWZ7,K1VVQ6,A0A158P1R9,G7DVX0,V6R0U9,G4N9J3,E3KLI3,B7Q5I1,A0A1E3QC61,D5GGK8,S8ANP9,A0A139AUH8,L2GMR6,U4LBG4,A0A177URI1,O74957,A0A3N4IGK1,A6N7Y9,A0A0E9NDK5,T1KZ60,A0A250WXN5,A0A2G8JLH3,Q5KAT1,L2GUF2,W2T741,A0A1W0E4B5,A0A2J7QB22,S4RYE2,A0A2K3CW87,A0A388KES6,A0A226EFL3,A0A3S3PD82,A0A0L0TEV1,A0A1S3J512,G0QTT2,A0A1J1HRI1,C4V9J2,Q9JMB7,A0A075AN09,Q5TW24,U5HIG6,A0A401PRI6,Q96J94,A0A2B4RHN2,G2QEV0,A0A397UU01,A0A2T7PFL8,K7ISV0,A0A024FT57,H3HCL6,A0A0G4IME3,E9FUN9,A0A1S3CYL5,D7FQK3,A0A1Y1YHC8,T1GSU4,F4S231,A0A1D8PMK0,A0A2G5B1D8,Q5BD61,A0A1C7M8P2,A0A4D8YSQ3,A0A158PJG6,J9JZ66,A0A0C2XG51,A0A158QZT6,A0A165QYQ9,T0SAU8,R7YY92,A0A3S1A0C3,A0A074YJ47,A0A2K1J482,A0A1Q3ENA6,O04379,A0A371I3C8,M8AEW7,A8P0D4,A0A2K3NY65,F4NYW7,A0A409Y6G2,A0A0L0HAB7,D8PZT7,A0A1D1W4K0,A7RQ46,W4YU94,A7BJS5,D8SNM6,A0A1J8PPA3,X1WG39,M5FQK2,Q69VD5,A0A2R6NSC2,A0A0D8XL16,A0A016WPN3,Q9QZ81,G5EES3,A0A0K0EFP6,Q8CJG0,A0A1D5NTU6,V2WTL2,A0A0V0YLH8,A0A139WDH0,A0A0R3W9Q7,H3DS31,A0A1Y1HWP2,G4T5G9,B7QCC4,A0A0B2UV00,M7BCJ9,E9GN30,Q7PZ41,A0A077Z361,R7U9I3,A0A1X7V1N5,A0A0K0JDP1,A0A0N4UKJ1,A0A498N3A3,A0A3M0IQP5,A0A0L8GBV4,Q32KD4,A0A1J1JBJ0,E0W4C3,A0A482XDA9,A0A3P7EJD6,J9K2Z4,A0A2J7Q8V4,T1IBM6,V3ZRX0,A0A210QKF7,A0A423TSS1,K1PT78,A0A267E8R7,A0A1D2N447,A0A226D7A9,F6YK55,T1KTE4,A0A2C9JGZ6,A0A1V9X9F0,K5X5Z7,A0A3Q0KUG5,T1FY40,1YVU,1Z26,3DLB,5AWH,5G5T,5I4A,6QZK,7R8K,A0A1I7IXT4,A0A2W1JZ37,A0A2S7WBN3,A0A420DFE6,E0ST67,A0A4V1VDY2,A0A368P5I0,A0A4R1RMM2,A0A1Y2RDH8,Q11QW7,A0A1M5ZSR3,A0A0M2PXX3,A0A1I3LMA1,K9TPA9,A0A1L3JHM3,A0A1W6MIP2,A0A1C0UUC4,A0A2U2J9E0,A0A2Z6E1D5,A0A0F4NXW8,A0A142XB92,L8D0R3,A0A326U7G5,A0A3D8L290,H1KXR6,A0A1Q4R485,K9U8J6,A0A097QRL6,K9RC91,A0A0D8ZUC0,A0A139XGN8,Q5P0R2,A0A0B0H9B4,A0YYT3,A0A2T1EFY0,G6FTN0,R6KUL9,A0A433NB65,K9UQR0,A0A2T1G8M7,K9VUN0,B7GJX9,A0A0P6X5X2,K9ZDE3,B0JXD6,A0A2T1LS63,A0A1Z4K1Y3,A0A2Z6E0R7,A0A1N6SSK9,A0A0P4UVI8,A0A0V7ZCG4,A0A1J0AGK2,K9PFF9,A0A2G9DT08,K9UEV4,Q9L1X1,A0A060HNJ0,A0A235B542,R5XQK4,A0A496APJ8,A0A062U2W9,H0HWQ5,A0A1V9G9U4,A0A1I2ZGP1,A0A317EJY3,A0A1I2BD20,F8ERC7,S7VLM7,A0A1A5X8H4,A0A1I2T6Q1,A0A1R3T9N6,A0A0Q2M2Z1,H8KXJ0,D3S0S6,A0A2D1U4H7,I3TE64,A0A0B7I4Z6,A0LL61,Q8DKB1,A0A139WY18,A0A1J1EK56,A0A2T1E1K4,A0A1Q8ZD62,A0A4Q6XKV6,A0A1Z3HNN4,A0A239JE83,A0A2N4XBY2,Q53W94,R5JEI2,A0A0Q0ZC47,A0A2T0XH18,A0A1V4CHV0,A0A1K1RQP7,A0A2T1EKT1,A0A1N6LUI7,A0A0P0NGR6,A0A1X7IML5,A0A0A2LKJ7,K1L112,A0A0U3AL92,A0A1H3A054,E0UCX3,K9XZC6,B9LVW4,A0A0C1VHB4,Q31N05,A0A0C5JKF3,R5NJJ8,A5D4D9,Q2JI93,A0A142Y7A9,A0A432MEQ5,A0A372DKU2,A0A3R7KLK4,C1F5Q7,A0A4R3EV39,A0A1P8WP90,A0A222F7P0,A0A1C9VH88,A0A2T2YMB1,A0A329TD61,A0A101R2A0,A0A1E3XF49,A0A1U9ND56,A0A4R7BQC4,A0A1H3DGN3,A0A1Q1FPH0,E0TGY3,A0A259TUP4,F6EYI8,A0A2S9Q9J0,A0A4Q2UIU6,A0A1H0LH25,A0A318LG42,H1YCU5,L0JS08,A0A1Q5ZS75,A0A345E7N0,M0AF24,A0A1W2A082,A0A1H3X247,A0A0C1XUA0,M0D2X3,A0A2R5G167,A0A346PK63,R7RTW6,A0A1H2RBI2,A0A1C3ZXN2,B9LVP8,M5RSF0,W0JW77,B7K585,F8D8G0,A0A343TL88,L0AJX6,A0A2A5QS34,A0A343JEE2,A0A3P3RGE5,A0A329TBQ3,A0A285N2A8,A0A0W1S8B8,A0A1V4C8L7,L9VRQ2,E4NRV1,A0A1I6HGN0,A0A1I0NI68,,",366,37
"955","N.H6.1","N.H6.4",246,176,70,2.9463474025974,"4F1N,4F3T,4KRE,5GUH,6KR6,6OON,7KX7,A0A163JTZ6,A0A0N4X8S8,A0A196SDB4,J9D5G4,Q389P5,C4LVV2,A0A2P6N8X7,A2DPV7,A0A0G4H2S4,T1H8B3,R1FDF0,S4RWI0,D2VMG4,A0A074TLL7,A0A0D1ZAJ4,Q1K660,F4PH46,A0A3M7S814,A0A164ZA52,A0A383WDW5,Q54G64,S7WCF7,I0YVB2,R7QGN7,A0A2C5Z0M1,A0CB11,R9ACY5,D3BMP8,A0A1Z5TVE5,W7XD45,A0A1U7LLR0,A0A4S2MWZ7,K1VVQ6,A0A158P1R9,G7DVX0,V6R0U9,G4N9J3,E3KLI3,A0A1E3QC61,D5GGK8,S8ANP9,A0A139AUH8,L2GMR6,U4LBG4,A0A177URI1,O74957,A0A3N4IGK1,A6N7Y9,A0A0E9NDK5,T1KZ60,A0A250WXN5,A0A2G8JLH3,Q5KAT1,L2GUF2,W2T741,A0A1W0E4B5,A0A2J7QB22,S4RYE2,A0A2K3CW87,A0A388KES6,A0A226EFL3,A0A3S3PD82,A0A0L0TEV1,A0A1S3J512,G0QTT2,A0A1J1HRI1,C4V9J2,Q9JMB7,A0A075AN09,Q5TW24,U5HIG6,A0A401PRI6,Q96J94,A0A2B4RHN2,G2QEV0,A0A397UU01,A0A2T7PFL8,K7ISV0,A0A024FT57,H3HCL6,A0A0G4IME3,E9FUN9,A0A1S3CYL5,D7FQK3,A0A1Y1YHC8,T1GSU4,F4S231,A0A1D8PMK0,A0A2G5B1D8,Q5BD61,A0A1C7M8P2,A0A4D8YSQ3,A0A158PJG6,J9JZ66,A0A0C2XG51,A0A158QZT6,T0SAU8,R7YY92,A0A3S1A0C3,A0A074YJ47,A0A2K1J482,A0A1Q3ENA6,O04379,A0A371I3C8,M8AEW7,A8P0D4,A0A2K3NY65,F4NYW7,A0A409Y6G2,A0A0L0HAB7,D8PZT7,A0A1D1W4K0,A7RQ46,A7BJS5,D8SNM6,A0A1J8PPA3,X1WG39,M5FQK2,Q69VD5,A0A2R6NSC2,A0A0D8XL16,A0A016WPN3,Q9QZ81,G5EES3,A0A0K0EFP6,Q8CJG0,A0A1D5NTU6,V2WTL2,A0A0V0YLH8,A0A139WDH0,A0A0R3W9Q7,H3DS31,A0A1Y1HWP2,G4T5G9,B7QCC4,A0A0B2UV00,M7BCJ9,E9GN30,Q7PZ41,A0A077Z361,R7U9I3,A0A1X7V1N5,A0A0K0JDP1,A0A0N4UKJ1,A0A498N3A3,A0A3M0IQP5,A0A0L8GBV4,Q32KD4,A0A1J1JBJ0,E0W4C3,A0A482XDA9,A0A3P7EJD6,J9K2Z4,A0A2J7Q8V4,T1IBM6,V3ZRX0,A0A210QKF7,A0A423TSS1,K1PT78,A0A267E8R7,A0A1D2N447,A0A226D7A9,F6YK55,T1KTE4,A0A2C9JGZ6,A0A1V9X9F0,K5X5Z7,A0A3Q0KUG5,T1FY40,1YVU,1Z26,3DLB,5G5T,6QZK,7R8K,E0ST67,C4L1M1,A0A0M2PXX3,A0A1I3LMA1,A0A1C0UUC4,A0A142XB92,B1XJG0,A0A0B0H9B4,R6KUL9,B7GJX9,A0A1N6SSK9,A0A060HNJ0,A0A235B542,R5XQK4,A0A1H3LE92,A0A062U2W9,H0HWQ5,A0A1I2ZGP1,A0A317EJY3,A0A1I2BD20,F8ERC7,Q8DKB1,A0A1J1EK56,Q53W94,A0A2T1EKT1,E0UCX3,K9XZC6,A0A0C1VHB4,Q31N05,R5NJJ8,Q2JI93,A0A3R7KLK4,A0A1E3XF49,A0A1H3DGN3,A0A1Q1FPH0,H1YCU5,L0JS08,A0A1Q5ZS75,A0A345E7N0,M0AF24,A0A1W2A082,A0A1H3X247,A0A0C1XUA0,M0D2X3,A0A346PK63,R7RTW6,A0A1H2RBI2,A0A1C3ZXN2,B9LVP8,W0JW77,F8D8G0,A0A343TL88,L0AJX6,A0A2A5QS34,A0A343JEE2,A0A3P3RGE5,A0A329TBQ3,A0A285N2A8,A0A0W1S8B8,A0A1V4C8L7,L9VRQ2,E4NRV1,A0A1I6HGN0,A0A1I0NI68,,",366,37
"966","N.S11.8","N.S12.5",331,176,155,2.02609970674487,"4F1N,4F3T,4KRE,5GUH,5VM9,6KR6,6OON,7KX7,A0A196SDB4,J9D5G4,C4LVV2,A0A2P6N8X7,A0A0G4H2S4,T1H8B3,R1FDF0,S4RWI0,D2VMG4,A0A0D1ZAJ4,Q1K660,F4PH46,A0A3M7S814,A0A164ZA52,A0A383WDW5,Q54G64,S7WCF7,I0YVB2,R7QGN7,C1DZY0,A0A2C5Z0M1,A0CB11,R9ACY5,D3BMP8,A0A1Z5TVE5,W7XD45,A0A1U7LLR0,A0A4S2MWZ7,K1VVQ6,A0A158P1R9,G7DVX0,V6R0U9,G4N9J3,E3KLI3,B7Q5I1,A0A1E3QC61,D5GGK8,S8ANP9,A0A139AUH8,L2GMR6,U4LBG4,A0A177URI1,O74957,A0A3N4IGK1,A6N7Y9,A0A0E9NDK5,T1KZ60,A0A250WXN5,A0A2G8JLH3,Q5KAT1,L2GUF2,W2T741,A0A1W0E4B5,A0A2J7QB22,S4RYE2,A0A2K3CW87,A0A388KES6,A0A226EFL3,A0A3S3PD82,A0A0L0TEV1,A0A1S3J512,G0QTT2,A0A1J1HRI1,C4V9J2,Q9JMB7,A0A075AN09,Q5TW24,U5HIG6,A0A401PRI6,Q96J94,A0A2B4RHN2,G2QEV0,A0A397UU01,A0A2T7PFL8,K7ISV0,A0A024FT57,H3HCL6,A0A0G4IME3,E9FUN9,A0A1S3CYL5,D7FQK3,A0A1Y1YHC8,T1GSU4,F4S231,A0A1D8PMK0,A0A2G5B1D8,Q5BD61,A0A1C7M8P2,A0A4D8YSQ3,A0A158PJG6,J9JZ66,A0A0C2XG51,A0A158QZT6,A0A165QYQ9,T0SAU8,R7YY92,A0A3S1A0C3,A0A074YJ47,A0A2K1J482,A0A1Q3ENA6,O04379,A0A371I3C8,M8AEW7,A8P0D4,A0A2K3NY65,F4NYW7,A0A409Y6G2,A0A0L0HAB7,D8PZT7,A0A1D1W4K0,A7RQ46,W4YU94,A7BJS5,D8SNM6,A0A1J8PPA3,X1WG39,M5FQK2,Q69VD5,A0A2R6NSC2,A0A0D8XL16,A0A016WPN3,Q9QZ81,G5EES3,A0A0K0EFP6,Q8CJG0,A0A1D5NTU6,V2WTL2,A0A0V0YLH8,A0A139WDH0,A0A0R3W9Q7,H3DS31,A0A1Y1HWP2,G4T5G9,B7QCC4,A0A0B2UV00,M7BCJ9,E9GN30,Q7PZ41,A0A077Z361,R7U9I3,A0A1X7V1N5,A0A0K0JDP1,A0A0N4UKJ1,A0A498N3A3,A0A3M0IQP5,A0A0L8GBV4,Q32KD4,A0A1J1JBJ0,E0W4C3,A0A482XDA9,A0A3P7EJD6,J9K2Z4,A0A2J7Q8V4,T1IBM6,V3ZRX0,A0A210QKF7,A0A423TSS1,K1PT78,A0A267E8R7,A0A1D2N447,A0A226D7A9,F6YK55,T1KTE4,A0A2C9JGZ6,A0A1V9X9F0,K5X5Z7,A0A3Q0KUG5,T1FY40,5AWH,5G5T,5I4A,6QZK,7R8K,A0A1I7IXT4,A0A2W1JZ37,A0A2S7WBN3,A0A420DFE6,A0A4V1VDY2,A0A368P5I0,C4L1M1,A0A4R1RMM2,A0A1Y2RDH8,A0A1I3LMA1,K9TPA9,A0A1W6MIP2,A0A2U2J9E0,B1XJG0,A0A326U7G5,A0A3D8L290,K9U8J6,A0A097QRL6,K9RC91,A0A0D8ZUC0,A0A139XGN8,A0A1T4Y3A2,A0A0B0H9B4,A0YYT3,A0A2T1EFY0,G6FTN0,R6KUL9,A0A433NB65,A0A1Z4L0A1,K9UQR0,A0A2T1G8M7,K9VUN0,B7GJX9,K9ZDE3,B0JXD6,A0A2T1LS63,A0A1Z4K1Y3,A0A1N6SSK9,A0A0P4UVI8,A0A0V7ZCG4,A0A1J0AGK2,K9PFF9,A0A2G9DT08,K9UEV4,Q9L1X1,A0A060HNJ0,A0A235B542,R5XQK4,A0A1H3LE92,A0A496APJ8,A0A062U2W9,H0HWQ5,A0A1V9G9U4,A0A1I2ZGP1,A0A317EJY3,A0A1I2BD20,S7VLM7,A0A1A5X8H4,A0A1I2T6Q1,A0A1R3T9N6,H8KXJ0,I3TE64,A0A0B7I4Z6,A0LL61,Q8DKB1,A0A139WY18,A0A1J1EK56,A0A2T1E1K4,A0A1Q8ZD62,A0A4Q6XKV6,A0A1Z3HNN4,A0A239JE83,A0A2N4XBY2,R5JEI2,A0A0Q0ZC47,A0A2T0XH18,A0A1V4CHV0,A0A1K1RQP7,A0A2T1EKT1,A0A1N6LUI7,A0A0P0NGR6,A0A1X7IML5,A0A0A2LKJ7,K1L112,A0A0U3AL92,A0A1H3A054,E0UCX3,K9XZC6,B9LVW4,A0A0C1VHB4,Q31N05,A0A0C5JKF3,R5NJJ8,A5D4D9,Q2JI93,A0A142Y7A9,A0A432MEQ5,A0A372DKU2,A0A3R7KLK4,C1F5Q7,A0A4R3EV39,A0A1P8WP90,A0A222F7P0,A0A1C9VH88,A0A2T2YMB1,A0A329TD61,A0A101R2A0,A0A1E3XF49,A0A1U9ND56,A0A4R7BQC4,A0A1H3DGN3,A0A1Q1FPH0,E0TGY3,A0A259TUP4,F6EYI8,A0A2S9Q9J0,A0A4Q2UIU6,A0A1H0LH25,A0A318LG42,H1YCU5,L0JS08,A0A1Q5ZS75,A0A345E7N0,M0AF24,A0A1W2A082,A0A1H3X247,A0A0C1XUA0,M0D2X3,A0A2R5G167,A0A346PK63,R7RTW6,A0A1H2RBI2,A0A1C3ZXN2,B9LVP8,M5RSF0,W0JW77,B7K585,A0A343TL88,L0AJX6,A0A2A5QS34,A0A343JEE2,A0A3P3RGE5,A0A329TBQ3,A0A285N2A8,A0A0W1S8B8,A0A1V4C8L7,L9VRQ2,E4NRV1,A0A1I6HGN0,A0A1I0NI68,,",366,37
"967","N.S17.3","N.S18.3",288,176,112,4.32102272727273,"4F1N,4F3T,4KRE,5GUH,5VM9,6KR6,6OON,7KX7,7SWF,A0A163JTZ6,A0A0N4X8S8,A0A196SDB4,J9D5G4,Q389P5,A0A2P6N8X7,A2DPV7,T1H8B3,S4RWI0,A0A074TLL7,A0A0D1ZAJ4,Q1K660,F4PH46,A0A3M7S814,A0A164ZA52,A0A383WDW5,Q54G64,S7WCF7,I0YVB2,R7QGN7,C1DZY0,A0A2C5Z0M1,A0CB11,R9ACY5,D3BMP8,A0A1Z5TVE5,W7XD45,A0A1U7LLR0,A0A4S2MWZ7,K1VVQ6,A0A158P1R9,G7DVX0,V6R0U9,G4N9J3,E3KLI3,A0A1E3QC61,D5GGK8,S8ANP9,A0A139AUH8,L2GMR6,U4LBG4,A0A177URI1,O74957,A0A3N4IGK1,A6N7Y9,A0A0E9NDK5,T1KZ60,A0A250WXN5,A0A2G8JLH3,Q5KAT1,L2GUF2,W2T741,A0A1W0E4B5,A0A2J7QB22,S4RYE2,A0A2K3CW87,A0A388KES6,A0A226EFL3,A0A3S3PD82,A0A0L0TEV1,A0A1S3J512,G0QTT2,A0A1J1HRI1,C4V9J2,Q9JMB7,A0A075AN09,Q5TW24,U5HIG6,A0A401PRI6,Q96J94,A0A2B4RHN2,G2QEV0,A0A397UU01,A0A2T7PFL8,K7ISV0,A0A024FT57,H3HCL6,A0A0G4IME3,E9FUN9,A0A1S3CYL5,D7FQK3,A0A1Y1YHC8,T1GSU4,F4S231,A0A1D8PMK0,A0A2G5B1D8,Q5BD61,A0A1C7M8P2,A0A4D8YSQ3,A0A158PJG6,J9JZ66,A0A158QZT6,A0A165QYQ9,T0SAU8,R7YY92,A0A3S1A0C3,A0A074YJ47,A0A2K1J482,A0A1Q3ENA6,O04379,A0A371I3C8,M8AEW7,A8P0D4,A0A2K3NY65,F4NYW7,A0A409Y6G2,A0A0L0HAB7,D8PZT7,A0A1D1W4K0,A7RQ46,W4YU94,A7BJS5,D8SNM6,A0A1J8PPA3,X1WG39,M5FQK2,Q69VD5,A0A2R6NSC2,A0A0D8XL16,A0A016WPN3,Q9QZ81,G5EES3,A0A0K0EFP6,Q8CJG0,A0A1D5NTU6,V2WTL2,A0A0V0YLH8,A0A139WDH0,A0A0R3W9Q7,H3DS31,A0A1Y1HWP2,G4T5G9,B7QCC4,A0A0B2UV00,M7BCJ9,E9GN30,Q7PZ41,A0A077Z361,R7U9I3,A0A1X7V1N5,A0A0K0JDP1,A0A0N4UKJ1,A0A498N3A3,A0A3M0IQP5,A0A0L8GBV4,Q32KD4,A0A1J1JBJ0,E0W4C3,A0A482XDA9,A0A3P7EJD6,J9K2Z4,A0A2J7Q8V4,T1IBM6,V3ZRX0,A0A210QKF7,A0A423TSS1,K1PT78,A0A267E8R7,A0A1D2N447,A0A226D7A9,F6YK55,T1KTE4,A0A2C9JGZ6,A0A1V9X9F0,K5X5Z7,A0A3Q0KUG5,T1FY40,1YVU,1Z26,3DLB,5AWH,5G5T,5I4A,6QZK,B1XJG0,A0A1T4Y3A2,A0A0P6X5X2,A0A2G9DT08,Q9L1X1,A0A1H3LE92,A0A496APJ8,A0A1V9G9U4,S7VLM7,A0A1A5X8H4,A0A1I2T6Q1,A0A1R3T9N6,A0A0Q2M2Z1,H8KXJ0,D3S0S6,A0A2D1U4H7,I3TE64,A0A0B7I4Z6,A0LL61,Q8DKB1,A0A139WY18,A0A1J1EK56,A0A2T1E1K4,A0A1Q8ZD62,A0A4Q6XKV6,A0A1Z3HNN4,A0A239JE83,A0A2N4XBY2,Q53W94,R5JEI2,A0A0Q0ZC47,A0A2T0XH18,A0A1V4CHV0,A0A1K1RQP7,A0A2T1EKT1,A0A0P0NGR6,A0A1X7IML5,A0A0A2LKJ7,K1L112,A0A0U3AL92,A0A1H3A054,E0UCX3,K9XZC6,A0A0C1VHB4,Q31N05,A0A0C5JKF3,R5NJJ8,A5D4D9,Q2JI93,A0A142Y7A9,A0A432MEQ5,A0A372DKU2,A0A3R7KLK4,C1F5Q7,A0A4R3EV39,A0A1P8WP90,A0A222F7P0,A0A1C9VH88,A0A2T2YMB1,A0A329TD61,A0A101R2A0,A0A1E3XF49,A0A1U9ND56,A0A4R7BQC4,A0A1H3DGN3,A0A1Q1FPH0,E0TGY3,A0A259TUP4,F6EYI8,A0A2S9Q9J0,A0A4Q2UIU6,A0A1H0LH25,A0A318LG42,H1YCU5,L0JS08,A0A1Q5ZS75,A0A345E7N0,M0AF24,A0A1W2A082,A0A1H3X247,A0A0C1XUA0,M0D2X3,A0A2R5G167,A0A346PK63,R7RTW6,A0A1H2RBI2,A0A1C3ZXN2,B9LVP8,M5RSF0,W0JW77,B7K585,F8D8G0,A0A343TL88,L0AJX6,A0A2A5QS34,A0A343JEE2,A0A3P3RGE5,A0A329TBQ3,A0A285N2A8,A0A0W1S8B8,A0A1V4C8L7,L9VRQ2,E4NRV1,A0A1I6HGN0,A0A1I0NI68,,",366,37
"970","C.H1.6","C.H1.8",335,177,158,1.96372380748051,"4F1N,4F3T,4KRE,5GUH,5VM9,6KR6,6OON,7KX7,7SWF,A0A163JTZ6,A0A0N4X8S8,A0A196SDB4,Q389P5,C4LVV2,A8BCK6,A2DPV7,A0A0G4H2S4,T1H8B3,S4RWI0,D2VMG4,A0A074TLL7,A0A0D1ZAJ4,Q1K660,F4PH46,A0A3M7S814,A0A164ZA52,A0A383WDW5,Q54G64,I0YVB2,R7QGN7,C1DZY0,A0A2C5Z0M1,A0CB11,R9ACY5,D3BMP8,A0A1Z5TVE5,W7XD45,A0A1U7LLR0,A0A4S2MWZ7,K1VVQ6,A0A158P1R9,G7DVX0,V6R0U9,G4N9J3,E3KLI3,B7Q5I1,A0A1E3QC61,D5GGK8,S8ANP9,A0A139AUH8,L2GMR6,U4LBG4,A0A177URI1,O74957,A0A3N4IGK1,A6N7Y9,A0A0E9NDK5,T1KZ60,A0A250WXN5,A0A2G8JLH3,Q5KAT1,L2GUF2,W2T741,A0A1W0E4B5,A0A2J7QB22,S4RYE2,A0A2K3CW87,A0A388KES6,A0A226EFL3,A0A3S3PD82,A0A0L0TEV1,A0A1S3J512,G0QTT2,A0A1J1HRI1,Q9JMB7,A0A075AN09,Q5TW24,U5HIG6,A0A401PRI6,Q96J94,A0A2B4RHN2,G2QEV0,A0A397UU01,A0A2T7PFL8,K7ISV0,A0A024FT57,H3HCL6,A0A0G4IME3,E9FUN9,A0A1S3CYL5,D7FQK3,A0A1Y1YHC8,T1GSU4,F4S231,A0A1D8PMK0,A0A2G5B1D8,Q5BD61,A0A1C7M8P2,A0A4D8YSQ3,A0A158PJG6,J9JZ66,A0A0C2XG51,A0A158QZT6,A0A165QYQ9,T0SAU8,R7YY92,A0A3S1A0C3,A0A074YJ47,A0A2K1J482,A0A1Q3ENA6,O04379,A0A371I3C8,M8AEW7,A8P0D4,A0A2K3NY65,F4NYW7,A0A409Y6G2,A0A0L0HAB7,D8PZT7,A0A1D1W4K0,A7RQ46,W4YU94,A7BJS5,D8SNM6,A0A1J8PPA3,X1WG39,M5FQK2,Q69VD5,A0A2R6NSC2,A0A0D8XL16,A0A016WPN3,Q9QZ81,G5EES3,A0A0K0EFP6,Q8CJG0,A0A1D5NTU6,V2WTL2,A0A0V0YLH8,A0A139WDH0,A0A0R3W9Q7,H3DS31,A0A1Y1HWP2,G4T5G9,B7QCC4,A0A0B2UV00,M7BCJ9,E9GN30,Q7PZ41,A0A077Z361,R7U9I3,A0A1X7V1N5,A0A0K0JDP1,A0A0N4UKJ1,A0A498N3A3,A0A3M0IQP5,A0A0L8GBV4,Q32KD4,A0A1J1JBJ0,E0W4C3,A0A482XDA9,J9K2Z4,A0A2J7Q8V4,T1IBM6,V3ZRX0,A0A210QKF7,A0A423TSS1,K1PT78,A0A267E8R7,A0A1D2N447,A0A226D7A9,F6YK55,T1KTE4,A0A2C9JGZ6,A0A1V9X9F0,K5X5Z7,A0A3Q0KUG5,T1FY40,1YVU,1Z26,5AWH,5G5T,5I4A,6QZK,7R8K,E8N0K8,A0A1I7IXT4,A0A2W1JZ37,A0A2S7WBN3,A0A328VKE4,A0A420DFE6,E0ST67,A0A4V1VDY2,A0A368P5I0,C4L1M1,A0A4R1RMM2,A0A1Y2RDH8,Q11QW7,A0A1M5ZSR3,A0A0K8QX04,A0A0M2PXX3,K9TPA9,A0A1L3JHM3,A0A1W6MIP2,A0A1C0UUC4,A0A2U2J9E0,A0A0F4NXW8,A0A142XB92,L8D0R3,A0A326U7G5,A0A3D8L290,H1KXR6,K9U8J6,A0A097QRL6,A0A0D8ZUC0,A0A139XGN8,A0A1T4Y3A2,Q5P0R2,B6YTQ5,A0A0B0H9B4,A0A2T1EFY0,G6FTN0,R6KUL9,A0A433NB65,A0A1Z4L0A1,K9UQR0,A0A2T1G8M7,K9VUN0,B7GJX9,A0A0P6X5X2,K9ZDE3,B0JXD6,A0A2T1LS63,A0A1Z4K1Y3,A0A2Z6E0R7,A0A1N6SSK9,A0A0P4UVI8,A0A1J0AGK2,K9PFF9,A0A2G9DT08,K9UEV4,Q9L1X1,A0A060HNJ0,A0A235B542,R5XQK4,A0A496APJ8,A0A062U2W9,H0HWQ5,A0A1V9G9U4,S7VLM7,A0A1A5X8H4,A0A1I2T6Q1,A0A1R3T9N6,A0A0Q2M2Z1,H8KXJ0,D3S0S6,A0A2D1U4H7,I3TE64,A0A0B7I4Z6,A0LL61,A0A139WY18,A0A2T1E1K4,A0A1Q8ZD62,A0A4Q6XKV6,A0A1Z3HNN4,A0A239JE83,A0A2N4XBY2,R5JEI2,A0A0Q0ZC47,A0A2T0XH18,A0A1V4CHV0,A0A1K1RQP7,A0A1N6LUI7,A0A0P0NGR6,A0A1X7IML5,A0A0A2LKJ7,K1L112,A0A0U3AL92,A0A1H3A054,A0A0C5JKF3,R5NJJ8,A5D4D9,A0A142Y7A9,A0A432MEQ5,A0A372DKU2,A0A3R7KLK4,C1F5Q7,A0A4R3EV39,A0A1P8WP90,A0A222F7P0,A0A1C9VH88,A0A2T2YMB1,A0A329TD61,A0A101R2A0,A0A1E3XF49,A0A1U9ND56,A0A4R7BQC4,A0A1H3DGN3,A0A1Q1FPH0,E0TGY3,A0A259TUP4,F6EYI8,A0A2S9Q9J0,A0A4Q2UIU6,A0A1H0LH25,A0A318LG42,H1YCU5,L0JS08,A0A1Q5ZS75,A0A345E7N0,M0AF24,A0A1W2A082,A0A1H3X247,A0A0C1XUA0,M0D2X3,A0A2R5G167,A0A346PK63,R7RTW6,A0A1H2RBI2,A0A1C3ZXN2,B9LVP8,M5RSF0,B7K585,F8D8G0,A0A343TL88,L0AJX6,A0A2A5QS34,A0A343JEE2,A0A3P3RGE5,A0A329TBQ3,A0A285N2A8,A0A0W1S8B8,A0A1V4C8L7,L9VRQ2,E4NRV1,A0A1I6HGN0,,",366,37
"975","C.H5.13","C.L11.1",336,177,159,1.03549728173969,"4F1N,4F3T,4KRE,5GUH,6KR6,6OON,A0A163JTZ6,A0A196SDB4,J9D5G4,C4LVV2,A0A2P6N8X7,A8BCK6,A2DPV7,A0A0G4H2S4,T1H8B3,R1FDF0,S4RWI0,D2VMG4,A0A074TLL7,A0A0D1ZAJ4,Q1K660,F4PH46,A0A3M7S814,A0A164ZA52,A0A383WDW5,Q54G64,S7WCF7,I0YVB2,R7QGN7,C1DZY0,A0A2C5Z0M1,A0CB11,R9ACY5,D3BMP8,A0A1Z5TVE5,W7XD45,A0A1U7LLR0,A0A4S2MWZ7,K1VVQ6,A0A158P1R9,G7DVX0,V6R0U9,G4N9J3,E3KLI3,B7Q5I1,A0A1E3QC61,D5GGK8,S8ANP9,A0A139AUH8,L2GMR6,U4LBG4,A0A177URI1,O74957,A0A3N4IGK1,A6N7Y9,A0A0E9NDK5,T1KZ60,A0A250WXN5,A0A2G8JLH3,Q5KAT1,L2GUF2,W2T741,A0A1W0E4B5,A0A2J7QB22,S4RYE2,A0A2K3CW87,A0A388KES6,A0A226EFL3,A0A3S3PD82,A0A1S3J512,G0QTT2,A0A1J1HRI1,C4V9J2,Q9JMB7,A0A075AN09,Q5TW24,U5HIG6,A0A401PRI6,Q96J94,A0A2B4RHN2,G2QEV0,A0A397UU01,A0A2T7PFL8,K7ISV0,A0A024FT57,H3HCL6,A0A0G4IME3,E9FUN9,A0A1S3CYL5,D7FQK3,A0A1Y1YHC8,T1GSU4,F4S231,A0A1D8PMK0,A0A2G5B1D8,Q5BD61,A0A1C7M8P2,A0A4D8YSQ3,A0A158PJG6,J9JZ66,A0A0C2XG51,A0A158QZT6,A0A165QYQ9,T0SAU8,R7YY92,A0A3S1A0C3,A0A074YJ47,A0A2K1J482,A0A1Q3ENA6,O04379,A0A371I3C8,M8AEW7,A8P0D4,A0A2K3NY65,F4NYW7,A0A409Y6G2,A0A0L0HAB7,D8PZT7,A0A1D1W4K0,A7RQ46,W4YU94,A7BJS5,D8SNM6,A0A1J8PPA3,X1WG39,M5FQK2,Q69VD5,A0A2R6NSC2,A0A0D8XL16,A0A016WPN3,Q9QZ81,G5EES3,A0A0K0EFP6,Q8CJG0,A0A1D5NTU6,V2WTL2,A0A0V0YLH8,A0A139WDH0,A0A0R3W9Q7,H3DS31,A0A1Y1HWP2,G4T5G9,B7QCC4,A0A0B2UV00,M7BCJ9,E9GN30,Q7PZ41,A0A077Z361,R7U9I3,A0A1X7V1N5,A0A0K0JDP1,A0A0N4UKJ1,A0A498N3A3,A0A3M0IQP5,A0A0L8GBV4,Q32KD4,A0A1J1JBJ0,E0W4C3,A0A482XDA9,A0A3P7EJD6,J9K2Z4,A0A2J7Q8V4,T1IBM6,V3ZRX0,A0A210QKF7,A0A423TSS1,K1PT78,A0A267E8R7,A0A1D2N447,A0A226D7A9,F6YK55,T1KTE4,A0A2C9JGZ6,A0A1V9X9F0,K5X5Z7,A0A3Q0KUG5,T1FY40,1YVU,1Z26,3DLB,5AWH,5G5T,E8N0K8,A0A328VKE4,C4L1M1,A0A4R1RMM2,A0A1Y2RDH8,Q11QW7,A0A1M5ZSR3,A0A0K8QX04,A0A0M2PXX3,A0A1I3LMA1,K9TPA9,A0A1L3JHM3,A0A1W6MIP2,A0A1C0UUC4,A0A2U2J9E0,A0A2Z6E1D5,A0A0F4NXW8,A0A142XB92,B1XJG0,A0A326U7G5,H1KXR6,A0A1Q4R485,K9U8J6,A0A097QRL6,K9RC91,A0A0D8ZUC0,A0A139XGN8,A0A1T4Y3A2,Q5P0R2,B6YTQ5,A0A0B0H9B4,A0YYT3,A0A2T1EFY0,G6FTN0,R6KUL9,A0A433NB65,A0A1Z4L0A1,K9UQR0,A0A2T1G8M7,K9VUN0,B7GJX9,K9ZDE3,B0JXD6,A0A2T1LS63,A0A1Z4K1Y3,A0A2Z6E0R7,A0A1N6SSK9,A0A0P4UVI8,A0A0V7ZCG4,A0A1J0AGK2,K9PFF9,A0A2G9DT08,K9UEV4,Q9L1X1,A0A060HNJ0,A0A235B542,R5XQK4,A0A1H3LE92,A0A496APJ8,A0A1V9G9U4,S7VLM7,A0A1A5X8H4,A0A1I2T6Q1,A0A1R3T9N6,A0A0Q2M2Z1,H8KXJ0,D3S0S6,A0A2D1U4H7,I3TE64,A0A0B7I4Z6,A0LL61,Q8DKB1,A0A139WY18,A0A1J1EK56,A0A2T1E1K4,A0A1Q8ZD62,A0A4Q6XKV6,A0A1Z3HNN4,A0A239JE83,A0A2N4XBY2,Q53W94,R5JEI2,A0A0Q0ZC47,A0A2T0XH18,A0A1V4CHV0,A0A1K1RQP7,A0A2T1EKT1,A0A1N6LUI7,A0A0P0NGR6,A0A1X7IML5,A0A0A2LKJ7,K1L112,A0A0U3AL92,A0A1H3A054,E0UCX3,K9XZC6,A0A0C1VHB4,Q31N05,A0A0C5JKF3,R5NJJ8,A5D4D9,Q2JI93,A0A142Y7A9,A0A432MEQ5,A0A372DKU2,C1F5Q7,A0A4R3EV39,A0A1P8WP90,A0A222F7P0,A0A1C9VH88,A0A2T2YMB1,A0A329TD61,A0A101R2A0,A0A1E3XF49,A0A1U9ND56,A0A4R7BQC4,A0A1Q1FPH0,E0TGY3,A0A259TUP4,F6EYI8,A0A2S9Q9J0,A0A4Q2UIU6,A0A1H0LH25,H1YCU5,L0JS08,A0A1Q5ZS75,A0A345E7N0,M0AF24,A0A1W2A082,A0A1H3X247,A0A0C1XUA0,M0D2X3,A0A346PK63,R7RTW6,A0A1H2RBI2,A0A1C3ZXN2,B9LVP8,M5RSF0,W0JW77,B7K585,F8D8G0,A0A343TL88,L0AJX6,A0A2A5QS34,A0A343JEE2,A0A3P3RGE5,A0A329TBQ3,A0A285N2A8,A0A0W1S8B8,A0A1V4C8L7,L9VRQ2,E4NRV1,A0A1I6HGN0,A0A1I0NI68,,",366,37
"978","C.H7.13","C.H7.16",246,177,69,3.42581675264063,"4F1N,4F3T,4KRE,5GUH,5VM9,6KR6,6OON,7KX7,7SWF,A0A163JTZ6,A0A0N4X8S8,A0A196SDB4,J9D5G4,C4LVV2,A0A2P6N8X7,A2DPV7,T1H8B3,R1FDF0,S4RWI0,D2VMG4,A0A0D1ZAJ4,Q1K660,F4PH46,A0A3M7S814,A0A164ZA52,A0A383WDW5,Q54G64,S7WCF7,I0YVB2,R7QGN7,C1DZY0,A0A2C5Z0M1,A0CB11,R9ACY5,D3BMP8,A0A1Z5TVE5,W7XD45,A0A1U7LLR0,A0A4S2MWZ7,K1VVQ6,A0A158P1R9,G7DVX0,V6R0U9,G4N9J3,E3KLI3,B7Q5I1,A0A1E3QC61,D5GGK8,S8ANP9,A0A139AUH8,L2GMR6,U4LBG4,A0A177URI1,O74957,A0A3N4IGK1,A6N7Y9,A0A0E9NDK5,T1KZ60,A0A250WXN5,A0A2G8JLH3,Q5KAT1,L2GUF2,W2T741,A0A1W0E4B5,A0A2J7QB22,A0A2K3CW87,A0A226EFL3,A0A3S3PD82,A0A0L0TEV1,A0A1S3J512,G0QTT2,A0A1J1HRI1,C4V9J2,Q9JMB7,A0A075AN09,Q5TW24,U5HIG6,A0A401PRI6,Q96J94,A0A2B4RHN2,G2QEV0,A0A397UU01,A0A2T7PFL8,K7ISV0,A0A024FT57,H3HCL6,A0A0G4IME3,E9FUN9,A0A1S3CYL5,D7FQK3,A0A1Y1YHC8,T1GSU4,F4S231,A0A1D8PMK0,A0A2G5B1D8,Q5BD61,A0A1C7M8P2,A0A4D8YSQ3,A0A158PJG6,J9JZ66,A0A0C2XG51,A0A158QZT6,A0A165QYQ9,T0SAU8,R7YY92,A0A3S1A0C3,A0A074YJ47,A0A2K1J482,A0A1Q3ENA6,O04379,A0A371I3C8,M8AEW7,A8P0D4,A0A2K3NY65,F4NYW7,A0A409Y6G2,A0A0L0HAB7,D8PZT7,A0A1D1W4K0,A7RQ46,W4YU94,A7BJS5,D8SNM6,A0A1J8PPA3,X1WG39,M5FQK2,Q69VD5,A0A2R6NSC2,A0A0D8XL16,A0A016WPN3,Q9QZ81,G5EES3,A0A0K0EFP6,Q8CJG0,A0A1D5NTU6,V2WTL2,A0A0V0YLH8,A0A139WDH0,A0A0R3W9Q7,H3DS31,A0A1Y1HWP2,G4T5G9,B7QCC4,A0A0B2UV00,M7BCJ9,E9GN30,Q7PZ41,A0A077Z361,R7U9I3,A0A1X7V1N5,A0A0K0JDP1,A0A0N4UKJ1,A0A498N3A3,A0A3M0IQP5,A0A0L8GBV4,Q32KD4,A0A1J1JBJ0,E0W4C3,A0A482XDA9,A0A3P7EJD6,J9K2Z4,A0A2J7Q8V4,T1IBM6,V3ZRX0,A0A210QKF7,A0A423TSS1,K1PT78,A0A267E8R7,A0A1D2N447,A0A226D7A9,F6YK55,T1KTE4,A0A2C9JGZ6,A0A1V9X9F0,K5X5Z7,A0A3Q0KUG5,T1FY40,1YVU,1Z26,5AWH,5I4A,6QZK,7R8K,C4L1M1,A0A0M2PXX3,A0A1I3LMA1,A0A1C0UUC4,A0A2U2J9E0,A0A142XB92,B1XJG0,A0A097QRL6,B6YTQ5,A0A0B0H9B4,R6KUL9,B7GJX9,A0A1N6SSK9,A0A060HNJ0,A0A235B542,R5XQK4,A0A1H3LE92,A0A496APJ8,A0A1I2ZGP1,A0A317EJY3,A0A1I2BD20,F8ERC7,A0A0Q2M2Z1,Q8DKB1,A0A1J1EK56,A0A1Z3HNN4,Q53W94,A0A2T1EKT1,E0UCX3,K9XZC6,B9LVW4,A0A0C1VHB4,Q31N05,R5NJJ8,Q2JI93,A0A432MEQ5,A0A329TD61,H1YCU5,A0A1Q5ZS75,A0A345E7N0,A0A1W2A082,A0A1H3X247,A0A0C1XUA0,A0A2R5G167,A0A346PK63,R7RTW6,A0A1H2RBI2,A0A1C3ZXN2,B9LVP8,M5RSF0,W0JW77,B7K585,A0A343TL88,L0AJX6,A0A2A5QS34,A0A343JEE2,A0A3P3RGE5,A0A329TBQ3,A0A285N2A8,A0A0W1S8B8,L9VRQ2,E4NRV1,A0A1I6HGN0,,",366,37
"981","C.H9.1","C.H9.3",339,177,162,3.27950408035154,"4F1N,4F3T,4KRE,5GUH,5VM9,6KR6,6OON,7KX7,7SWF,A0A163JTZ6,A0A196SDB4,J9D5G4,Q389P5,C4LVV2,A0A2P6N8X7,A2DPV7,A0A0G4H2S4,R1FDF0,D2VMG4,A0A074TLL7,A0A0D1ZAJ4,Q1K660,F4PH46,A0A3M7S814,A0A164ZA52,A0A383WDW5,Q54G64,I0YVB2,R7QGN7,C1DZY0,A0A2C5Z0M1,A0CB11,R9ACY5,D3BMP8,A0A1Z5TVE5,W7XD45,A0A1U7LLR0,A0A4S2MWZ7,K1VVQ6,A0A158P1R9,G7DVX0,V6R0U9,G4N9J3,E3KLI3,B7Q5I1,A0A1E3QC61,D5GGK8,S8ANP9,A0A139AUH8,L2GMR6,U4LBG4,A0A177URI1,O74957,A0A3N4IGK1,A6N7Y9,A0A0E9NDK5,T1KZ60,A0A250WXN5,A0A2G8JLH3,Q5KAT1,W2T741,A0A1W0E4B5,A0A2J7QB22,S4RYE2,A0A2K3CW87,A0A388KES6,A0A226EFL3,A0A3S3PD82,A0A0L0TEV1,A0A1S3J512,G0QTT2,A0A1J1HRI1,C4V9J2,Q9JMB7,A0A075AN09,Q5TW24,U5HIG6,A0A401PRI6,Q96J94,A0A2B4RHN2,G2QEV0,A0A397UU01,A0A2T7PFL8,K7ISV0,A0A024FT57,H3HCL6,A0A0G4IME3,E9FUN9,A0A1S3CYL5,D7FQK3,A0A1Y1YHC8,T1GSU4,F4S231,A0A1D8PMK0,A0A2G5B1D8,Q5BD61,A0A1C7M8P2,A0A4D8YSQ3,A0A158PJG6,J9JZ66,A0A0C2XG51,A0A158QZT6,A0A165QYQ9,T0SAU8,R7YY92,A0A3S1A0C3,A0A074YJ47,A0A2K1J482,A0A1Q3ENA6,O04379,A0A371I3C8,M8AEW7,A8P0D4,A0A2K3NY65,F4NYW7,A0A409Y6G2,A0A0L0HAB7,D8PZT7,A0A1D1W4K0,A7RQ46,W4YU94,A7BJS5,D8SNM6,A0A1J8PPA3,X1WG39,M5FQK2,Q69VD5,A0A2R6NSC2,A0A0D8XL16,A0A016WPN3,Q9QZ81,G5EES3,A0A0K0EFP6,Q8CJG0,A0A1D5NTU6,V2WTL2,A0A0V0YLH8,A0A139WDH0,A0A0R3W9Q7,H3DS31,A0A1Y1HWP2,G4T5G9,B7QCC4,A0A0B2UV00,M7BCJ9,E9GN30,Q7PZ41,A0A077Z361,R7U9I3,A0A1X7V1N5,A0A0K0JDP1,A0A0N4UKJ1,A0A498N3A3,A0A3M0IQP5,A0A0L8GBV4,Q32KD4,A0A1J1JBJ0,E0W4C3,A0A482XDA9,A0A3P7EJD6,J9K2Z4,A0A2J7Q8V4,T1IBM6,V3ZRX0,A0A210QKF7,A0A423TSS1,K1PT78,A0A267E8R7,A0A1D2N447,A0A226D7A9,F6YK55,T1KTE4,A0A2C9JGZ6,A0A1V9X9F0,K5X5Z7,A0A3Q0KUG5,T1FY40,1YVU,3DLB,5AWH,5I4A,6QZK,7R8K,A0A1I7IXT4,A0A2W1JZ37,A0A2S7WBN3,A0A328VKE4,A0A420DFE6,E0ST67,A0A4V1VDY2,A0A368P5I0,A0A4R1RMM2,A0A1Y2RDH8,A0A0M2PXX3,K9TPA9,A0A1L3JHM3,A0A1W6MIP2,A0A1C0UUC4,A0A2U2J9E0,A0A2Z6E1D5,A0A0F4NXW8,L8D0R3,B1XJG0,A0A326U7G5,A0A3D8L290,A0A1Q4R485,K9U8J6,K9RC91,A0A0D8ZUC0,A0A139XGN8,A0A1T4Y3A2,Q5P0R2,A0YYT3,A0A2T1EFY0,G6FTN0,A0A433NB65,A0A1Z4L0A1,K9UQR0,A0A2T1G8M7,K9VUN0,A0A0P6X5X2,K9ZDE3,B0JXD6,A0A2T1LS63,A0A1Z4K1Y3,A0A2Z6E0R7,A0A0P4UVI8,A0A0V7ZCG4,A0A1J0AGK2,K9PFF9,A0A2G9DT08,K9UEV4,Q9L1X1,A0A060HNJ0,A0A1H3LE92,A0A496APJ8,A0A062U2W9,H0HWQ5,A0A1V9G9U4,A0A1I2ZGP1,A0A317EJY3,A0A1I2BD20,F8ERC7,S7VLM7,A0A1A5X8H4,A0A1I2T6Q1,A0A1R3T9N6,H8KXJ0,A0A2D1U4H7,A0A0B7I4Z6,A0LL61,Q8DKB1,A0A139WY18,A0A1J1EK56,A0A2T1E1K4,A0A1Q8ZD62,A0A4Q6XKV6,A0A1Z3HNN4,A0A239JE83,A0A2N4XBY2,Q53W94,R5JEI2,A0A0Q0ZC47,A0A2T0XH18,A0A1V4CHV0,A0A1K1RQP7,A0A2T1EKT1,A0A1N6LUI7,A0A0P0NGR6,A0A1X7IML5,A0A0A2LKJ7,K1L112,A0A0U3AL92,A0A1H3A054,E0UCX3,K9XZC6,B9LVW4,A0A0C1VHB4,Q31N05,A0A0C5JKF3,R5NJJ8,A5D4D9,Q2JI93,A0A142Y7A9,A0A432MEQ5,A0A372DKU2,A0A3R7KLK4,C1F5Q7,A0A4R3EV39,A0A1P8WP90,A0A222F7P0,A0A1C9VH88,A0A2T2YMB1,A0A329TD61,A0A101R2A0,A0A1E3XF49,A0A1U9ND56,A0A4R7BQC4,A0A1H3DGN3,A0A1Q1FPH0,E0TGY3,A0A259TUP4,F6EYI8,A0A2S9Q9J0,A0A4Q2UIU6,A0A1H0LH25,A0A318LG42,H1YCU5,L0JS08,A0A1Q5ZS75,A0A345E7N0,M0AF24,A0A1W2A082,A0A1H3X247,A0A0C1XUA0,M0D2X3,A0A2R5G167,A0A346PK63,R7RTW6,A0A1H2RBI2,A0A1C3ZXN2,B9LVP8,M5RSF0,W0JW77,B7K585,F8D8G0,A0A343TL88,L0AJX6,A0A2A5QS34,A0A343JEE2,A0A3P3RGE5,A0A329TBQ3,A0A285N2A8,A0A0W1S8B8,A0A1V4C8L7,L9VRQ2,E4NRV1,A0A1I6HGN0,A0A1I0NI68,,",366,37
"988","C.S11.2","C.S12.1",359,177,182,1.79434407400509,"4F1N,4F3T,4KRE,5GUH,5VM9,6KR6,6OON,7KX7,7SWF,A0A163JTZ6,A0A0N4X8S8,A0A196SDB4,J9D5G4,C4LVV2,A0A2P6N8X7,A8BCK6,A2DPV7,A0A0G4H2S4,T1H8B3,R1FDF0,S4RWI0,D2VMG4,A0A074TLL7,A0A0D1ZAJ4,Q1K660,F4PH46,A0A3M7S814,A0A164ZA52,A0A383WDW5,Q54G64,S7WCF7,R7QGN7,C1DZY0,A0A2C5Z0M1,A0CB11,R9ACY5,D3BMP8,W7XD45,A0A1U7LLR0,A0A4S2MWZ7,K1VVQ6,A0A158P1R9,G7DVX0,V6R0U9,G4N9J3,E3KLI3,B7Q5I1,A0A1E3QC61,D5GGK8,S8ANP9,A0A139AUH8,L2GMR6,U4LBG4,A0A177URI1,O74957,A0A3N4IGK1,A6N7Y9,A0A0E9NDK5,T1KZ60,A0A250WXN5,A0A2G8JLH3,Q5KAT1,L2GUF2,W2T741,A0A1W0E4B5,A0A2J7QB22,A0A2K3CW87,A0A226EFL3,A0A3S3PD82,A0A0L0TEV1,A0A1S3J512,G0QTT2,A0A1J1HRI1,C4V9J2,Q9JMB7,A0A075AN09,Q5TW24,U5HIG6,A0A401PRI6,Q96J94,A0A2B4RHN2,G2QEV0,A0A397UU01,A0A2T7PFL8,K7ISV0,A0A024FT57,H3HCL6,A0A0G4IME3,A0A1S3CYL5,D7FQK3,A0A1Y1YHC8,T1GSU4,F4S231,A0A1D8PMK0,A0A2G5B1D8,Q5BD61,A0A1C7M8P2,A0A4D8YSQ3,A0A158PJG6,J9JZ66,A0A0C2XG51,A0A158QZT6,A0A165QYQ9,T0SAU8,R7YY92,A0A3S1A0C3,A0A074YJ47,A0A2K1J482,A0A1Q3ENA6,O04379,A0A371I3C8,M8AEW7,A8P0D4,A0A2K3NY65,F4NYW7,A0A409Y6G2,A0A0L0HAB7,D8PZT7,A0A1D1W4K0,A7RQ46,W4YU94,A7BJS5,D8SNM6,A0A1J8PPA3,X1WG39,M5FQK2,Q69VD5,A0A2R6NSC2,A0A0D8XL16,A0A016WPN3,Q9QZ81,G5EES3,A0A0K0EFP6,Q8CJG0,A0A1D5NTU6,V2WTL2,A0A0V0YLH8,A0A139WDH0,A0A0R3W9Q7,H3DS31,A0A1Y1HWP2,G4T5G9,B7QCC4,A0A0B2UV00,M7BCJ9,E9GN30,Q7PZ41,A0A077Z361,R7U9I3,A0A1X7V1N5,A0A0K0JDP1,A0A0N4UKJ1,A0A498N3A3,A0A3M0IQP5,A0A0L8GBV4,Q32KD4,A0A1J1JBJ0,E0W4C3,A0A482XDA9,A0A3P7EJD6,J9K2Z4,A0A2J7Q8V4,T1IBM6,V3ZRX0,A0A210QKF7,A0A423TSS1,K1PT78,A0A267E8R7,A0A1D2N447,A0A226D7A9,F6YK55,T1KTE4,A0A2C9JGZ6,A0A1V9X9F0,K5X5Z7,A0A3Q0KUG5,T1FY40,1YVU,1Z26,3DLB,5AWH,5G5T,5I4A,6QZK,7R8K,E8N0K8,A0A1I7IXT4,A0A2W1JZ37,A0A2S7WBN3,A0A328VKE4,A0A420DFE6,E0ST67,A0A4V1VDY2,A0A368P5I0,C4L1M1,A0A4R1RMM2,A0A1Y2RDH8,A0A1M5ZSR3,A0A0K8QX04,A0A0M2PXX3,A0A1I3LMA1,K9TPA9,A0A1L3JHM3,A0A1W6MIP2,A0A1C0UUC4,A0A2U2J9E0,A0A2Z6E1D5,A0A0F4NXW8,A0A142XB92,L8D0R3,B1XJG0,A0A326U7G5,A0A3D8L290,H1KXR6,A0A1Q4R485,K9U8J6,A0A097QRL6,K9RC91,A0A0D8ZUC0,A0A139XGN8,A0A1T4Y3A2,Q5P0R2,B6YTQ5,A0A0B0H9B4,A0YYT3,A0A2T1EFY0,G6FTN0,R6KUL9,A0A433NB65,A0A1Z4L0A1,K9UQR0,A0A2T1G8M7,K9VUN0,B7GJX9,A0A0P6X5X2,K9ZDE3,B0JXD6,A0A2T1LS63,A0A1Z4K1Y3,A0A2Z6E0R7,A0A1N6SSK9,A0A0P4UVI8,A0A0V7ZCG4,A0A1J0AGK2,K9PFF9,A0A2G9DT08,K9UEV4,Q9L1X1,A0A060HNJ0,A0A235B542,R5XQK4,A0A1H3LE92,A0A496APJ8,A0A062U2W9,H0HWQ5,A0A1V9G9U4,A0A1I2ZGP1,A0A317EJY3,A0A1I2BD20,F8ERC7,S7VLM7,A0A1A5X8H4,A0A1I2T6Q1,A0A1R3T9N6,A0A0Q2M2Z1,H8KXJ0,D3S0S6,A0A2D1U4H7,I3TE64,A0A0B7I4Z6,A0LL61,Q8DKB1,A0A139WY18,A0A1J1EK56,A0A2T1E1K4,A0A1Q8ZD62,A0A4Q6XKV6,A0A1Z3HNN4,A0A239JE83,A0A2N4XBY2,Q53W94,R5JEI2,A0A0Q0ZC47,A0A2T0XH18,A0A1V4CHV0,A0A1K1RQP7,A0A2T1EKT1,A0A1N6LUI7,A0A0P0NGR6,A0A1X7IML5,A0A0A2LKJ7,K1L112,A0A0U3AL92,A0A1H3A054,E0UCX3,K9XZC6,B9LVW4,A0A0C1VHB4,Q31N05,A0A0C5JKF3,R5NJJ8,A5D4D9,Q2JI93,A0A142Y7A9,A0A432MEQ5,A0A372DKU2,A0A3R7KLK4,C1F5Q7,A0A4R3EV39,A0A1P8WP90,A0A222F7P0,A0A1C9VH88,A0A2T2YMB1,A0A329TD61,A0A101R2A0,A0A1E3XF49,A0A1U9ND56,A0A4R7BQC4,A0A1H3DGN3,A0A1Q1FPH0,E0TGY3,A0A259TUP4,F6EYI8,A0A2S9Q9J0,A0A4Q2UIU6,A0A1H0LH25,A0A318LG42,H1YCU5,L0JS08,A0A1Q5ZS75,A0A345E7N0,M0AF24,A0A1W2A082,A0A1H3X247,A0A0C1XUA0,M0D2X3,A0A2R5G167,A0A346PK63,R7RTW6,A0A1H2RBI2,A0A1C3ZXN2,B9LVP8,M5RSF0,W0JW77,B7K585,F8D8G0,A0A343TL88,L0AJX6,A0A2A5QS34,A0A343JEE2,A0A3P3RGE5,A0A329TBQ3,A0A285N2A8,A0A0W1S8B8,A0A1V4C8L7,L9VRQ2,E4NRV1,A0A1I6HGN0,A0A1I0NI68,,",366,37
"989","C.S11.3","C.S12.3",355,177,178,2.47890877928014,"4F1N,4F3T,4KRE,5GUH,5VM9,6KR6,6OON,7KX7,A0A163JTZ6,A0A0N4X8S8,A0A196SDB4,J9D5G4,C4LVV2,A0A2P6N8X7,A8BCK6,A2DPV7,A0A0G4H2S4,T1H8B3,R1FDF0,S4RWI0,D2VMG4,A0A074TLL7,A0A0D1ZAJ4,Q1K660,F4PH46,A0A3M7S814,A0A164ZA52,A0A383WDW5,Q54G64,S7WCF7,I0YVB2,R7QGN7,C1DZY0,A0A2C5Z0M1,A0CB11,R9ACY5,D3BMP8,A0A1Z5TVE5,W7XD45,A0A1U7LLR0,A0A4S2MWZ7,K1VVQ6,A0A158P1R9,G7DVX0,V6R0U9,G4N9J3,E3KLI3,B7Q5I1,A0A1E3QC61,S8ANP9,A0A139AUH8,L2GMR6,U4LBG4,A0A177URI1,O74957,A0A3N4IGK1,A6N7Y9,A0A0E9NDK5,A0A250WXN5,A0A2G8JLH3,Q5KAT1,L2GUF2,W2T741,A0A1W0E4B5,A0A2J7QB22,A0A2K3CW87,A0A226EFL3,A0A3S3PD82,A0A0L0TEV1,A0A1S3J512,G0QTT2,A0A1J1HRI1,C4V9J2,Q9JMB7,A0A075AN09,Q5TW24,U5HIG6,A0A401PRI6,Q96J94,A0A2B4RHN2,G2QEV0,A0A397UU01,A0A2T7PFL8,K7ISV0,A0A024FT57,H3HCL6,A0A0G4IME3,E9FUN9,A0A1S3CYL5,D7FQK3,A0A1Y1YHC8,T1GSU4,F4S231,A0A1D8PMK0,A0A2G5B1D8,Q5BD61,A0A1C7M8P2,A0A4D8YSQ3,A0A158PJG6,J9JZ66,A0A0C2XG51,A0A158QZT6,A0A165QYQ9,T0SAU8,R7YY92,A0A3S1A0C3,A0A074YJ47,A0A2K1J482,A0A1Q3ENA6,O04379,A0A371I3C8,M8AEW7,A8P0D4,A0A2K3NY65,F4NYW7,A0A409Y6G2,A0A0L0HAB7,D8PZT7,A0A1D1W4K0,A7RQ46,W4YU94,A7BJS5,D8SNM6,A0A1J8PPA3,X1WG39,M5FQK2,Q69VD5,A0A2R6NSC2,A0A0D8XL16,A0A016WPN3,Q9QZ81,G5EES3,A0A0K0EFP6,Q8CJG0,A0A1D5NTU6,V2WTL2,A0A0V0YLH8,A0A139WDH0,A0A0R3W9Q7,H3DS31,A0A1Y1HWP2,G4T5G9,B7QCC4,A0A0B2UV00,M7BCJ9,E9GN30,Q7PZ41,A0A077Z361,R7U9I3,A0A1X7V1N5,A0A0K0JDP1,A0A0N4UKJ1,A0A498N3A3,A0A3M0IQP5,A0A0L8GBV4,Q32KD4,A0A1J1JBJ0,E0W4C3,A0A482XDA9,A0A3P7EJD6,J9K2Z4,A0A2J7Q8V4,T1IBM6,V3ZRX0,A0A210QKF7,A0A423TSS1,K1PT78,A0A267E8R7,A0A1D2N447,A0A226D7A9,F6YK55,T1KTE4,A0A2C9JGZ6,A0A1V9X9F0,K5X5Z7,A0A3Q0KUG5,T1FY40,1YVU,1Z26,3DLB,5AWH,5G5T,5I4A,6QZK,7R8K,E8N0K8,A0A1I7IXT4,A0A2W1JZ37,A0A2S7WBN3,A0A328VKE4,A0A420DFE6,E0ST67,A0A4V1VDY2,A0A368P5I0,C4L1M1,A0A4R1RMM2,A0A1Y2RDH8,A0A1M5ZSR3,A0A0K8QX04,A0A0M2PXX3,A0A1I3LMA1,K9TPA9,A0A1L3JHM3,A0A1W6MIP2,A0A1C0UUC4,A0A2U2J9E0,A0A2Z6E1D5,A0A0F4NXW8,A0A142XB92,L8D0R3,B1XJG0,A0A326U7G5,A0A3D8L290,H1KXR6,A0A1Q4R485,K9U8J6,A0A097QRL6,K9RC91,A0A0D8ZUC0,A0A139XGN8,A0A1T4Y3A2,Q5P0R2,B6YTQ5,A0A0B0H9B4,A0YYT3,A0A2T1EFY0,G6FTN0,R6KUL9,A0A433NB65,A0A1Z4L0A1,K9UQR0,A0A2T1G8M7,K9VUN0,B7GJX9,A0A0P6X5X2,K9ZDE3,B0JXD6,A0A2T1LS63,A0A1Z4K1Y3,A0A2Z6E0R7,A0A1N6SSK9,A0A0P4UVI8,A0A0V7ZCG4,A0A1J0AGK2,K9PFF9,A0A2G9DT08,K9UEV4,Q9L1X1,A0A235B542,R5XQK4,A0A1H3LE92,A0A496APJ8,A0A062U2W9,H0HWQ5,A0A1V9G9U4,A0A1I2ZGP1,A0A317EJY3,A0A1I2BD20,F8ERC7,S7VLM7,A0A1A5X8H4,A0A1I2T6Q1,A0A1R3T9N6,A0A0Q2M2Z1,H8KXJ0,D3S0S6,A0A2D1U4H7,I3TE64,A0A0B7I4Z6,A0LL61,Q8DKB1,A0A139WY18,A0A1J1EK56,A0A2T1E1K4,A0A1Q8ZD62,A0A4Q6XKV6,A0A1Z3HNN4,A0A239JE83,A0A2N4XBY2,Q53W94,R5JEI2,A0A0Q0ZC47,A0A2T0XH18,A0A1V4CHV0,A0A1K1RQP7,A0A2T1EKT1,A0A1N6LUI7,A0A0P0NGR6,A0A1X7IML5,A0A0A2LKJ7,K1L112,A0A1H3A054,E0UCX3,K9XZC6,B9LVW4,A0A0C1VHB4,Q31N05,A0A0C5JKF3,R5NJJ8,A5D4D9,Q2JI93,A0A142Y7A9,A0A432MEQ5,A0A372DKU2,A0A3R7KLK4,C1F5Q7,A0A4R3EV39,A0A1P8WP90,A0A222F7P0,A0A1C9VH88,A0A2T2YMB1,A0A329TD61,A0A101R2A0,A0A1E3XF49,A0A1U9ND56,A0A4R7BQC4,A0A1H3DGN3,A0A1Q1FPH0,E0TGY3,A0A259TUP4,F6EYI8,A0A2S9Q9J0,A0A4Q2UIU6,A0A1H0LH25,A0A318LG42,H1YCU5,L0JS08,A0A1Q5ZS75,A0A345E7N0,M0AF24,A0A1W2A082,A0A1H3X247,A0A0C1XUA0,M0D2X3,A0A2R5G167,R7RTW6,A0A1H2RBI2,A0A1C3ZXN2,B9LVP8,M5RSF0,W0JW77,B7K585,F8D8G0,A0A343TL88,L0AJX6,A0A2A5QS34,A0A343JEE2,A0A3P3RGE5,A0A329TBQ3,A0A285N2A8,A0A1V4C8L7,L9VRQ2,E4NRV1,A0A1I6HGN0,A0A1I0NI68,,",366,37
"992","C.S3.4","C.S5.5",344,177,167,1.5557698162996,"4F1N,4F3T,4KRE,5GUH,5VM9,6KR6,6OON,7KX7,7SWF,A0A163JTZ6,A0A196SDB4,J9D5G4,C4LVV2,A8BCK6,A0A0G4H2S4,T1H8B3,S4RWI0,D2VMG4,A0A074TLL7,A0A0D1ZAJ4,Q1K660,F4PH46,A0A3M7S814,A0A164ZA52,A0A383WDW5,Q54G64,S7WCF7,I0YVB2,R7QGN7,C1DZY0,A0A2C5Z0M1,A0CB11,R9ACY5,D3BMP8,A0A1Z5TVE5,W7XD45,A0A1U7LLR0,A0A4S2MWZ7,K1VVQ6,A0A158P1R9,G7DVX0,V6R0U9,G4N9J3,E3KLI3,B7Q5I1,A0A1E3QC61,D5GGK8,S8ANP9,A0A139AUH8,L2GMR6,U4LBG4,A0A177URI1,O74957,A0A3N4IGK1,A6N7Y9,A0A0E9NDK5,T1KZ60,A0A250WXN5,A0A2G8JLH3,Q5KAT1,L2GUF2,W2T741,A0A1W0E4B5,A0A2J7QB22,S4RYE2,A0A2K3CW87,A0A388KES6,A0A226EFL3,A0A3S3PD82,A0A0L0TEV1,A0A1S3J512,G0QTT2,A0A1J1HRI1,C4V9J2,Q9JMB7,A0A075AN09,Q5TW24,U5HIG6,A0A401PRI6,Q96J94,A0A2B4RHN2,G2QEV0,A0A397UU01,A0A2T7PFL8,K7ISV0,A0A024FT57,H3HCL6,A0A0G4IME3,E9FUN9,A0A1S3CYL5,D7FQK3,A0A1Y1YHC8,F4S231,A0A1D8PMK0,A0A2G5B1D8,Q5BD61,A0A1C7M8P2,A0A4D8YSQ3,A0A158PJG6,J9JZ66,A0A0C2XG51,A0A158QZT6,A0A165QYQ9,T0SAU8,R7YY92,A0A3S1A0C3,A0A074YJ47,A0A2K1J482,A0A1Q3ENA6,O04379,A0A371I3C8,M8AEW7,A8P0D4,A0A2K3NY65,F4NYW7,A0A409Y6G2,A0A0L0HAB7,D8PZT7,A0A1D1W4K0,A7RQ46,W4YU94,A7BJS5,D8SNM6,A0A1J8PPA3,X1WG39,M5FQK2,Q69VD5,A0A2R6NSC2,A0A0D8XL16,A0A016WPN3,Q9QZ81,G5EES3,A0A0K0EFP6,Q8CJG0,A0A1D5NTU6,V2WTL2,A0A0V0YLH8,A0A139WDH0,A0A0R3W9Q7,H3DS31,A0A1Y1HWP2,G4T5G9,B7QCC4,A0A0B2UV00,M7BCJ9,E9GN30,Q7PZ41,A0A077Z361,R7U9I3,A0A1X7V1N5,A0A0K0JDP1,A0A0N4UKJ1,A0A498N3A3,A0A3M0IQP5,A0A0L8GBV4,Q32KD4,A0A1J1JBJ0,E0W4C3,A0A482XDA9,A0A3P7EJD6,J9K2Z4,A0A2J7Q8V4,T1IBM6,V3ZRX0,A0A210QKF7,A0A423TSS1,K1PT78,A0A267E8R7,A0A1D2N447,A0A226D7A9,F6YK55,T1KTE4,A0A2C9JGZ6,A0A1V9X9F0,K5X5Z7,A0A3Q0KUG5,T1FY40,1YVU,1Z26,3DLB,5AWH,5G5T,5I4A,6QZK,7R8K,E8N0K8,A0A1I7IXT4,A0A2W1JZ37,A0A2S7WBN3,A0A328VKE4,A0A420DFE6,E0ST67,A0A4V1VDY2,A0A368P5I0,C4L1M1,A0A4R1RMM2,A0A1Y2RDH8,A0A1M5ZSR3,A0A0K8QX04,A0A0M2PXX3,A0A1I3LMA1,K9TPA9,A0A1L3JHM3,A0A1W6MIP2,A0A1C0UUC4,A0A2U2J9E0,B1XJG0,A0A326U7G5,A0A1Q4R485,K9U8J6,K9RC91,A0A0D8ZUC0,A0A139XGN8,A0A1T4Y3A2,A0A0B0H9B4,A0YYT3,A0A2T1EFY0,G6FTN0,R6KUL9,A0A433NB65,A0A1Z4L0A1,K9UQR0,A0A2T1G8M7,K9VUN0,B7GJX9,A0A0P6X5X2,K9ZDE3,B0JXD6,A0A2T1LS63,A0A1Z4K1Y3,A0A1N6SSK9,A0A0P4UVI8,A0A0V7ZCG4,A0A1J0AGK2,K9PFF9,A0A2G9DT08,K9UEV4,Q9L1X1,A0A060HNJ0,A0A235B542,R5XQK4,A0A1H3LE92,A0A496APJ8,A0A062U2W9,H0HWQ5,A0A1V9G9U4,A0A1I2ZGP1,A0A317EJY3,A0A1I2BD20,F8ERC7,S7VLM7,A0A1A5X8H4,A0A1I2T6Q1,A0A1R3T9N6,A0A0Q2M2Z1,H8KXJ0,A0A2D1U4H7,A0A0B7I4Z6,A0LL61,Q8DKB1,A0A139WY18,A0A1J1EK56,A0A2T1E1K4,A0A1Q8ZD62,A0A4Q6XKV6,A0A1Z3HNN4,A0A239JE83,A0A2N4XBY2,Q53W94,R5JEI2,A0A0Q0ZC47,A0A2T0XH18,A0A1V4CHV0,A0A1K1RQP7,A0A2T1EKT1,A0A1N6LUI7,A0A0P0NGR6,A0A1X7IML5,A0A0A2LKJ7,K1L112,A0A0U3AL92,A0A1H3A054,E0UCX3,K9XZC6,A0A0C1VHB4,Q31N05,A0A0C5JKF3,R5NJJ8,A5D4D9,Q2JI93,A0A142Y7A9,A0A432MEQ5,A0A372DKU2,A0A3R7KLK4,C1F5Q7,A0A4R3EV39,A0A1P8WP90,A0A222F7P0,A0A1C9VH88,A0A2T2YMB1,A0A101R2A0,A0A1E3XF49,A0A1U9ND56,A0A4R7BQC4,A0A1H3DGN3,A0A1Q1FPH0,E0TGY3,A0A259TUP4,F6EYI8,A0A2S9Q9J0,A0A4Q2UIU6,A0A1H0LH25,A0A318LG42,H1YCU5,L0JS08,A0A1Q5ZS75,M0AF24,A0A1W2A082,A0A1H3X247,A0A0C1XUA0,M0D2X3,A0A2R5G167,A0A346PK63,R7RTW6,A0A1H2RBI2,A0A1C3ZXN2,B9LVP8,M5RSF0,W0JW77,B7K585,F8D8G0,A0A343TL88,L0AJX6,A0A2A5QS34,A0A343JEE2,A0A3P3RGE5,A0A329TBQ3,A0A285N2A8,A0A0W1S8B8,A0A1V4C8L7,L9VRQ2,E4NRV1,A0A1I6HGN0,A0A1I0NI68,,",366,37
"993","C.S5.6","C.S6.5",352,177,175,1.58871670702179,"4F1N,4F3T,4KRE,5GUH,5VM9,6KR6,6OON,7KX7,7SWF,A0A163JTZ6,A0A0N4X8S8,A0A196SDB4,J9D5G4,C4LVV2,A0A2P6N8X7,A8BCK6,A2DPV7,A0A0G4H2S4,T1H8B3,S4RWI0,D2VMG4,A0A074TLL7,A0A0D1ZAJ4,Q1K660,F4PH46,A0A3M7S814,A0A164ZA52,A0A383WDW5,Q54G64,S7WCF7,I0YVB2,R7QGN7,C1DZY0,A0A2C5Z0M1,A0CB11,R9ACY5,D3BMP8,A0A1Z5TVE5,A0A1U7LLR0,A0A4S2MWZ7,K1VVQ6,A0A158P1R9,G7DVX0,V6R0U9,G4N9J3,E3KLI3,B7Q5I1,A0A1E3QC61,D5GGK8,S8ANP9,A0A139AUH8,L2GMR6,U4LBG4,A0A177URI1,O74957,A0A3N4IGK1,A6N7Y9,A0A0E9NDK5,T1KZ60,A0A250WXN5,A0A2G8JLH3,Q5KAT1,L2GUF2,W2T741,A0A1W0E4B5,A0A2J7QB22,S4RYE2,A0A2K3CW87,A0A388KES6,A0A226EFL3,A0A3S3PD82,A0A0L0TEV1,A0A1S3J512,A0A1J1HRI1,C4V9J2,Q9JMB7,A0A075AN09,Q5TW24,U5HIG6,A0A401PRI6,Q96J94,A0A2B4RHN2,G2QEV0,A0A397UU01,A0A2T7PFL8,K7ISV0,A0A024FT57,H3HCL6,A0A0G4IME3,A0A1S3CYL5,D7FQK3,A0A1Y1YHC8,F4S231,A0A1D8PMK0,A0A2G5B1D8,Q5BD61,A0A1C7M8P2,A0A4D8YSQ3,A0A158PJG6,J9JZ66,A0A0C2XG51,A0A158QZT6,A0A165QYQ9,T0SAU8,R7YY92,A0A3S1A0C3,A0A074YJ47,A0A2K1J482,A0A1Q3ENA6,O04379,A0A371I3C8,M8AEW7,A8P0D4,A0A2K3NY65,F4NYW7,A0A409Y6G2,A0A0L0HAB7,D8PZT7,A0A1D1W4K0,A7RQ46,W4YU94,A7BJS5,D8SNM6,A0A1J8PPA3,X1WG39,M5FQK2,Q69VD5,A0A2R6NSC2,A0A0D8XL16,A0A016WPN3,Q9QZ81,G5EES3,A0A0K0EFP6,Q8CJG0,A0A1D5NTU6,V2WTL2,A0A0V0YLH8,A0A139WDH0,A0A0R3W9Q7,H3DS31,A0A1Y1HWP2,G4T5G9,B7QCC4,A0A0B2UV00,M7BCJ9,E9GN30,Q7PZ41,A0A077Z361,R7U9I3,A0A1X7V1N5,A0A0K0JDP1,A0A0N4UKJ1,A0A498N3A3,A0A3M0IQP5,A0A0L8GBV4,Q32KD4,A0A1J1JBJ0,E0W4C3,A0A482XDA9,A0A3P7EJD6,J9K2Z4,A0A2J7Q8V4,T1IBM6,V3ZRX0,A0A210QKF7,A0A423TSS1,K1PT78,A0A267E8R7,A0A1D2N447,A0A226D7A9,F6YK55,T1KTE4,A0A2C9JGZ6,A0A1V9X9F0,K5X5Z7,A0A3Q0KUG5,T1FY40,1YVU,1Z26,3DLB,5AWH,5G5T,5I4A,6QZK,7R8K,E8N0K8,A0A1I7IXT4,A0A2W1JZ37,A0A2S7WBN3,A0A328VKE4,A0A420DFE6,E0ST67,A0A4V1VDY2,A0A368P5I0,C4L1M1,A0A4R1RMM2,A0A1Y2RDH8,Q11QW7,A0A1M5ZSR3,A0A0K8QX04,A0A0M2PXX3,A0A1I3LMA1,K9TPA9,A0A1L3JHM3,A0A1W6MIP2,A0A1C0UUC4,A0A2U2J9E0,A0A2Z6E1D5,A0A0F4NXW8,A0A142XB92,L8D0R3,B1XJG0,A0A326U7G5,A0A3D8L290,H1KXR6,A0A1Q4R485,K9U8J6,K9RC91,A0A0D8ZUC0,A0A139XGN8,A0A1T4Y3A2,Q5P0R2,A0A0B0H9B4,A0YYT3,A0A2T1EFY0,G6FTN0,R6KUL9,A0A433NB65,A0A1Z4L0A1,K9UQR0,A0A2T1G8M7,K9VUN0,B7GJX9,A0A0P6X5X2,K9ZDE3,B0JXD6,A0A2T1LS63,A0A1Z4K1Y3,A0A2Z6E0R7,A0A1N6SSK9,A0A0P4UVI8,A0A0V7ZCG4,A0A1J0AGK2,K9PFF9,A0A2G9DT08,K9UEV4,Q9L1X1,A0A060HNJ0,A0A235B542,R5XQK4,A0A1H3LE92,A0A496APJ8,A0A062U2W9,H0HWQ5,A0A1V9G9U4,A0A1I2ZGP1,A0A317EJY3,A0A1I2BD20,F8ERC7,S7VLM7,A0A1A5X8H4,A0A1I2T6Q1,A0A1R3T9N6,A0A0Q2M2Z1,H8KXJ0,A0A2D1U4H7,A0A0B7I4Z6,A0LL61,Q8DKB1,A0A139WY18,A0A1J1EK56,A0A2T1E1K4,A0A1Q8ZD62,A0A4Q6XKV6,A0A1Z3HNN4,A0A239JE83,A0A2N4XBY2,Q53W94,R5JEI2,A0A0Q0ZC47,A0A2T0XH18,A0A1V4CHV0,A0A1K1RQP7,A0A2T1EKT1,A0A1N6LUI7,A0A0P0NGR6,A0A1X7IML5,A0A0A2LKJ7,K1L112,A0A0U3AL92,A0A1H3A054,E0UCX3,K9XZC6,A0A0C1VHB4,Q31N05,A0A0C5JKF3,R5NJJ8,A5D4D9,Q2JI93,A0A142Y7A9,A0A432MEQ5,A0A372DKU2,A0A3R7KLK4,C1F5Q7,A0A4R3EV39,A0A1P8WP90,A0A222F7P0,A0A1C9VH88,A0A2T2YMB1,A0A101R2A0,A0A1E3XF49,A0A1U9ND56,A0A4R7BQC4,A0A1H3DGN3,A0A1Q1FPH0,E0TGY3,A0A259TUP4,F6EYI8,A0A2S9Q9J0,A0A4Q2UIU6,A0A1H0LH25,A0A318LG42,H1YCU5,L0JS08,A0A1Q5ZS75,M0AF24,A0A1W2A082,A0A1H3X247,A0A0C1XUA0,M0D2X3,A0A2R5G167,A0A346PK63,R7RTW6,A0A1H2RBI2,A0A1C3ZXN2,B9LVP8,M5RSF0,W0JW77,B7K585,F8D8G0,A0A343TL88,L0AJX6,A0A2A5QS34,A0A343JEE2,A0A3P3RGE5,A0A329TBQ3,A0A0W1S8B8,A0A1V4C8L7,L9VRQ2,E4NRV1,A0A1I6HGN0,A0A1I0NI68,,",366,37
"996","N.H6.2","N.H6.4",260,177,83,2.02767000204207,"4F1N,4F3T,4KRE,5GUH,5VM9,6KR6,6OON,7KX7,A0A163JTZ6,A0A0N4X8S8,A0A196SDB4,J9D5G4,Q389P5,C4LVV2,A0A2P6N8X7,A2DPV7,A0A0G4H2S4,T1H8B3,R1FDF0,S4RWI0,D2VMG4,A0A074TLL7,A0A0D1ZAJ4,Q1K660,F4PH46,A0A3M7S814,A0A164ZA52,A0A383WDW5,Q54G64,S7WCF7,I0YVB2,R7QGN7,A0A2C5Z0M1,A0CB11,R9ACY5,D3BMP8,A0A1Z5TVE5,W7XD45,A0A1U7LLR0,A0A4S2MWZ7,K1VVQ6,A0A158P1R9,G7DVX0,V6R0U9,G4N9J3,E3KLI3,A0A1E3QC61,D5GGK8,S8ANP9,A0A139AUH8,L2GMR6,U4LBG4,A0A177URI1,O74957,A0A3N4IGK1,A6N7Y9,A0A0E9NDK5,T1KZ60,A0A250WXN5,A0A2G8JLH3,Q5KAT1,L2GUF2,W2T741,A0A1W0E4B5,A0A2J7QB22,S4RYE2,A0A2K3CW87,A0A388KES6,A0A226EFL3,A0A3S3PD82,A0A0L0TEV1,A0A1S3J512,G0QTT2,A0A1J1HRI1,C4V9J2,Q9JMB7,A0A075AN09,Q5TW24,U5HIG6,A0A401PRI6,Q96J94,A0A2B4RHN2,G2QEV0,A0A397UU01,A0A2T7PFL8,K7ISV0,A0A024FT57,H3HCL6,A0A0G4IME3,E9FUN9,A0A1S3CYL5,D7FQK3,A0A1Y1YHC8,T1GSU4,F4S231,A0A1D8PMK0,A0A2G5B1D8,Q5BD61,A0A1C7M8P2,A0A4D8YSQ3,A0A158PJG6,J9JZ66,A0A0C2XG51,A0A158QZT6,T0SAU8,R7YY92,A0A3S1A0C3,A0A074YJ47,A0A2K1J482,A0A1Q3ENA6,O04379,A0A371I3C8,M8AEW7,A8P0D4,A0A2K3NY65,F4NYW7,A0A409Y6G2,A0A0L0HAB7,D8PZT7,A0A1D1W4K0,A7RQ46,A7BJS5,D8SNM6,A0A1J8PPA3,X1WG39,M5FQK2,Q69VD5,A0A2R6NSC2,A0A0D8XL16,A0A016WPN3,Q9QZ81,G5EES3,A0A0K0EFP6,Q8CJG0,A0A1D5NTU6,V2WTL2,A0A0V0YLH8,A0A139WDH0,A0A0R3W9Q7,H3DS31,A0A1Y1HWP2,G4T5G9,B7QCC4,A0A0B2UV00,M7BCJ9,E9GN30,Q7PZ41,A0A077Z361,R7U9I3,A0A1X7V1N5,A0A0K0JDP1,A0A0N4UKJ1,A0A498N3A3,A0A3M0IQP5,A0A0L8GBV4,Q32KD4,A0A1J1JBJ0,E0W4C3,A0A482XDA9,A0A3P7EJD6,J9K2Z4,A0A2J7Q8V4,T1IBM6,V3ZRX0,A0A210QKF7,A0A423TSS1,K1PT78,A0A267E8R7,A0A1D2N447,A0A226D7A9,F6YK55,T1KTE4,A0A2C9JGZ6,A0A1V9X9F0,K5X5Z7,A0A3Q0KUG5,T1FY40,1YVU,1Z26,3DLB,5G5T,6QZK,7R8K,A0A1I7IXT4,A0A2W1JZ37,A0A2S7WBN3,A0A420DFE6,E0ST67,A0A4V1VDY2,A0A368P5I0,C4L1M1,A0A4R1RMM2,A0A1Y2RDH8,A0A0M2PXX3,A0A1I3LMA1,A0A1L3JHM3,A0A1C0UUC4,A0A2U2J9E0,A0A142XB92,B1XJG0,A0A0B0H9B4,R6KUL9,B7GJX9,A0A1N6SSK9,A0A060HNJ0,A0A235B542,R5XQK4,A0A1H3LE92,A0A062U2W9,H0HWQ5,A0A1I2ZGP1,A0A317EJY3,A0A1I2BD20,F8ERC7,A0A0Q2M2Z1,D3S0S6,Q8DKB1,A0A1J1EK56,Q53W94,A0A2T1EKT1,E0UCX3,K9XZC6,B9LVW4,A0A0C1VHB4,Q31N05,R5NJJ8,Q2JI93,A0A3R7KLK4,A0A1E3XF49,A0A1H3DGN3,A0A1Q1FPH0,H1YCU5,L0JS08,A0A1Q5ZS75,A0A345E7N0,M0AF24,A0A1W2A082,A0A1H3X247,A0A0C1XUA0,M0D2X3,A0A346PK63,R7RTW6,A0A1H2RBI2,A0A1C3ZXN2,B9LVP8,W0JW77,F8D8G0,A0A343TL88,L0AJX6,A0A2A5QS34,A0A343JEE2,A0A3P3RGE5,A0A329TBQ3,A0A285N2A8,A0A0W1S8B8,A0A1V4C8L7,L9VRQ2,E4NRV1,A0A1I6HGN0,A0A1I0NI68,,",366,37
"998","N.H6.4","N.S16.5",247,177,70,2.30419693301049,"4F1N,4F3T,4KRE,5GUH,5VM9,6KR6,6OON,7KX7,A0A163JTZ6,A0A0N4X8S8,A0A196SDB4,J9D5G4,Q389P5,C4LVV2,A0A2P6N8X7,A2DPV7,A0A0G4H2S4,T1H8B3,R1FDF0,S4RWI0,D2VMG4,A0A074TLL7,A0A0D1ZAJ4,Q1K660,F4PH46,A0A3M7S814,A0A164ZA52,A0A383WDW5,Q54G64,S7WCF7,I0YVB2,R7QGN7,A0A2C5Z0M1,A0CB11,R9ACY5,D3BMP8,A0A1Z5TVE5,W7XD45,A0A1U7LLR0,A0A4S2MWZ7,K1VVQ6,A0A158P1R9,G7DVX0,V6R0U9,G4N9J3,E3KLI3,A0A1E3QC61,D5GGK8,S8ANP9,A0A139AUH8,L2GMR6,U4LBG4,A0A177URI1,O74957,A0A3N4IGK1,A6N7Y9,A0A0E9NDK5,T1KZ60,A0A250WXN5,A0A2G8JLH3,Q5KAT1,L2GUF2,W2T741,A0A1W0E4B5,A0A2J7QB22,S4RYE2,A0A2K3CW87,A0A388KES6,A0A226EFL3,A0A3S3PD82,A0A0L0TEV1,A0A1S3J512,G0QTT2,A0A1J1HRI1,C4V9J2,Q9JMB7,A0A075AN09,Q5TW24,U5HIG6,A0A401PRI6,Q96J94,A0A2B4RHN2,G2QEV0,A0A397UU01,A0A2T7PFL8,K7ISV0,A0A024FT57,H3HCL6,A0A0G4IME3,E9FUN9,A0A1S3CYL5,D7FQK3,A0A1Y1YHC8,T1GSU4,F4S231,A0A1D8PMK0,A0A2G5B1D8,Q5BD61,A0A1C7M8P2,A0A4D8YSQ3,A0A158PJG6,J9JZ66,A0A0C2XG51,A0A158QZT6,T0SAU8,R7YY92,A0A3S1A0C3,A0A074YJ47,A0A2K1J482,A0A1Q3ENA6,O04379,A0A371I3C8,M8AEW7,A8P0D4,A0A2K3NY65,F4NYW7,A0A409Y6G2,A0A0L0HAB7,D8PZT7,A0A1D1W4K0,A7RQ46,A7BJS5,D8SNM6,A0A1J8PPA3,X1WG39,M5FQK2,Q69VD5,A0A2R6NSC2,A0A0D8XL16,A0A016WPN3,Q9QZ81,G5EES3,A0A0K0EFP6,Q8CJG0,A0A1D5NTU6,V2WTL2,A0A0V0YLH8,A0A139WDH0,A0A0R3W9Q7,H3DS31,A0A1Y1HWP2,G4T5G9,B7QCC4,A0A0B2UV00,M7BCJ9,E9GN30,Q7PZ41,A0A077Z361,R7U9I3,A0A1X7V1N5,A0A0K0JDP1,A0A0N4UKJ1,A0A498N3A3,A0A3M0IQP5,A0A0L8GBV4,Q32KD4,A0A1J1JBJ0,E0W4C3,A0A482XDA9,A0A3P7EJD6,J9K2Z4,A0A2J7Q8V4,T1IBM6,V3ZRX0,A0A210QKF7,A0A423TSS1,K1PT78,A0A267E8R7,A0A1D2N447,A0A226D7A9,F6YK55,T1KTE4,A0A2C9JGZ6,A0A1V9X9F0,K5X5Z7,A0A3Q0KUG5,T1FY40,1YVU,1Z26,3DLB,5G5T,6QZK,C4L1M1,A0A0M2PXX3,A0A1I3LMA1,A0A1C0UUC4,B1XJG0,A0A0B0H9B4,R6KUL9,B7GJX9,A0A1N6SSK9,A0A060HNJ0,A0A235B542,R5XQK4,A0A1H3LE92,A0A062U2W9,H0HWQ5,A0A1I2ZGP1,A0A317EJY3,A0A1I2BD20,F8ERC7,A0A0Q2M2Z1,I3TE64,Q8DKB1,A0A1J1EK56,Q53W94,A0A2T1EKT1,E0UCX3,K9XZC6,B9LVW4,A0A0C1VHB4,Q31N05,R5NJJ8,Q2JI93,A0A3R7KLK4,A0A1E3XF49,A0A1H3DGN3,A0A1Q1FPH0,H1YCU5,L0JS08,A0A1Q5ZS75,A0A345E7N0,M0AF24,A0A1W2A082,A0A1H3X247,A0A0C1XUA0,M0D2X3,A0A346PK63,R7RTW6,A0A1H2RBI2,A0A1C3ZXN2,B9LVP8,W0JW77,F8D8G0,A0A343TL88,L0AJX6,A0A2A5QS34,A0A343JEE2,A0A3P3RGE5,A0A329TBQ3,A0A285N2A8,A0A0W1S8B8,A0A1V4C8L7,L9VRQ2,E4NRV1,A0A1I6HGN0,A0A1I0NI68,,",366,37
"1003","N.S11.8","N.S12.6",330,177,153,3.39891436800709,"4F1N,4F3T,4KRE,5GUH,5VM9,6KR6,6OON,7KX7,7SWF,A0A196SDB4,J9D5G4,C4LVV2,A0A2P6N8X7,A2DPV7,A0A0G4H2S4,T1H8B3,R1FDF0,S4RWI0,D2VMG4,A0A0D1ZAJ4,Q1K660,F4PH46,A0A3M7S814,A0A164ZA52,A0A383WDW5,Q54G64,S7WCF7,I0YVB2,R7QGN7,C1DZY0,A0A2C5Z0M1,A0CB11,R9ACY5,D3BMP8,A0A1Z5TVE5,W7XD45,A0A1U7LLR0,A0A4S2MWZ7,K1VVQ6,A0A158P1R9,G7DVX0,V6R0U9,G4N9J3,E3KLI3,B7Q5I1,A0A1E3QC61,D5GGK8,S8ANP9,A0A139AUH8,L2GMR6,U4LBG4,A0A177URI1,O74957,A0A3N4IGK1,A6N7Y9,A0A0E9NDK5,A0A250WXN5,A0A2G8JLH3,Q5KAT1,L2GUF2,W2T741,A0A1W0E4B5,A0A2J7QB22,S4RYE2,A0A2K3CW87,A0A388KES6,A0A226EFL3,A0A3S3PD82,A0A0L0TEV1,A0A1S3J512,G0QTT2,A0A1J1HRI1,C4V9J2,Q9JMB7,A0A075AN09,Q5TW24,U5HIG6,A0A401PRI6,Q96J94,A0A2B4RHN2,G2QEV0,A0A397UU01,A0A2T7PFL8,K7ISV0,A0A024FT57,H3HCL6,A0A0G4IME3,E9FUN9,A0A1S3CYL5,D7FQK3,A0A1Y1YHC8,T1GSU4,F4S231,A0A1D8PMK0,A0A2G5B1D8,Q5BD61,A0A1C7M8P2,A0A4D8YSQ3,A0A158PJG6,J9JZ66,A0A0C2XG51,A0A158QZT6,A0A165QYQ9,T0SAU8,R7YY92,A0A3S1A0C3,A0A074YJ47,A0A2K1J482,A0A1Q3ENA6,O04379,A0A371I3C8,M8AEW7,A8P0D4,A0A2K3NY65,F4NYW7,A0A409Y6G2,A0A0L0HAB7,D8PZT7,A0A1D1W4K0,A7RQ46,W4YU94,A7BJS5,D8SNM6,A0A1J8PPA3,X1WG39,M5FQK2,Q69VD5,A0A2R6NSC2,A0A0D8XL16,A0A016WPN3,Q9QZ81,G5EES3,A0A0K0EFP6,Q8CJG0,A0A1D5NTU6,V2WTL2,A0A0V0YLH8,A0A139WDH0,A0A0R3W9Q7,H3DS31,A0A1Y1HWP2,G4T5G9,B7QCC4,A0A0B2UV00,M7BCJ9,E9GN30,Q7PZ41,A0A077Z361,R7U9I3,A0A1X7V1N5,A0A0K0JDP1,A0A0N4UKJ1,A0A498N3A3,A0A3M0IQP5,A0A0L8GBV4,Q32KD4,A0A1J1JBJ0,E0W4C3,A0A482XDA9,A0A3P7EJD6,J9K2Z4,A0A2J7Q8V4,T1IBM6,V3ZRX0,A0A210QKF7,A0A423TSS1,K1PT78,A0A267E8R7,A0A1D2N447,A0A226D7A9,F6YK55,T1KTE4,A0A2C9JGZ6,A0A1V9X9F0,K5X5Z7,A0A3Q0KUG5,T1FY40,1YVU,1Z26,3DLB,5AWH,5G5T,5I4A,6QZK,7R8K,C4L1M1,A0A1I3LMA1,K9TPA9,B1XJG0,A0A326U7G5,A0A3D8L290,K9U8J6,A0A097QRL6,K9RC91,A0A0D8ZUC0,A0A139XGN8,A0A1T4Y3A2,A0A0B0H9B4,A0YYT3,A0A2T1EFY0,G6FTN0,R6KUL9,A0A433NB65,A0A1Z4L0A1,K9UQR0,A0A2T1G8M7,K9VUN0,B7GJX9,K9ZDE3,B0JXD6,A0A2T1LS63,A0A1Z4K1Y3,A0A1N6SSK9,A0A0P4UVI8,A0A0V7ZCG4,A0A1J0AGK2,K9PFF9,A0A2G9DT08,K9UEV4,Q9L1X1,A0A060HNJ0,A0A235B542,R5XQK4,A0A1H3LE92,A0A496APJ8,A0A062U2W9,H0HWQ5,A0A1V9G9U4,A0A1I2ZGP1,A0A317EJY3,A0A1I2BD20,F8ERC7,S7VLM7,A0A1A5X8H4,A0A1I2T6Q1,A0A1R3T9N6,A0A0Q2M2Z1,H8KXJ0,A0A2D1U4H7,I3TE64,A0A0B7I4Z6,A0LL61,Q8DKB1,A0A139WY18,A0A1J1EK56,A0A2T1E1K4,A0A1Q8ZD62,A0A4Q6XKV6,A0A1Z3HNN4,A0A239JE83,A0A2N4XBY2,Q53W94,R5JEI2,A0A0Q0ZC47,A0A2T0XH18,A0A1V4CHV0,A0A1K1RQP7,A0A2T1EKT1,A0A1N6LUI7,A0A0P0NGR6,A0A1X7IML5,A0A0A2LKJ7,K1L112,A0A0U3AL92,A0A1H3A054,E0UCX3,K9XZC6,B9LVW4,A0A0C1VHB4,Q31N05,A0A0C5JKF3,R5NJJ8,A5D4D9,Q2JI93,A0A142Y7A9,A0A432MEQ5,A0A372DKU2,A0A3R7KLK4,C1F5Q7,A0A4R3EV39,A0A1P8WP90,A0A222F7P0,A0A1C9VH88,A0A2T2YMB1,A0A329TD61,A0A101R2A0,A0A1E3XF49,A0A1U9ND56,A0A4R7BQC4,A0A1H3DGN3,A0A1Q1FPH0,E0TGY3,A0A259TUP4,F6EYI8,A0A2S9Q9J0,A0A4Q2UIU6,A0A1H0LH25,A0A318LG42,H1YCU5,L0JS08,A0A1Q5ZS75,A0A345E7N0,M0AF24,A0A1W2A082,A0A1H3X247,A0A0C1XUA0,M0D2X3,A0A2R5G167,A0A346PK63,R7RTW6,A0A1H2RBI2,A0A1C3ZXN2,B9LVP8,M5RSF0,W0JW77,B7K585,F8D8G0,A0A343TL88,L0AJX6,A0A2A5QS34,A0A343JEE2,A0A3P3RGE5,A0A329TBQ3,A0A285N2A8,A0A0W1S8B8,A0A1V4C8L7,L9VRQ2,E4NRV1,A0A1I6HGN0,A0A1I0NI68,,",366,37
"1005","C.H1.10","C.H1.12",356,178,178,1.97752808988764,"4F1N,4F3T,4KRE,5GUH,5VM9,6KR6,6OON,7KX7,7SWF,A0A163JTZ6,A0A0N4X8S8,A0A196SDB4,J9D5G4,A0A2P6N8X7,A8BCK6,A2DPV7,A0A0G4H2S4,T1H8B3,S4RWI0,D2VMG4,A0A074TLL7,A0A0D1ZAJ4,Q1K660,F4PH46,A0A3M7S814,A0A164ZA52,A0A383WDW5,Q54G64,I0YVB2,R7QGN7,A0A2C5Z0M1,A0CB11,R9ACY5,D3BMP8,A0A1Z5TVE5,W7XD45,A0A1U7LLR0,A0A4S2MWZ7,K1VVQ6,A0A158P1R9,G7DVX0,V6R0U9,G4N9J3,E3KLI3,B7Q5I1,A0A1E3QC61,D5GGK8,S8ANP9,A0A139AUH8,L2GMR6,U4LBG4,A0A177URI1,O74957,A0A3N4IGK1,A6N7Y9,A0A0E9NDK5,T1KZ60,A0A250WXN5,A0A2G8JLH3,Q5KAT1,L2GUF2,W2T741,A0A1W0E4B5,A0A2J7QB22,S4RYE2,A0A2K3CW87,A0A388KES6,A0A226EFL3,A0A3S3PD82,A0A0L0TEV1,A0A1S3J512,G0QTT2,A0A1J1HRI1,C4V9J2,Q9JMB7,A0A075AN09,Q5TW24,U5HIG6,A0A401PRI6,Q96J94,A0A2B4RHN2,G2QEV0,A0A397UU01,A0A2T7PFL8,K7ISV0,A0A024FT57,H3HCL6,A0A0G4IME3,E9FUN9,A0A1S3CYL5,D7FQK3,A0A1Y1YHC8,T1GSU4,F4S231,A0A1D8PMK0,A0A2G5B1D8,Q5BD61,A0A1C7M8P2,A0A4D8YSQ3,A0A158PJG6,J9JZ66,A0A0C2XG51,A0A158QZT6,A0A165QYQ9,T0SAU8,R7YY92,A0A3S1A0C3,A0A074YJ47,A0A2K1J482,A0A1Q3ENA6,O04379,A0A371I3C8,M8AEW7,A8P0D4,A0A2K3NY65,F4NYW7,A0A409Y6G2,A0A0L0HAB7,D8PZT7,A0A1D1W4K0,A7RQ46,W4YU94,A7BJS5,D8SNM6,A0A1J8PPA3,X1WG39,M5FQK2,Q69VD5,A0A2R6NSC2,A0A0D8XL16,A0A016WPN3,Q9QZ81,G5EES3,A0A0K0EFP6,Q8CJG0,A0A1D5NTU6,V2WTL2,A0A0V0YLH8,A0A139WDH0,A0A0R3W9Q7,H3DS31,A0A1Y1HWP2,G4T5G9,B7QCC4,A0A0B2UV00,M7BCJ9,E9GN30,Q7PZ41,A0A077Z361,R7U9I3,A0A1X7V1N5,A0A0K0JDP1,A0A0N4UKJ1,A0A498N3A3,A0A3M0IQP5,A0A0L8GBV4,Q32KD4,A0A1J1JBJ0,E0W4C3,A0A482XDA9,A0A3P7EJD6,J9K2Z4,A0A2J7Q8V4,T1IBM6,V3ZRX0,A0A210QKF7,A0A423TSS1,K1PT78,A0A267E8R7,A0A1D2N447,A0A226D7A9,F6YK55,T1KTE4,A0A2C9JGZ6,A0A1V9X9F0,K5X5Z7,A0A3Q0KUG5,T1FY40,1YVU,1Z26,3DLB,5AWH,5G5T,5I4A,6QZK,7R8K,E8N0K8,A0A1I7IXT4,A0A2W1JZ37,A0A2S7WBN3,A0A328VKE4,A0A420DFE6,E0ST67,A0A4V1VDY2,A0A368P5I0,C4L1M1,A0A4R1RMM2,A0A1Y2RDH8,Q11QW7,A0A1M5ZSR3,A0A0K8QX04,A0A0M2PXX3,A0A1I3LMA1,K9TPA9,A0A1L3JHM3,A0A1W6MIP2,A0A1C0UUC4,A0A2U2J9E0,A0A2Z6E1D5,A0A0F4NXW8,A0A142XB92,L8D0R3,B1XJG0,A0A326U7G5,H1KXR6,K9U8J6,A0A097QRL6,K9RC91,A0A139XGN8,A0A1T4Y3A2,Q5P0R2,B6YTQ5,A0A0B0H9B4,A0YYT3,G6FTN0,R6KUL9,A0A433NB65,A0A1Z4L0A1,K9UQR0,A0A2T1G8M7,K9VUN0,B7GJX9,A0A0P6X5X2,K9ZDE3,B0JXD6,A0A2T1LS63,A0A1Z4K1Y3,A0A2Z6E0R7,A0A1N6SSK9,A0A0P4UVI8,A0A0V7ZCG4,A0A1J0AGK2,K9PFF9,A0A2G9DT08,K9UEV4,Q9L1X1,A0A060HNJ0,A0A235B542,R5XQK4,A0A1H3LE92,A0A496APJ8,A0A062U2W9,H0HWQ5,A0A1V9G9U4,A0A1I2ZGP1,A0A317EJY3,A0A1I2BD20,F8ERC7,S7VLM7,A0A1A5X8H4,A0A1I2T6Q1,A0A1R3T9N6,A0A0Q2M2Z1,H8KXJ0,D3S0S6,A0A2D1U4H7,I3TE64,A0A0B7I4Z6,A0LL61,Q8DKB1,A0A139WY18,A0A1J1EK56,A0A2T1E1K4,A0A1Q8ZD62,A0A4Q6XKV6,A0A1Z3HNN4,A0A239JE83,A0A2N4XBY2,Q53W94,R5JEI2,A0A0Q0ZC47,A0A2T0XH18,A0A1V4CHV0,A0A1K1RQP7,A0A2T1EKT1,A0A1N6LUI7,A0A0P0NGR6,A0A1X7IML5,A0A0A2LKJ7,K1L112,A0A0U3AL92,A0A1H3A054,E0UCX3,K9XZC6,A0A0C1VHB4,Q31N05,A0A0C5JKF3,R5NJJ8,A5D4D9,Q2JI93,A0A142Y7A9,A0A432MEQ5,A0A372DKU2,A0A3R7KLK4,C1F5Q7,A0A4R3EV39,A0A1P8WP90,A0A222F7P0,A0A1C9VH88,A0A2T2YMB1,A0A329TD61,A0A101R2A0,A0A1E3XF49,A0A1U9ND56,A0A4R7BQC4,A0A1H3DGN3,A0A1Q1FPH0,E0TGY3,A0A259TUP4,F6EYI8,A0A2S9Q9J0,A0A4Q2UIU6,A0A1H0LH25,A0A318LG42,H1YCU5,L0JS08,A0A1Q5ZS75,A0A345E7N0,M0AF24,A0A1W2A082,A0A1H3X247,A0A0C1XUA0,M0D2X3,A0A2R5G167,A0A346PK63,R7RTW6,A0A1H2RBI2,A0A1C3ZXN2,B9LVP8,M5RSF0,W0JW77,B7K585,F8D8G0,A0A343TL88,L0AJX6,A0A2A5QS34,A0A343JEE2,A0A3P3RGE5,A0A329TBQ3,A0A285N2A8,A0A0W1S8B8,A0A1V4C8L7,L9VRQ2,E4NRV1,A0A1I6HGN0,A0A1I0NI68,,",366,37
"1010","C.H1.12","C.H1.9",355,178,177,3.22394147146575,"4F1N,4F3T,4KRE,5GUH,5VM9,6KR6,6OON,7KX7,7SWF,A0A163JTZ6,A0A0N4X8S8,A0A196SDB4,J9D5G4,A0A2P6N8X7,A8BCK6,A2DPV7,A0A0G4H2S4,T1H8B3,S4RWI0,D2VMG4,A0A074TLL7,A0A0D1ZAJ4,Q1K660,F4PH46,A0A3M7S814,A0A164ZA52,A0A383WDW5,Q54G64,I0YVB2,R7QGN7,A0A2C5Z0M1,A0CB11,R9ACY5,D3BMP8,A0A1Z5TVE5,W7XD45,A0A1U7LLR0,A0A4S2MWZ7,K1VVQ6,A0A158P1R9,G7DVX0,V6R0U9,G4N9J3,E3KLI3,B7Q5I1,A0A1E3QC61,D5GGK8,S8ANP9,A0A139AUH8,L2GMR6,U4LBG4,A0A177URI1,O74957,A0A3N4IGK1,A6N7Y9,A0A0E9NDK5,T1KZ60,A0A250WXN5,A0A2G8JLH3,Q5KAT1,L2GUF2,W2T741,A0A1W0E4B5,A0A2J7QB22,S4RYE2,A0A2K3CW87,A0A388KES6,A0A226EFL3,A0A3S3PD82,A0A0L0TEV1,A0A1S3J512,G0QTT2,A0A1J1HRI1,C4V9J2,Q9JMB7,A0A075AN09,Q5TW24,U5HIG6,A0A401PRI6,Q96J94,A0A2B4RHN2,G2QEV0,A0A397UU01,A0A2T7PFL8,K7ISV0,A0A024FT57,H3HCL6,A0A0G4IME3,E9FUN9,A0A1S3CYL5,D7FQK3,A0A1Y1YHC8,T1GSU4,F4S231,A0A1D8PMK0,A0A2G5B1D8,Q5BD61,A0A1C7M8P2,A0A4D8YSQ3,A0A158PJG6,J9JZ66,A0A0C2XG51,A0A158QZT6,A0A165QYQ9,T0SAU8,R7YY92,A0A3S1A0C3,A0A074YJ47,A0A2K1J482,A0A1Q3ENA6,O04379,A0A371I3C8,M8AEW7,A8P0D4,A0A2K3NY65,F4NYW7,A0A409Y6G2,A0A0L0HAB7,D8PZT7,A0A1D1W4K0,A7RQ46,W4YU94,A7BJS5,D8SNM6,A0A1J8PPA3,X1WG39,M5FQK2,Q69VD5,A0A2R6NSC2,A0A0D8XL16,A0A016WPN3,Q9QZ81,G5EES3,A0A0K0EFP6,Q8CJG0,A0A1D5NTU6,V2WTL2,A0A0V0YLH8,A0A139WDH0,A0A0R3W9Q7,H3DS31,A0A1Y1HWP2,G4T5G9,B7QCC4,A0A0B2UV00,M7BCJ9,E9GN30,Q7PZ41,A0A077Z361,R7U9I3,A0A1X7V1N5,A0A0K0JDP1,A0A0N4UKJ1,A0A498N3A3,A0A3M0IQP5,A0A0L8GBV4,Q32KD4,A0A1J1JBJ0,E0W4C3,A0A482XDA9,A0A3P7EJD6,J9K2Z4,A0A2J7Q8V4,T1IBM6,V3ZRX0,A0A210QKF7,A0A423TSS1,K1PT78,A0A267E8R7,A0A1D2N447,A0A226D7A9,F6YK55,T1KTE4,A0A2C9JGZ6,A0A1V9X9F0,K5X5Z7,A0A3Q0KUG5,T1FY40,1YVU,1Z26,3DLB,5AWH,5G5T,6QZK,7R8K,E8N0K8,A0A1I7IXT4,A0A2W1JZ37,A0A2S7WBN3,A0A420DFE6,E0ST67,A0A4V1VDY2,A0A368P5I0,C4L1M1,A0A4R1RMM2,A0A1Y2RDH8,A0A1M5ZSR3,A0A0K8QX04,A0A0M2PXX3,A0A1I3LMA1,K9TPA9,A0A1L3JHM3,A0A1W6MIP2,A0A1C0UUC4,A0A2U2J9E0,A0A2Z6E1D5,A0A0F4NXW8,A0A142XB92,L8D0R3,B1XJG0,A0A326U7G5,A0A3D8L290,K9U8J6,A0A097QRL6,K9RC91,A0A0D8ZUC0,A0A139XGN8,A0A1T4Y3A2,Q5P0R2,B6YTQ5,A0A0B0H9B4,A0YYT3,A0A2T1EFY0,G6FTN0,R6KUL9,A0A433NB65,A0A1Z4L0A1,K9UQR0,A0A2T1G8M7,K9VUN0,B7GJX9,A0A0P6X5X2,K9ZDE3,B0JXD6,A0A2T1LS63,A0A1Z4K1Y3,A0A2Z6E0R7,A0A1N6SSK9,A0A0P4UVI8,A0A0V7ZCG4,A0A1J0AGK2,K9PFF9,A0A2G9DT08,K9UEV4,Q9L1X1,A0A060HNJ0,A0A235B542,R5XQK4,A0A1H3LE92,A0A496APJ8,A0A062U2W9,H0HWQ5,A0A1V9G9U4,A0A1I2ZGP1,A0A317EJY3,A0A1I2BD20,F8ERC7,S7VLM7,A0A1A5X8H4,A0A1I2T6Q1,A0A1R3T9N6,A0A0Q2M2Z1,H8KXJ0,D3S0S6,A0A2D1U4H7,I3TE64,A0A0B7I4Z6,A0LL61,Q8DKB1,A0A139WY18,A0A1J1EK56,A0A2T1E1K4,A0A1Q8ZD62,A0A4Q6XKV6,A0A1Z3HNN4,A0A239JE83,A0A2N4XBY2,Q53W94,R5JEI2,A0A0Q0ZC47,A0A2T0XH18,A0A1V4CHV0,A0A1K1RQP7,A0A2T1EKT1,A0A1N6LUI7,A0A0P0NGR6,A0A1X7IML5,A0A0A2LKJ7,K1L112,A0A0U3AL92,A0A1H3A054,E0UCX3,K9XZC6,A0A0C1VHB4,Q31N05,A0A0C5JKF3,R5NJJ8,A5D4D9,Q2JI93,A0A142Y7A9,A0A432MEQ5,A0A372DKU2,A0A3R7KLK4,C1F5Q7,A0A4R3EV39,A0A1P8WP90,A0A222F7P0,A0A1C9VH88,A0A2T2YMB1,A0A329TD61,A0A101R2A0,A0A1E3XF49,A0A1U9ND56,A0A4R7BQC4,A0A1H3DGN3,A0A1Q1FPH0,E0TGY3,A0A259TUP4,F6EYI8,A0A2S9Q9J0,A0A4Q2UIU6,A0A1H0LH25,A0A318LG42,H1YCU5,L0JS08,A0A1Q5ZS75,A0A345E7N0,M0AF24,A0A1W2A082,A0A1H3X247,A0A0C1XUA0,M0D2X3,A0A2R5G167,A0A346PK63,R7RTW6,A0A1H2RBI2,A0A1C3ZXN2,B9LVP8,M5RSF0,W0JW77,B7K585,F8D8G0,A0A343TL88,L0AJX6,A0A2A5QS34,A0A343JEE2,A0A3P3RGE5,A0A329TBQ3,A0A285N2A8,A0A0W1S8B8,A0A1V4C8L7,L9VRQ2,E4NRV1,A0A1I6HGN0,A0A1I0NI68,,",366,37
"1014","C.H10.1","C.H10.4",353,178,175,3.30969502407705,"4F1N,4F3T,4KRE,5GUH,5VM9,6KR6,6OON,7KX7,7SWF,A0A163JTZ6,J9D5G4,Q389P5,C4LVV2,A0A2P6N8X7,A8BCK6,A2DPV7,A0A0G4H2S4,R1FDF0,D2VMG4,A0A074TLL7,A0A0D1ZAJ4,Q1K660,F4PH46,A0A3M7S814,A0A164ZA52,Q54G64,S7WCF7,I0YVB2,R7QGN7,C1DZY0,A0A2C5Z0M1,A0CB11,R9ACY5,D3BMP8,A0A1Z5TVE5,W7XD45,A0A1U7LLR0,A0A4S2MWZ7,K1VVQ6,A0A158P1R9,G7DVX0,V6R0U9,G4N9J3,E3KLI3,B7Q5I1,A0A1E3QC61,D5GGK8,S8ANP9,A0A139AUH8,L2GMR6,U4LBG4,A0A177URI1,O74957,A0A3N4IGK1,A6N7Y9,A0A0E9NDK5,T1KZ60,A0A250WXN5,A0A2G8JLH3,Q5KAT1,L2GUF2,W2T741,A0A1W0E4B5,A0A2J7QB22,S4RYE2,A0A2K3CW87,A0A388KES6,A0A226EFL3,A0A3S3PD82,A0A0L0TEV1,A0A1S3J512,G0QTT2,A0A1J1HRI1,C4V9J2,Q9JMB7,A0A075AN09,Q5TW24,U5HIG6,A0A401PRI6,Q96J94,A0A2B4RHN2,G2QEV0,A0A397UU01,A0A2T7PFL8,K7ISV0,A0A024FT57,H3HCL6,A0A0G4IME3,E9FUN9,A0A1S3CYL5,D7FQK3,A0A1Y1YHC8,T1GSU4,F4S231,A0A1D8PMK0,A0A2G5B1D8,Q5BD61,A0A1C7M8P2,A0A4D8YSQ3,A0A158PJG6,J9JZ66,A0A0C2XG51,A0A158QZT6,A0A165QYQ9,T0SAU8,R7YY92,A0A3S1A0C3,A0A074YJ47,A0A2K1J482,A0A1Q3ENA6,O04379,A0A371I3C8,M8AEW7,A8P0D4,A0A2K3NY65,F4NYW7,A0A409Y6G2,A0A0L0HAB7,D8PZT7,A0A1D1W4K0,A7RQ46,W4YU94,A7BJS5,D8SNM6,A0A1J8PPA3,X1WG39,M5FQK2,Q69VD5,A0A2R6NSC2,A0A0D8XL16,A0A016WPN3,Q9QZ81,G5EES3,A0A0K0EFP6,Q8CJG0,A0A1D5NTU6,V2WTL2,A0A0V0YLH8,A0A139WDH0,A0A0R3W9Q7,H3DS31,A0A1Y1HWP2,G4T5G9,B7QCC4,A0A0B2UV00,M7BCJ9,E9GN30,Q7PZ41,A0A077Z361,R7U9I3,A0A1X7V1N5,A0A0K0JDP1,A0A0N4UKJ1,A0A498N3A3,A0A3M0IQP5,A0A0L8GBV4,Q32KD4,A0A1J1JBJ0,E0W4C3,A0A482XDA9,A0A3P7EJD6,J9K2Z4,A0A2J7Q8V4,T1IBM6,V3ZRX0,A0A210QKF7,A0A423TSS1,K1PT78,A0A267E8R7,A0A1D2N447,A0A226D7A9,F6YK55,T1KTE4,A0A2C9JGZ6,A0A1V9X9F0,K5X5Z7,A0A3Q0KUG5,T1FY40,1YVU,1Z26,5AWH,5G5T,5I4A,6QZK,7R8K,A0A1I7IXT4,A0A2W1JZ37,A0A2S7WBN3,A0A328VKE4,A0A420DFE6,A0A4V1VDY2,A0A368P5I0,C4L1M1,A0A4R1RMM2,A0A1Y2RDH8,Q11QW7,A0A1M5ZSR3,A0A0K8QX04,A0A0M2PXX3,K9TPA9,A0A1L3JHM3,A0A1W6MIP2,A0A1C0UUC4,A0A2U2J9E0,A0A2Z6E1D5,A0A0F4NXW8,A0A142XB92,L8D0R3,B1XJG0,A0A326U7G5,A0A3D8L290,H1KXR6,A0A1Q4R485,K9U8J6,A0A097QRL6,K9RC91,A0A0D8ZUC0,A0A139XGN8,A0A1T4Y3A2,Q5P0R2,B6YTQ5,A0A0B0H9B4,A0YYT3,A0A2T1EFY0,G6FTN0,R6KUL9,A0A433NB65,A0A1Z4L0A1,K9UQR0,A0A2T1G8M7,K9VUN0,B7GJX9,K9ZDE3,B0JXD6,A0A2T1LS63,A0A1Z4K1Y3,A0A2Z6E0R7,A0A1N6SSK9,A0A0P4UVI8,A0A0V7ZCG4,A0A1J0AGK2,K9PFF9,A0A2G9DT08,K9UEV4,Q9L1X1,A0A060HNJ0,A0A235B542,R5XQK4,A0A1H3LE92,A0A496APJ8,A0A062U2W9,H0HWQ5,A0A1V9G9U4,A0A1I2ZGP1,A0A317EJY3,A0A1I2BD20,F8ERC7,A0A1A5X8H4,A0A1I2T6Q1,A0A1R3T9N6,A0A0Q2M2Z1,H8KXJ0,D3S0S6,A0A2D1U4H7,I3TE64,A0A0B7I4Z6,A0LL61,Q8DKB1,A0A139WY18,A0A1J1EK56,A0A2T1E1K4,A0A1Q8ZD62,A0A4Q6XKV6,A0A1Z3HNN4,A0A239JE83,A0A2N4XBY2,Q53W94,R5JEI2,A0A0Q0ZC47,A0A2T0XH18,A0A1V4CHV0,A0A1K1RQP7,A0A2T1EKT1,A0A1N6LUI7,A0A0P0NGR6,A0A1X7IML5,A0A0A2LKJ7,K1L112,A0A0U3AL92,A0A1H3A054,E0UCX3,K9XZC6,A0A0C1VHB4,Q31N05,A0A0C5JKF3,R5NJJ8,A5D4D9,Q2JI93,A0A142Y7A9,A0A432MEQ5,A0A372DKU2,A0A3R7KLK4,C1F5Q7,A0A4R3EV39,A0A1P8WP90,A0A222F7P0,A0A1C9VH88,A0A2T2YMB1,A0A329TD61,A0A101R2A0,A0A1E3XF49,A0A1U9ND56,A0A4R7BQC4,A0A1H3DGN3,A0A1Q1FPH0,E0TGY3,A0A259TUP4,F6EYI8,A0A2S9Q9J0,A0A4Q2UIU6,A0A1H0LH25,A0A318LG42,L0JS08,A0A1Q5ZS75,A0A345E7N0,M0AF24,A0A1W2A082,A0A1H3X247,A0A0C1XUA0,M0D2X3,A0A2R5G167,A0A346PK63,R7RTW6,A0A1H2RBI2,A0A1C3ZXN2,B9LVP8,M5RSF0,W0JW77,B7K585,F8D8G0,A0A343TL88,L0AJX6,A0A2A5QS34,A0A343JEE2,A0A3P3RGE5,A0A329TBQ3,A0A285N2A8,A0A0W1S8B8,A0A1V4C8L7,L9VRQ2,E4NRV1,A0A1I6HGN0,A0A1I0NI68,,",366,37
"1015","C.H10.10","C.H10.12",310,178,132,1.99621212121212,"4F1N,4F3T,4KRE,5GUH,5VM9,6KR6,6OON,7KX7,7SWF,A0A163JTZ6,J9D5G4,Q389P5,C4LVV2,A0A2P6N8X7,A8BCK6,A2DPV7,A0A0G4H2S4,R1FDF0,D2VMG4,A0A074TLL7,A0A0D1ZAJ4,Q1K660,F4PH46,A0A3M7S814,A0A164ZA52,Q54G64,S7WCF7,I0YVB2,R7QGN7,C1DZY0,A0A2C5Z0M1,A0CB11,R9ACY5,D3BMP8,A0A1Z5TVE5,W7XD45,A0A1U7LLR0,A0A4S2MWZ7,K1VVQ6,A0A158P1R9,G7DVX0,V6R0U9,G4N9J3,E3KLI3,B7Q5I1,A0A1E3QC61,D5GGK8,S8ANP9,A0A139AUH8,L2GMR6,U4LBG4,A0A177URI1,O74957,A0A3N4IGK1,A6N7Y9,A0A0E9NDK5,T1KZ60,A0A250WXN5,A0A2G8JLH3,Q5KAT1,L2GUF2,W2T741,A0A1W0E4B5,A0A2J7QB22,S4RYE2,A0A2K3CW87,A0A388KES6,A0A226EFL3,A0A3S3PD82,A0A0L0TEV1,A0A1S3J512,G0QTT2,A0A1J1HRI1,C4V9J2,Q9JMB7,A0A075AN09,Q5TW24,U5HIG6,A0A401PRI6,Q96J94,A0A2B4RHN2,G2QEV0,A0A397UU01,A0A2T7PFL8,K7ISV0,A0A024FT57,H3HCL6,A0A0G4IME3,E9FUN9,A0A1S3CYL5,D7FQK3,A0A1Y1YHC8,T1GSU4,F4S231,A0A1D8PMK0,A0A2G5B1D8,Q5BD61,A0A1C7M8P2,A0A4D8YSQ3,A0A158PJG6,J9JZ66,A0A0C2XG51,A0A158QZT6,A0A165QYQ9,T0SAU8,R7YY92,A0A3S1A0C3,A0A074YJ47,A0A2K1J482,A0A1Q3ENA6,O04379,A0A371I3C8,M8AEW7,A8P0D4,A0A2K3NY65,F4NYW7,A0A409Y6G2,A0A0L0HAB7,D8PZT7,A0A1D1W4K0,A7RQ46,W4YU94,A7BJS5,D8SNM6,A0A1J8PPA3,X1WG39,M5FQK2,Q69VD5,A0A2R6NSC2,A0A0D8XL16,A0A016WPN3,Q9QZ81,G5EES3,A0A0K0EFP6,Q8CJG0,A0A1D5NTU6,V2WTL2,A0A0V0YLH8,A0A139WDH0,A0A0R3W9Q7,H3DS31,A0A1Y1HWP2,G4T5G9,B7QCC4,A0A0B2UV00,M7BCJ9,E9GN30,Q7PZ41,A0A077Z361,R7U9I3,A0A1X7V1N5,A0A0K0JDP1,A0A0N4UKJ1,A0A498N3A3,A0A3M0IQP5,A0A0L8GBV4,Q32KD4,A0A1J1JBJ0,E0W4C3,A0A482XDA9,A0A3P7EJD6,J9K2Z4,A0A2J7Q8V4,T1IBM6,V3ZRX0,A0A210QKF7,A0A423TSS1,K1PT78,A0A267E8R7,A0A1D2N447,A0A226D7A9,F6YK55,T1KTE4,A0A2C9JGZ6,A0A1V9X9F0,K5X5Z7,A0A3Q0KUG5,T1FY40,1YVU,1Z26,5AWH,5G5T,5I4A,6QZK,A0A1I7IXT4,A0A2W1JZ37,A0A2S7WBN3,A0A328VKE4,A0A420DFE6,E0ST67,A0A4V1VDY2,A0A368P5I0,C4L1M1,A0A4R1RMM2,A0A1Y2RDH8,Q11QW7,A0A1M5ZSR3,A0A0K8QX04,A0A0M2PXX3,A0A1L3JHM3,A0A1W6MIP2,A0A1C0UUC4,A0A2U2J9E0,L8D0R3,B1XJG0,A0A326U7G5,A0A3D8L290,H1KXR6,A0A1Q4R485,A0A097QRL6,K9RC91,A0A1T4Y3A2,B6YTQ5,A0A0B0H9B4,G6FTN0,R6KUL9,A0A433NB65,K9UQR0,K9VUN0,B7GJX9,K9ZDE3,B0JXD6,A0A2T1LS63,A0A1Z4K1Y3,A0A1N6SSK9,A0A0P4UVI8,A0A1J0AGK2,A0A2G9DT08,K9UEV4,Q9L1X1,A0A060HNJ0,A0A235B542,A0A496APJ8,A0A1V9G9U4,F8ERC7,A0A1A5X8H4,A0A1I2T6Q1,A0A1R3T9N6,A0A0Q2M2Z1,H8KXJ0,A0A2D1U4H7,I3TE64,A0A0B7I4Z6,A0LL61,A0A139WY18,A0A1J1EK56,A0A2T1E1K4,A0A1Q8ZD62,A0A4Q6XKV6,A0A1Z3HNN4,A0A239JE83,A0A2N4XBY2,Q53W94,R5JEI2,A0A0Q0ZC47,A0A2T0XH18,A0A1V4CHV0,A0A1K1RQP7,A0A1N6LUI7,A0A0P0NGR6,A0A1X7IML5,A0A0A2LKJ7,K1L112,A0A0U3AL92,A0A1H3A054,E0UCX3,K9XZC6,A0A0C1VHB4,A0A0C5JKF3,R5NJJ8,A5D4D9,A0A142Y7A9,A0A432MEQ5,A0A372DKU2,C1F5Q7,A0A4R3EV39,A0A1P8WP90,A0A222F7P0,A0A1C9VH88,A0A2T2YMB1,A0A101R2A0,A0A1U9ND56,A0A4R7BQC4,E0TGY3,A0A259TUP4,F6EYI8,A0A2S9Q9J0,A0A4Q2UIU6,A0A1H0LH25,A0A318LG42,L0JS08,M0AF24,M0D2X3,A0A2R5G167,A0A346PK63,M5RSF0,W0JW77,B7K585,F8D8G0,A0A343TL88,L0AJX6,A0A2A5QS34,A0A3P3RGE5,A0A329TBQ3,A0A285N2A8,A0A0W1S8B8,A0A1V4C8L7,L9VRQ2,E4NRV1,A0A1I6HGN0,,",366,37
"1016","C.H10.10","C.H10.13",316,178,138,2.89643380556913,"4F1N,4F3T,4KRE,5GUH,5VM9,6KR6,6OON,7KX7,7SWF,A0A163JTZ6,J9D5G4,Q389P5,C4LVV2,A0A2P6N8X7,A8BCK6,A2DPV7,A0A0G4H2S4,R1FDF0,D2VMG4,A0A074TLL7,A0A0D1ZAJ4,Q1K660,F4PH46,A0A3M7S814,A0A164ZA52,Q54G64,S7WCF7,I0YVB2,R7QGN7,C1DZY0,A0A2C5Z0M1,A0CB11,R9ACY5,D3BMP8,A0A1Z5TVE5,W7XD45,A0A1U7LLR0,A0A4S2MWZ7,K1VVQ6,A0A158P1R9,G7DVX0,V6R0U9,G4N9J3,E3KLI3,B7Q5I1,A0A1E3QC61,D5GGK8,S8ANP9,A0A139AUH8,L2GMR6,U4LBG4,A0A177URI1,O74957,A0A3N4IGK1,A6N7Y9,A0A0E9NDK5,T1KZ60,A0A250WXN5,A0A2G8JLH3,Q5KAT1,L2GUF2,W2T741,A0A1W0E4B5,A0A2J7QB22,S4RYE2,A0A2K3CW87,A0A388KES6,A0A226EFL3,A0A3S3PD82,A0A0L0TEV1,A0A1S3J512,G0QTT2,A0A1J1HRI1,C4V9J2,Q9JMB7,A0A075AN09,Q5TW24,U5HIG6,A0A401PRI6,Q96J94,A0A2B4RHN2,G2QEV0,A0A397UU01,A0A2T7PFL8,K7ISV0,A0A024FT57,H3HCL6,A0A0G4IME3,E9FUN9,A0A1S3CYL5,D7FQK3,A0A1Y1YHC8,T1GSU4,F4S231,A0A1D8PMK0,A0A2G5B1D8,Q5BD61,A0A1C7M8P2,A0A4D8YSQ3,A0A158PJG6,J9JZ66,A0A0C2XG51,A0A158QZT6,A0A165QYQ9,T0SAU8,R7YY92,A0A3S1A0C3,A0A074YJ47,A0A2K1J482,A0A1Q3ENA6,O04379,A0A371I3C8,M8AEW7,A8P0D4,A0A2K3NY65,F4NYW7,A0A409Y6G2,A0A0L0HAB7,D8PZT7,A0A1D1W4K0,A7RQ46,W4YU94,A7BJS5,D8SNM6,A0A1J8PPA3,X1WG39,M5FQK2,Q69VD5,A0A2R6NSC2,A0A0D8XL16,A0A016WPN3,Q9QZ81,G5EES3,A0A0K0EFP6,Q8CJG0,A0A1D5NTU6,V2WTL2,A0A0V0YLH8,A0A139WDH0,A0A0R3W9Q7,H3DS31,A0A1Y1HWP2,G4T5G9,B7QCC4,A0A0B2UV00,M7BCJ9,E9GN30,Q7PZ41,A0A077Z361,R7U9I3,A0A1X7V1N5,A0A0K0JDP1,A0A0N4UKJ1,A0A498N3A3,A0A3M0IQP5,A0A0L8GBV4,Q32KD4,A0A1J1JBJ0,E0W4C3,A0A482XDA9,A0A3P7EJD6,J9K2Z4,A0A2J7Q8V4,T1IBM6,V3ZRX0,A0A210QKF7,A0A423TSS1,K1PT78,A0A267E8R7,A0A1D2N447,A0A226D7A9,F6YK55,T1KTE4,A0A2C9JGZ6,A0A1V9X9F0,K5X5Z7,A0A3Q0KUG5,T1FY40,1YVU,1Z26,5AWH,5G5T,5I4A,6QZK,A0A1I7IXT4,A0A2W1JZ37,A0A2S7WBN3,A0A328VKE4,A0A420DFE6,E0ST67,A0A4V1VDY2,A0A368P5I0,C4L1M1,A0A4R1RMM2,A0A1Y2RDH8,Q11QW7,A0A1M5ZSR3,A0A0K8QX04,A0A0M2PXX3,K9TPA9,A0A1L3JHM3,A0A1W6MIP2,A0A1C0UUC4,A0A2U2J9E0,B1XJG0,A0A326U7G5,A0A3D8L290,H1KXR6,A0A1Q4R485,K9U8J6,A0A097QRL6,K9RC91,A0A0D8ZUC0,A0A139XGN8,A0A1T4Y3A2,B6YTQ5,A0A0B0H9B4,A0YYT3,A0A2T1EFY0,G6FTN0,R6KUL9,A0A433NB65,K9UQR0,A0A2T1G8M7,K9VUN0,B7GJX9,K9ZDE3,B0JXD6,A0A2T1LS63,A0A1Z4K1Y3,A0A1N6SSK9,A0A0P4UVI8,A0A0V7ZCG4,A0A1J0AGK2,A0A2G9DT08,K9UEV4,Q9L1X1,A0A060HNJ0,A0A235B542,A0A496APJ8,A0A1V9G9U4,A0A1A5X8H4,A0A1I2T6Q1,A0A1R3T9N6,A0A0Q2M2Z1,H8KXJ0,A0A2D1U4H7,I3TE64,A0A0B7I4Z6,A0LL61,A0A139WY18,A0A1J1EK56,A0A2T1E1K4,A0A1Q8ZD62,A0A4Q6XKV6,A0A1Z3HNN4,A0A239JE83,A0A2N4XBY2,Q53W94,R5JEI2,A0A0Q0ZC47,A0A2T0XH18,A0A1V4CHV0,A0A1K1RQP7,A0A1N6LUI7,A0A0P0NGR6,A0A1X7IML5,A0A0A2LKJ7,K1L112,A0A0U3AL92,A0A1H3A054,E0UCX3,K9XZC6,A0A0C1VHB4,A0A0C5JKF3,R5NJJ8,A5D4D9,A0A142Y7A9,A0A432MEQ5,A0A372DKU2,C1F5Q7,A0A4R3EV39,A0A1P8WP90,A0A222F7P0,A0A1C9VH88,A0A2T2YMB1,A0A101R2A0,A0A1U9ND56,A0A4R7BQC4,E0TGY3,A0A259TUP4,F6EYI8,A0A2S9Q9J0,A0A4Q2UIU6,A0A1H0LH25,A0A318LG42,L0JS08,M0AF24,M0D2X3,A0A2R5G167,A0A346PK63,M5RSF0,W0JW77,B7K585,F8D8G0,A0A343TL88,L0AJX6,A0A2A5QS34,A0A3P3RGE5,A0A329TBQ3,A0A285N2A8,A0A0W1S8B8,A0A1V4C8L7,L9VRQ2,E4NRV1,A0A1I6HGN0,,",366,37
"1017","C.H10.10","C.H10.7",328,178,150,1.66513108614232,"4F1N,4F3T,4KRE,5GUH,6KR6,6OON,7KX7,7SWF,A0A163JTZ6,J9D5G4,Q389P5,C4LVV2,A0A2P6N8X7,A8BCK6,A2DPV7,A0A0G4H2S4,R1FDF0,D2VMG4,A0A074TLL7,A0A0D1ZAJ4,Q1K660,F4PH46,A0A3M7S814,A0A164ZA52,A0A383WDW5,Q54G64,S7WCF7,I0YVB2,R7QGN7,C1DZY0,A0A2C5Z0M1,A0CB11,R9ACY5,D3BMP8,A0A1Z5TVE5,W7XD45,A0A1U7LLR0,A0A4S2MWZ7,K1VVQ6,A0A158P1R9,G7DVX0,V6R0U9,G4N9J3,E3KLI3,B7Q5I1,A0A1E3QC61,D5GGK8,S8ANP9,A0A139AUH8,L2GMR6,U4LBG4,A0A177URI1,O74957,A0A3N4IGK1,A6N7Y9,A0A0E9NDK5,T1KZ60,A0A250WXN5,A0A2G8JLH3,Q5KAT1,L2GUF2,W2T741,A0A1W0E4B5,A0A2J7QB22,S4RYE2,A0A2K3CW87,A0A388KES6,A0A226EFL3,A0A3S3PD82,A0A0L0TEV1,A0A1S3J512,G0QTT2,A0A1J1HRI1,C4V9J2,Q9JMB7,A0A075AN09,Q5TW24,U5HIG6,A0A401PRI6,Q96J94,A0A2B4RHN2,G2QEV0,A0A397UU01,A0A2T7PFL8,K7ISV0,A0A024FT57,H3HCL6,A0A0G4IME3,E9FUN9,A0A1S3CYL5,D7FQK3,A0A1Y1YHC8,T1GSU4,F4S231,A0A1D8PMK0,A0A2G5B1D8,Q5BD61,A0A1C7M8P2,A0A4D8YSQ3,A0A158PJG6,J9JZ66,A0A0C2XG51,A0A158QZT6,A0A165QYQ9,T0SAU8,R7YY92,A0A3S1A0C3,A0A074YJ47,A0A2K1J482,A0A1Q3ENA6,O04379,A0A371I3C8,M8AEW7,A8P0D4,A0A2K3NY65,F4NYW7,A0A409Y6G2,A0A0L0HAB7,D8PZT7,A0A1D1W4K0,A7RQ46,W4YU94,A7BJS5,D8SNM6,A0A1J8PPA3,X1WG39,M5FQK2,Q69VD5,A0A2R6NSC2,A0A0D8XL16,A0A016WPN3,Q9QZ81,G5EES3,A0A0K0EFP6,Q8CJG0,A0A1D5NTU6,V2WTL2,A0A0V0YLH8,A0A139WDH0,A0A0R3W9Q7,H3DS31,A0A1Y1HWP2,G4T5G9,B7QCC4,A0A0B2UV00,M7BCJ9,E9GN30,Q7PZ41,A0A077Z361,R7U9I3,A0A1X7V1N5,A0A0K0JDP1,A0A0N4UKJ1,A0A498N3A3,A0A3M0IQP5,A0A0L8GBV4,Q32KD4,A0A1J1JBJ0,E0W4C3,A0A482XDA9,A0A3P7EJD6,J9K2Z4,A0A2J7Q8V4,T1IBM6,V3ZRX0,A0A210QKF7,A0A423TSS1,K1PT78,A0A267E8R7,A0A1D2N447,A0A226D7A9,F6YK55,T1KTE4,A0A2C9JGZ6,A0A1V9X9F0,K5X5Z7,A0A3Q0KUG5,T1FY40,1Z26,5AWH,5G5T,6QZK,A0A1I7IXT4,A0A2W1JZ37,A0A2S7WBN3,A0A328VKE4,A0A420DFE6,E0ST67,A0A4V1VDY2,A0A368P5I0,C4L1M1,A0A4R1RMM2,A0A1Y2RDH8,Q11QW7,A0A1M5ZSR3,A0A0K8QX04,A0A0M2PXX3,K9TPA9,A0A1L3JHM3,A0A1W6MIP2,A0A1C0UUC4,A0A2U2J9E0,A0A2Z6E1D5,A0A142XB92,L8D0R3,B1XJG0,A0A326U7G5,H1KXR6,A0A1Q4R485,K9U8J6,A0A097QRL6,K9RC91,A0A0D8ZUC0,A0A139XGN8,A0A1T4Y3A2,B6YTQ5,A0A0B0H9B4,A0YYT3,A0A2T1EFY0,G6FTN0,R6KUL9,A0A433NB65,K9UQR0,A0A2T1G8M7,K9VUN0,B7GJX9,K9ZDE3,A0A2T1LS63,A0A1Z4K1Y3,A0A1N6SSK9,A0A0V7ZCG4,A0A1J0AGK2,A0A2G9DT08,K9UEV4,Q9L1X1,A0A060HNJ0,A0A235B542,A0A1H3LE92,A0A496APJ8,A0A1V9G9U4,A0A1I2ZGP1,A0A317EJY3,A0A1I2BD20,F8ERC7,A0A1A5X8H4,A0A1I2T6Q1,A0A1R3T9N6,A0A0Q2M2Z1,H8KXJ0,D3S0S6,A0A2D1U4H7,I3TE64,A0A0B7I4Z6,A0LL61,A0A139WY18,A0A1J1EK56,A0A2T1E1K4,A0A1Q8ZD62,A0A4Q6XKV6,A0A1Z3HNN4,A0A239JE83,A0A2N4XBY2,Q53W94,R5JEI2,A0A0Q0ZC47,A0A2T0XH18,A0A1V4CHV0,A0A1K1RQP7,A0A1N6LUI7,A0A0P0NGR6,A0A1X7IML5,A0A0A2LKJ7,K1L112,A0A0U3AL92,A0A1H3A054,E0UCX3,A0A0C1VHB4,Q31N05,A0A0C5JKF3,R5NJJ8,A5D4D9,Q2JI93,A0A142Y7A9,A0A432MEQ5,A0A372DKU2,C1F5Q7,A0A4R3EV39,A0A1P8WP90,A0A222F7P0,A0A1C9VH88,A0A2T2YMB1,A0A329TD61,A0A101R2A0,A0A1U9ND56,A0A4R7BQC4,A0A1Q1FPH0,E0TGY3,A0A259TUP4,F6EYI8,A0A2S9Q9J0,A0A4Q2UIU6,A0A1H0LH25,A0A318LG42,L0JS08,A0A345E7N0,M0AF24,A0A1H3X247,M0D2X3,A0A2R5G167,A0A346PK63,R7RTW6,B9LVP8,M5RSF0,W0JW77,B7K585,F8D8G0,A0A343TL88,L0AJX6,A0A2A5QS34,A0A343JEE2,A0A3P3RGE5,A0A329TBQ3,A0A285N2A8,A0A0W1S8B8,A0A1V4C8L7,L9VRQ2,E4NRV1,A0A1I6HGN0,,",366,37
"1018","C.H10.11","C.H10.13",304,178,126,1.6498127340824,"4F1N,4F3T,4KRE,5GUH,5VM9,6KR6,6OON,7KX7,7SWF,A0A163JTZ6,J9D5G4,Q389P5,C4LVV2,A0A2P6N8X7,A8BCK6,A2DPV7,A0A0G4H2S4,R1FDF0,D2VMG4,A0A074TLL7,A0A0D1ZAJ4,Q1K660,F4PH46,A0A3M7S814,A0A164ZA52,Q54G64,S7WCF7,I0YVB2,R7QGN7,C1DZY0,A0A2C5Z0M1,A0CB11,R9ACY5,D3BMP8,A0A1Z5TVE5,W7XD45,A0A1U7LLR0,A0A4S2MWZ7,K1VVQ6,A0A158P1R9,G7DVX0,V6R0U9,G4N9J3,E3KLI3,B7Q5I1,A0A1E3QC61,D5GGK8,S8ANP9,A0A139AUH8,L2GMR6,U4LBG4,A0A177URI1,O74957,A0A3N4IGK1,A6N7Y9,A0A0E9NDK5,T1KZ60,A0A250WXN5,A0A2G8JLH3,Q5KAT1,L2GUF2,W2T741,A0A1W0E4B5,A0A2J7QB22,S4RYE2,A0A2K3CW87,A0A388KES6,A0A226EFL3,A0A3S3PD82,A0A0L0TEV1,A0A1S3J512,G0QTT2,A0A1J1HRI1,C4V9J2,Q9JMB7,A0A075AN09,Q5TW24,U5HIG6,A0A401PRI6,Q96J94,A0A2B4RHN2,G2QEV0,A0A397UU01,A0A2T7PFL8,K7ISV0,A0A024FT57,H3HCL6,A0A0G4IME3,E9FUN9,A0A1S3CYL5,D7FQK3,A0A1Y1YHC8,T1GSU4,F4S231,A0A1D8PMK0,A0A2G5B1D8,Q5BD61,A0A1C7M8P2,A0A4D8YSQ3,A0A158PJG6,J9JZ66,A0A0C2XG51,A0A158QZT6,A0A165QYQ9,T0SAU8,R7YY92,A0A3S1A0C3,A0A074YJ47,A0A2K1J482,A0A1Q3ENA6,O04379,A0A371I3C8,M8AEW7,A8P0D4,A0A2K3NY65,F4NYW7,A0A409Y6G2,A0A0L0HAB7,D8PZT7,A0A1D1W4K0,A7RQ46,W4YU94,A7BJS5,D8SNM6,A0A1J8PPA3,X1WG39,M5FQK2,Q69VD5,A0A2R6NSC2,A0A0D8XL16,A0A016WPN3,Q9QZ81,G5EES3,A0A0K0EFP6,Q8CJG0,A0A1D5NTU6,V2WTL2,A0A0V0YLH8,A0A139WDH0,A0A0R3W9Q7,H3DS31,A0A1Y1HWP2,G4T5G9,B7QCC4,A0A0B2UV00,M7BCJ9,E9GN30,Q7PZ41,A0A077Z361,R7U9I3,A0A1X7V1N5,A0A0K0JDP1,A0A0N4UKJ1,A0A498N3A3,A0A3M0IQP5,A0A0L8GBV4,Q32KD4,A0A1J1JBJ0,E0W4C3,A0A482XDA9,A0A3P7EJD6,J9K2Z4,A0A2J7Q8V4,T1IBM6,V3ZRX0,A0A210QKF7,A0A423TSS1,K1PT78,A0A267E8R7,A0A1D2N447,A0A226D7A9,F6YK55,T1KTE4,A0A2C9JGZ6,A0A1V9X9F0,K5X5Z7,A0A3Q0KUG5,T1FY40,1YVU,1Z26,5AWH,5G5T,5I4A,6QZK,A0A1I7IXT4,A0A2W1JZ37,A0A2S7WBN3,A0A328VKE4,A0A420DFE6,E0ST67,A0A4V1VDY2,A0A368P5I0,C4L1M1,A0A4R1RMM2,A0A1Y2RDH8,Q11QW7,A0A1M5ZSR3,A0A0K8QX04,A0A0M2PXX3,A0A1L3JHM3,A0A1W6MIP2,A0A1C0UUC4,A0A2U2J9E0,B1XJG0,A0A326U7G5,A0A3D8L290,H1KXR6,A0A1Q4R485,A0A097QRL6,K9RC91,A0A1T4Y3A2,B6YTQ5,A0A0B0H9B4,R6KUL9,A0A433NB65,K9UQR0,K9VUN0,B7GJX9,K9ZDE3,B0JXD6,A0A2T1LS63,A0A1Z4K1Y3,A0A1N6SSK9,A0A0P4UVI8,A0A1J0AGK2,A0A2G9DT08,K9UEV4,Q9L1X1,A0A060HNJ0,A0A235B542,A0A496APJ8,A0A1V9G9U4,A0A1A5X8H4,A0A1I2T6Q1,A0A0Q2M2Z1,H8KXJ0,A0A2D1U4H7,I3TE64,A0A0B7I4Z6,A0LL61,A0A139WY18,A0A1J1EK56,A0A2T1E1K4,A0A1Q8ZD62,A0A4Q6XKV6,A0A1Z3HNN4,A0A239JE83,A0A2N4XBY2,Q53W94,R5JEI2,A0A2T0XH18,A0A1V4CHV0,A0A1K1RQP7,A0A1N6LUI7,A0A0P0NGR6,A0A1X7IML5,A0A0A2LKJ7,K1L112,A0A0U3AL92,A0A1H3A054,E0UCX3,K9XZC6,A0A0C1VHB4,A0A0C5JKF3,R5NJJ8,A5D4D9,A0A142Y7A9,A0A432MEQ5,A0A372DKU2,C1F5Q7,A0A4R3EV39,A0A1P8WP90,A0A222F7P0,A0A1C9VH88,A0A2T2YMB1,A0A101R2A0,A0A1U9ND56,A0A4R7BQC4,E0TGY3,A0A259TUP4,F6EYI8,A0A2S9Q9J0,A0A4Q2UIU6,A0A1H0LH25,A0A318LG42,L0JS08,M0AF24,M0D2X3,A0A2R5G167,A0A346PK63,M5RSF0,W0JW77,B7K585,F8D8G0,A0A343TL88,L0AJX6,A0A3P3RGE5,A0A329TBQ3,A0A285N2A8,A0A0W1S8B8,A0A1V4C8L7,L9VRQ2,E4NRV1,A0A1I6HGN0,,",366,37
"1019","C.H10.2","C.H10.6",334,178,156,6.12849322961683,"4F1N,4F3T,4KRE,5GUH,5VM9,6KR6,6OON,7KX7,7SWF,A0A163JTZ6,A0A196SDB4,J9D5G4,C4LVV2,A0A2P6N8X7,A8BCK6,A2DPV7,A0A0G4H2S4,R1FDF0,D2VMG4,A0A074TLL7,A0A0D1ZAJ4,Q1K660,F4PH46,A0A3M7S814,A0A164ZA52,Q54G64,S7WCF7,I0YVB2,R7QGN7,C1DZY0,A0A2C5Z0M1,A0CB11,R9ACY5,D3BMP8,A0A1Z5TVE5,W7XD45,A0A1U7LLR0,A0A4S2MWZ7,K1VVQ6,A0A158P1R9,G7DVX0,V6R0U9,G4N9J3,E3KLI3,B7Q5I1,A0A1E3QC61,D5GGK8,S8ANP9,A0A139AUH8,L2GMR6,U4LBG4,A0A177URI1,O74957,A0A3N4IGK1,A6N7Y9,A0A0E9NDK5,T1KZ60,A0A250WXN5,A0A2G8JLH3,Q5KAT1,L2GUF2,W2T741,A0A1W0E4B5,A0A2J7QB22,S4RYE2,A0A2K3CW87,A0A388KES6,A0A226EFL3,A0A3S3PD82,A0A0L0TEV1,A0A1S3J512,G0QTT2,A0A1J1HRI1,C4V9J2,Q9JMB7,A0A075AN09,Q5TW24,U5HIG6,A0A401PRI6,Q96J94,A0A2B4RHN2,G2QEV0,A0A397UU01,A0A2T7PFL8,K7ISV0,A0A024FT57,H3HCL6,A0A0G4IME3,E9FUN9,A0A1S3CYL5,D7FQK3,A0A1Y1YHC8,T1GSU4,F4S231,A0A1D8PMK0,A0A2G5B1D8,Q5BD61,A0A1C7M8P2,A0A4D8YSQ3,A0A158PJG6,J9JZ66,A0A0C2XG51,A0A158QZT6,A0A165QYQ9,T0SAU8,R7YY92,A0A3S1A0C3,A0A074YJ47,A0A2K1J482,A0A1Q3ENA6,O04379,A0A371I3C8,M8AEW7,A8P0D4,A0A2K3NY65,F4NYW7,A0A409Y6G2,A0A0L0HAB7,D8PZT7,A0A1D1W4K0,A7RQ46,W4YU94,A7BJS5,D8SNM6,A0A1J8PPA3,X1WG39,M5FQK2,Q69VD5,A0A2R6NSC2,A0A0D8XL16,A0A016WPN3,Q9QZ81,G5EES3,A0A0K0EFP6,Q8CJG0,A0A1D5NTU6,V2WTL2,A0A0V0YLH8,A0A139WDH0,A0A0R3W9Q7,H3DS31,A0A1Y1HWP2,G4T5G9,B7QCC4,A0A0B2UV00,M7BCJ9,E9GN30,Q7PZ41,A0A077Z361,R7U9I3,A0A1X7V1N5,A0A0K0JDP1,A0A0N4UKJ1,A0A498N3A3,A0A3M0IQP5,A0A0L8GBV4,Q32KD4,A0A1J1JBJ0,E0W4C3,A0A482XDA9,A0A3P7EJD6,J9K2Z4,A0A2J7Q8V4,T1IBM6,V3ZRX0,A0A210QKF7,A0A423TSS1,K1PT78,A0A267E8R7,A0A1D2N447,A0A226D7A9,F6YK55,T1KTE4,A0A2C9JGZ6,A0A1V9X9F0,K5X5Z7,A0A3Q0KUG5,T1FY40,1Z26,5AWH,5G5T,5I4A,6QZK,7R8K,A0A1I7IXT4,A0A2W1JZ37,A0A2S7WBN3,A0A420DFE6,E0ST67,A0A4V1VDY2,A0A368P5I0,C4L1M1,A0A4R1RMM2,A0A1Y2RDH8,Q11QW7,A0A1M5ZSR3,A0A0K8QX04,A0A0M2PXX3,A0A1L3JHM3,A0A1W6MIP2,A0A1C0UUC4,A0A2U2J9E0,A0A2Z6E1D5,A0A0F4NXW8,A0A142XB92,L8D0R3,B1XJG0,A0A3D8L290,H1KXR6,A0A097QRL6,K9RC91,A0A1T4Y3A2,Q5P0R2,B6YTQ5,A0A0B0H9B4,R6KUL9,K9UQR0,B7GJX9,B0JXD6,A0A1Z4K1Y3,A0A2Z6E0R7,A0A1N6SSK9,A0A0P4UVI8,A0A1J0AGK2,A0A2G9DT08,K9UEV4,Q9L1X1,A0A060HNJ0,A0A235B542,R5XQK4,A0A1H3LE92,A0A496APJ8,A0A062U2W9,H0HWQ5,A0A1V9G9U4,A0A1I2ZGP1,A0A317EJY3,A0A1I2BD20,F8ERC7,A0A1A5X8H4,A0A1I2T6Q1,A0A1R3T9N6,A0A0Q2M2Z1,H8KXJ0,D3S0S6,A0A2D1U4H7,I3TE64,A0A0B7I4Z6,A0LL61,Q8DKB1,A0A139WY18,A0A1J1EK56,A0A2T1E1K4,A0A1Q8ZD62,A0A4Q6XKV6,A0A1Z3HNN4,A0A239JE83,A0A2N4XBY2,Q53W94,R5JEI2,A0A0Q0ZC47,A0A2T0XH18,A0A1V4CHV0,A0A1K1RQP7,A0A2T1EKT1,A0A1N6LUI7,A0A0P0NGR6,A0A1X7IML5,A0A0A2LKJ7,K1L112,A0A0U3AL92,A0A1H3A054,E0UCX3,K9XZC6,A0A0C1VHB4,Q31N05,A0A0C5JKF3,R5NJJ8,A5D4D9,Q2JI93,A0A142Y7A9,A0A432MEQ5,A0A372DKU2,A0A3R7KLK4,C1F5Q7,A0A4R3EV39,A0A1P8WP90,A0A222F7P0,A0A1C9VH88,A0A2T2YMB1,A0A329TD61,A0A101R2A0,A0A1E3XF49,A0A1U9ND56,A0A4R7BQC4,A0A1H3DGN3,A0A1Q1FPH0,E0TGY3,A0A259TUP4,F6EYI8,A0A2S9Q9J0,A0A4Q2UIU6,A0A1H0LH25,A0A318LG42,L0JS08,A0A345E7N0,M0AF24,A0A1W2A082,A0A1H3X247,A0A0C1XUA0,M0D2X3,A0A2R5G167,A0A346PK63,R7RTW6,A0A1H2RBI2,A0A1C3ZXN2,B9LVP8,M5RSF0,W0JW77,B7K585,F8D8G0,A0A343TL88,L0AJX6,A0A2A5QS34,A0A343JEE2,A0A3P3RGE5,A0A329TBQ3,A0A285N2A8,A0A0W1S8B8,A0A1V4C8L7,L9VRQ2,E4NRV1,A0A1I6HGN0,A0A1I0NI68,,",366,37
"1020","C.H10.2","C.H9.12",351,178,173,2.88979996103137,"4F1N,4F3T,4KRE,5GUH,6KR6,6OON,7KX7,7SWF,A0A163JTZ6,J9D5G4,Q389P5,C4LVV2,A0A2P6N8X7,A8BCK6,A2DPV7,A0A0G4H2S4,R1FDF0,D2VMG4,A0A074TLL7,A0A0D1ZAJ4,Q1K660,F4PH46,A0A3M7S814,A0A164ZA52,A0A383WDW5,Q54G64,S7WCF7,I0YVB2,R7QGN7,C1DZY0,A0A2C5Z0M1,A0CB11,R9ACY5,D3BMP8,A0A1Z5TVE5,W7XD45,A0A1U7LLR0,A0A4S2MWZ7,K1VVQ6,A0A158P1R9,G7DVX0,V6R0U9,G4N9J3,E3KLI3,B7Q5I1,A0A1E3QC61,D5GGK8,S8ANP9,A0A139AUH8,L2GMR6,U4LBG4,A0A177URI1,O74957,A0A3N4IGK1,A6N7Y9,A0A0E9NDK5,T1KZ60,A0A250WXN5,A0A2G8JLH3,Q5KAT1,L2GUF2,W2T741,A0A1W0E4B5,A0A2J7QB22,S4RYE2,A0A2K3CW87,A0A388KES6,A0A226EFL3,A0A3S3PD82,A0A0L0TEV1,A0A1S3J512,G0QTT2,A0A1J1HRI1,C4V9J2,Q9JMB7,A0A075AN09,Q5TW24,U5HIG6,A0A401PRI6,Q96J94,A0A2B4RHN2,G2QEV0,A0A397UU01,A0A2T7PFL8,K7ISV0,A0A024FT57,H3HCL6,A0A0G4IME3,E9FUN9,A0A1S3CYL5,D7FQK3,A0A1Y1YHC8,T1GSU4,F4S231,A0A1D8PMK0,A0A2G5B1D8,Q5BD61,A0A1C7M8P2,A0A4D8YSQ3,A0A158PJG6,J9JZ66,A0A0C2XG51,A0A158QZT6,A0A165QYQ9,T0SAU8,R7YY92,A0A3S1A0C3,A0A074YJ47,A0A2K1J482,A0A1Q3ENA6,O04379,A0A371I3C8,M8AEW7,A8P0D4,A0A2K3NY65,F4NYW7,A0A409Y6G2,A0A0L0HAB7,D8PZT7,A0A1D1W4K0,A7RQ46,W4YU94,A7BJS5,D8SNM6,A0A1J8PPA3,X1WG39,M5FQK2,Q69VD5,A0A2R6NSC2,A0A0D8XL16,A0A016WPN3,Q9QZ81,G5EES3,A0A0K0EFP6,Q8CJG0,A0A1D5NTU6,V2WTL2,A0A0V0YLH8,A0A139WDH0,A0A0R3W9Q7,H3DS31,A0A1Y1HWP2,G4T5G9,B7QCC4,A0A0B2UV00,M7BCJ9,E9GN30,Q7PZ41,A0A077Z361,R7U9I3,A0A1X7V1N5,A0A0K0JDP1,A0A0N4UKJ1,A0A498N3A3,A0A3M0IQP5,A0A0L8GBV4,Q32KD4,A0A1J1JBJ0,E0W4C3,A0A482XDA9,A0A3P7EJD6,J9K2Z4,A0A2J7Q8V4,T1IBM6,V3ZRX0,A0A210QKF7,A0A423TSS1,K1PT78,A0A267E8R7,A0A1D2N447,A0A226D7A9,F6YK55,T1KTE4,A0A2C9JGZ6,A0A1V9X9F0,K5X5Z7,A0A3Q0KUG5,T1FY40,1YVU,1Z26,5AWH,5G5T,5I4A,6QZK,7R8K,A0A1I7IXT4,A0A2W1JZ37,A0A2S7WBN3,A0A328VKE4,A0A420DFE6,A0A4V1VDY2,A0A368P5I0,C4L1M1,A0A4R1RMM2,A0A1Y2RDH8,Q11QW7,A0A1M5ZSR3,A0A0K8QX04,A0A0M2PXX3,K9TPA9,A0A1L3JHM3,A0A1W6MIP2,A0A1C0UUC4,A0A2U2J9E0,A0A2Z6E1D5,A0A0F4NXW8,L8D0R3,B1XJG0,A0A326U7G5,A0A3D8L290,H1KXR6,A0A1Q4R485,K9U8J6,A0A097QRL6,K9RC91,A0A0D8ZUC0,A0A139XGN8,A0A1T4Y3A2,Q5P0R2,B6YTQ5,A0A0B0H9B4,A0YYT3,A0A2T1EFY0,G6FTN0,R6KUL9,A0A433NB65,A0A1Z4L0A1,K9UQR0,A0A2T1G8M7,K9VUN0,B7GJX9,K9ZDE3,B0JXD6,A0A2T1LS63,A0A1Z4K1Y3,A0A2Z6E0R7,A0A1N6SSK9,A0A0P4UVI8,A0A0V7ZCG4,A0A1J0AGK2,K9PFF9,A0A2G9DT08,K9UEV4,Q9L1X1,A0A060HNJ0,A0A235B542,R5XQK4,A0A1H3LE92,A0A496APJ8,A0A062U2W9,H0HWQ5,A0A1V9G9U4,A0A1I2ZGP1,A0A317EJY3,A0A1I2BD20,F8ERC7,A0A1A5X8H4,A0A1I2T6Q1,A0A1R3T9N6,A0A0Q2M2Z1,H8KXJ0,D3S0S6,A0A2D1U4H7,I3TE64,A0A0B7I4Z6,A0LL61,Q8DKB1,A0A139WY18,A0A1J1EK56,A0A2T1E1K4,A0A1Q8ZD62,A0A4Q6XKV6,A0A1Z3HNN4,A0A239JE83,A0A2N4XBY2,Q53W94,R5JEI2,A0A0Q0ZC47,A0A2T0XH18,A0A1V4CHV0,A0A1K1RQP7,A0A2T1EKT1,A0A1N6LUI7,A0A0P0NGR6,A0A1X7IML5,A0A0A2LKJ7,K1L112,A0A0U3AL92,A0A1H3A054,E0UCX3,K9XZC6,A0A0C1VHB4,Q31N05,A0A0C5JKF3,R5NJJ8,A5D4D9,Q2JI93,A0A142Y7A9,A0A432MEQ5,A0A372DKU2,C1F5Q7,A0A4R3EV39,A0A1P8WP90,A0A222F7P0,A0A1C9VH88,A0A2T2YMB1,A0A329TD61,A0A101R2A0,A0A1E3XF49,A0A1U9ND56,A0A4R7BQC4,A0A1H3DGN3,A0A1Q1FPH0,E0TGY3,A0A259TUP4,F6EYI8,A0A2S9Q9J0,A0A4Q2UIU6,A0A1H0LH25,A0A318LG42,H1YCU5,L0JS08,A0A345E7N0,M0AF24,A0A1W2A082,A0A1H3X247,A0A0C1XUA0,M0D2X3,A0A2R5G167,A0A346PK63,R7RTW6,A0A1H2RBI2,A0A1C3ZXN2,B9LVP8,M5RSF0,W0JW77,B7K585,F8D8G0,A0A343TL88,L0AJX6,A0A2A5QS34,A0A343JEE2,A0A3P3RGE5,A0A329TBQ3,A0A285N2A8,A0A0W1S8B8,A0A1V4C8L7,L9VRQ2,E4NRV1,A0A1I6HGN0,A0A1I0NI68,,",366,37
"1021","C.H10.3","C.S8.5",344,178,166,2.93715310680926,"4F1N,4F3T,4KRE,5GUH,5VM9,6KR6,6OON,7KX7,7SWF,A0A163JTZ6,J9D5G4,Q389P5,C4LVV2,A0A2P6N8X7,A8BCK6,A2DPV7,A0A0G4H2S4,R1FDF0,D2VMG4,A0A074TLL7,A0A0D1ZAJ4,Q1K660,F4PH46,A0A3M7S814,A0A164ZA52,Q54G64,S7WCF7,I0YVB2,R7QGN7,C1DZY0,A0A2C5Z0M1,A0CB11,R9ACY5,D3BMP8,A0A1Z5TVE5,W7XD45,A0A1U7LLR0,A0A4S2MWZ7,K1VVQ6,A0A158P1R9,G7DVX0,V6R0U9,G4N9J3,E3KLI3,B7Q5I1,A0A1E3QC61,D5GGK8,S8ANP9,A0A139AUH8,L2GMR6,U4LBG4,A0A177URI1,O74957,A0A3N4IGK1,A6N7Y9,A0A0E9NDK5,T1KZ60,A0A250WXN5,A0A2G8JLH3,Q5KAT1,L2GUF2,W2T741,A0A1W0E4B5,A0A2J7QB22,S4RYE2,A0A2K3CW87,A0A388KES6,A0A226EFL3,A0A3S3PD82,A0A0L0TEV1,A0A1S3J512,G0QTT2,A0A1J1HRI1,C4V9J2,Q9JMB7,A0A075AN09,Q5TW24,U5HIG6,A0A401PRI6,Q96J94,A0A2B4RHN2,G2QEV0,A0A397UU01,A0A2T7PFL8,K7ISV0,A0A024FT57,H3HCL6,A0A0G4IME3,E9FUN9,A0A1S3CYL5,D7FQK3,A0A1Y1YHC8,T1GSU4,F4S231,A0A1D8PMK0,A0A2G5B1D8,Q5BD61,A0A1C7M8P2,A0A4D8YSQ3,A0A158PJG6,J9JZ66,A0A0C2XG51,A0A158QZT6,A0A165QYQ9,T0SAU8,R7YY92,A0A3S1A0C3,A0A074YJ47,A0A2K1J482,A0A1Q3ENA6,O04379,A0A371I3C8,M8AEW7,A8P0D4,A0A2K3NY65,F4NYW7,A0A409Y6G2,A0A0L0HAB7,D8PZT7,A0A1D1W4K0,A7RQ46,W4YU94,A7BJS5,D8SNM6,A0A1J8PPA3,X1WG39,M5FQK2,Q69VD5,A0A2R6NSC2,A0A0D8XL16,A0A016WPN3,Q9QZ81,G5EES3,A0A0K0EFP6,Q8CJG0,A0A1D5NTU6,V2WTL2,A0A0V0YLH8,A0A139WDH0,A0A0R3W9Q7,H3DS31,A0A1Y1HWP2,G4T5G9,B7QCC4,A0A0B2UV00,M7BCJ9,E9GN30,Q7PZ41,A0A077Z361,R7U9I3,A0A1X7V1N5,A0A0K0JDP1,A0A0N4UKJ1,A0A498N3A3,A0A3M0IQP5,A0A0L8GBV4,Q32KD4,A0A1J1JBJ0,E0W4C3,A0A482XDA9,A0A3P7EJD6,J9K2Z4,A0A2J7Q8V4,T1IBM6,V3ZRX0,A0A210QKF7,A0A423TSS1,K1PT78,A0A267E8R7,A0A1D2N447,A0A226D7A9,F6YK55,T1KTE4,A0A2C9JGZ6,A0A1V9X9F0,K5X5Z7,A0A3Q0KUG5,T1FY40,1YVU,1Z26,5AWH,5G5T,5I4A,A0A1I7IXT4,A0A2W1JZ37,A0A2S7WBN3,A0A328VKE4,A0A420DFE6,A0A4V1VDY2,A0A368P5I0,C4L1M1,A0A4R1RMM2,A0A1Y2RDH8,Q11QW7,A0A1M5ZSR3,A0A0K8QX04,A0A0M2PXX3,K9TPA9,A0A1L3JHM3,A0A1W6MIP2,A0A1C0UUC4,A0A2U2J9E0,A0A2Z6E1D5,A0A0F4NXW8,A0A142XB92,L8D0R3,B1XJG0,A0A326U7G5,A0A3D8L290,H1KXR6,A0A1Q4R485,K9U8J6,A0A097QRL6,K9RC91,A0A0D8ZUC0,A0A139XGN8,A0A1T4Y3A2,Q5P0R2,B6YTQ5,A0A0B0H9B4,A0YYT3,A0A2T1EFY0,G6FTN0,R6KUL9,A0A433NB65,A0A1Z4L0A1,K9UQR0,A0A2T1G8M7,K9VUN0,K9ZDE3,B0JXD6,A0A2T1LS63,A0A1Z4K1Y3,A0A2Z6E0R7,A0A1N6SSK9,A0A0P4UVI8,A0A0V7ZCG4,A0A1J0AGK2,K9PFF9,A0A2G9DT08,K9UEV4,Q9L1X1,A0A060HNJ0,A0A235B542,R5XQK4,A0A1H3LE92,A0A496APJ8,A0A062U2W9,H0HWQ5,A0A1V9G9U4,A0A1I2ZGP1,A0A1I2BD20,F8ERC7,A0A1A5X8H4,A0A1I2T6Q1,A0A1R3T9N6,A0A0Q2M2Z1,H8KXJ0,D3S0S6,A0A2D1U4H7,I3TE64,A0A0B7I4Z6,A0LL61,Q8DKB1,A0A139WY18,A0A1J1EK56,A0A2T1E1K4,A0A1Q8ZD62,A0A4Q6XKV6,A0A1Z3HNN4,A0A239JE83,A0A2N4XBY2,Q53W94,R5JEI2,A0A0Q0ZC47,A0A2T0XH18,A0A1V4CHV0,A0A1K1RQP7,A0A1N6LUI7,A0A0P0NGR6,A0A1X7IML5,A0A0A2LKJ7,K1L112,A0A0U3AL92,A0A1H3A054,E0UCX3,K9XZC6,A0A0C1VHB4,A0A0C5JKF3,R5NJJ8,A5D4D9,Q2JI93,A0A142Y7A9,A0A432MEQ5,A0A372DKU2,A0A3R7KLK4,C1F5Q7,A0A4R3EV39,A0A1P8WP90,A0A222F7P0,A0A1C9VH88,A0A2T2YMB1,A0A329TD61,A0A101R2A0,A0A1U9ND56,A0A4R7BQC4,A0A1H3DGN3,A0A1Q1FPH0,E0TGY3,A0A259TUP4,F6EYI8,A0A2S9Q9J0,A0A4Q2UIU6,A0A1H0LH25,A0A318LG42,H1YCU5,L0JS08,A0A345E7N0,M0AF24,A0A1W2A082,A0A1H3X247,A0A0C1XUA0,M0D2X3,A0A2R5G167,A0A346PK63,R7RTW6,B9LVP8,M5RSF0,W0JW77,B7K585,F8D8G0,A0A343TL88,L0AJX6,A0A2A5QS34,A0A343JEE2,A0A3P3RGE5,A0A329TBQ3,A0A285N2A8,A0A0W1S8B8,A0A1V4C8L7,L9VRQ2,E4NRV1,A0A1I6HGN0,A0A1I0NI68,,",366,37
"1022","C.H10.4","C.H10.6",350,178,172,1.9190945910635,"4F1N,4F3T,4KRE,5GUH,5VM9,6KR6,6OON,7KX7,7SWF,A0A163JTZ6,J9D5G4,C4LVV2,A0A2P6N8X7,A8BCK6,A2DPV7,A0A0G4H2S4,R1FDF0,D2VMG4,A0A074TLL7,A0A0D1ZAJ4,Q1K660,F4PH46,A0A3M7S814,A0A164ZA52,A0A383WDW5,Q54G64,S7WCF7,I0YVB2,R7QGN7,C1DZY0,A0A2C5Z0M1,A0CB11,R9ACY5,D3BMP8,A0A1Z5TVE5,W7XD45,A0A1U7LLR0,A0A4S2MWZ7,K1VVQ6,A0A158P1R9,G7DVX0,V6R0U9,G4N9J3,E3KLI3,B7Q5I1,A0A1E3QC61,D5GGK8,S8ANP9,A0A139AUH8,L2GMR6,U4LBG4,A0A177URI1,O74957,A0A3N4IGK1,A6N7Y9,A0A0E9NDK5,T1KZ60,A0A250WXN5,A0A2G8JLH3,Q5KAT1,L2GUF2,W2T741,A0A1W0E4B5,A0A2J7QB22,S4RYE2,A0A2K3CW87,A0A388KES6,A0A226EFL3,A0A3S3PD82,A0A0L0TEV1,A0A1S3J512,G0QTT2,A0A1J1HRI1,C4V9J2,Q9JMB7,A0A075AN09,Q5TW24,U5HIG6,A0A401PRI6,Q96J94,A0A2B4RHN2,G2QEV0,A0A397UU01,A0A2T7PFL8,K7ISV0,A0A024FT57,H3HCL6,A0A0G4IME3,E9FUN9,A0A1S3CYL5,D7FQK3,A0A1Y1YHC8,T1GSU4,F4S231,A0A1D8PMK0,A0A2G5B1D8,Q5BD61,A0A1C7M8P2,A0A4D8YSQ3,A0A158PJG6,J9JZ66,A0A0C2XG51,A0A158QZT6,A0A165QYQ9,T0SAU8,R7YY92,A0A3S1A0C3,A0A074YJ47,A0A2K1J482,A0A1Q3ENA6,O04379,A0A371I3C8,M8AEW7,A8P0D4,A0A2K3NY65,F4NYW7,A0A409Y6G2,A0A0L0HAB7,D8PZT7,A0A1D1W4K0,A7RQ46,W4YU94,A7BJS5,D8SNM6,A0A1J8PPA3,X1WG39,M5FQK2,Q69VD5,A0A2R6NSC2,A0A0D8XL16,A0A016WPN3,Q9QZ81,G5EES3,A0A0K0EFP6,Q8CJG0,A0A1D5NTU6,V2WTL2,A0A0V0YLH8,A0A139WDH0,A0A0R3W9Q7,H3DS31,A0A1Y1HWP2,G4T5G9,B7QCC4,A0A0B2UV00,M7BCJ9,E9GN30,Q7PZ41,A0A077Z361,R7U9I3,A0A1X7V1N5,A0A0K0JDP1,A0A0N4UKJ1,A0A498N3A3,A0A3M0IQP5,A0A0L8GBV4,Q32KD4,A0A1J1JBJ0,E0W4C3,A0A482XDA9,A0A3P7EJD6,J9K2Z4,A0A2J7Q8V4,T1IBM6,V3ZRX0,A0A210QKF7,A0A423TSS1,K1PT78,A0A267E8R7,A0A1D2N447,A0A226D7A9,F6YK55,T1KTE4,A0A2C9JGZ6,A0A1V9X9F0,K5X5Z7,A0A3Q0KUG5,T1FY40,1YVU,1Z26,5AWH,5G5T,5I4A,6QZK,7R8K,A0A1I7IXT4,A0A2W1JZ37,A0A2S7WBN3,A0A328VKE4,A0A420DFE6,A0A4V1VDY2,A0A368P5I0,C4L1M1,A0A4R1RMM2,A0A1Y2RDH8,Q11QW7,A0A1M5ZSR3,A0A0K8QX04,A0A0M2PXX3,K9TPA9,A0A1L3JHM3,A0A1W6MIP2,A0A1C0UUC4,A0A2U2J9E0,A0A2Z6E1D5,A0A0F4NXW8,A0A142XB92,L8D0R3,B1XJG0,A0A326U7G5,A0A3D8L290,H1KXR6,A0A1Q4R485,K9U8J6,A0A097QRL6,K9RC91,A0A0D8ZUC0,A0A139XGN8,A0A1T4Y3A2,Q5P0R2,B6YTQ5,A0A0B0H9B4,A0YYT3,A0A2T1EFY0,G6FTN0,R6KUL9,A0A433NB65,K9UQR0,A0A2T1G8M7,K9VUN0,B7GJX9,K9ZDE3,B0JXD6,A0A2T1LS63,A0A1Z4K1Y3,A0A2Z6E0R7,A0A1N6SSK9,A0A0P4UVI8,A0A0V7ZCG4,A0A1J0AGK2,A0A2G9DT08,K9UEV4,Q9L1X1,A0A060HNJ0,A0A235B542,R5XQK4,A0A1H3LE92,A0A496APJ8,A0A062U2W9,H0HWQ5,A0A1V9G9U4,A0A1I2ZGP1,A0A317EJY3,A0A1I2BD20,F8ERC7,A0A1A5X8H4,A0A1I2T6Q1,A0A1R3T9N6,A0A0Q2M2Z1,H8KXJ0,D3S0S6,A0A2D1U4H7,I3TE64,A0A0B7I4Z6,A0LL61,Q8DKB1,A0A139WY18,A0A1J1EK56,A0A2T1E1K4,A0A1Q8ZD62,A0A4Q6XKV6,A0A1Z3HNN4,A0A239JE83,A0A2N4XBY2,Q53W94,R5JEI2,A0A0Q0ZC47,A0A2T0XH18,A0A1V4CHV0,A0A1K1RQP7,A0A2T1EKT1,A0A1N6LUI7,A0A0P0NGR6,A0A1X7IML5,A0A0A2LKJ7,K1L112,A0A0U3AL92,A0A1H3A054,E0UCX3,K9XZC6,A0A0C1VHB4,Q31N05,A0A0C5JKF3,R5NJJ8,A5D4D9,Q2JI93,A0A142Y7A9,A0A432MEQ5,A0A372DKU2,A0A3R7KLK4,C1F5Q7,A0A4R3EV39,A0A1P8WP90,A0A222F7P0,A0A1C9VH88,A0A2T2YMB1,A0A329TD61,A0A101R2A0,A0A1E3XF49,A0A1U9ND56,A0A4R7BQC4,A0A1H3DGN3,A0A1Q1FPH0,E0TGY3,A0A259TUP4,F6EYI8,A0A2S9Q9J0,A0A4Q2UIU6,A0A1H0LH25,A0A318LG42,L0JS08,A0A345E7N0,M0AF24,A0A1W2A082,A0A1H3X247,A0A0C1XUA0,M0D2X3,A0A2R5G167,A0A346PK63,R7RTW6,A0A1H2RBI2,A0A1C3ZXN2,B9LVP8,M5RSF0,W0JW77,B7K585,F8D8G0,A0A343TL88,L0AJX6,A0A2A5QS34,A0A343JEE2,A0A3P3RGE5,A0A329TBQ3,A0A285N2A8,A0A0W1S8B8,A0A1V4C8L7,L9VRQ2,E4NRV1,A0A1I6HGN0,A0A1I0NI68,,",366,37
"1023","C.H10.5","C.H10.7",349,178,171,1.95075234903739,"4F1N,4F3T,4KRE,5GUH,5VM9,6KR6,6OON,7KX7,7SWF,A0A163JTZ6,J9D5G4,C4LVV2,A0A2P6N8X7,A8BCK6,A2DPV7,A0A0G4H2S4,R1FDF0,D2VMG4,A0A074TLL7,A0A0D1ZAJ4,Q1K660,F4PH46,A0A3M7S814,A0A164ZA52,A0A383WDW5,Q54G64,S7WCF7,I0YVB2,R7QGN7,C1DZY0,A0A2C5Z0M1,A0CB11,R9ACY5,D3BMP8,A0A1Z5TVE5,W7XD45,A0A1U7LLR0,A0A4S2MWZ7,K1VVQ6,A0A158P1R9,G7DVX0,V6R0U9,G4N9J3,E3KLI3,B7Q5I1,A0A1E3QC61,D5GGK8,S8ANP9,A0A139AUH8,L2GMR6,U4LBG4,A0A177URI1,O74957,A0A3N4IGK1,A6N7Y9,A0A0E9NDK5,T1KZ60,A0A250WXN5,A0A2G8JLH3,Q5KAT1,L2GUF2,W2T741,A0A1W0E4B5,A0A2J7QB22,S4RYE2,A0A2K3CW87,A0A388KES6,A0A226EFL3,A0A3S3PD82,A0A0L0TEV1,A0A1S3J512,G0QTT2,A0A1J1HRI1,C4V9J2,Q9JMB7,A0A075AN09,Q5TW24,U5HIG6,A0A401PRI6,Q96J94,A0A2B4RHN2,G2QEV0,A0A397UU01,A0A2T7PFL8,K7ISV0,A0A024FT57,H3HCL6,A0A0G4IME3,E9FUN9,A0A1S3CYL5,D7FQK3,A0A1Y1YHC8,T1GSU4,F4S231,A0A1D8PMK0,A0A2G5B1D8,Q5BD61,A0A1C7M8P2,A0A4D8YSQ3,A0A158PJG6,J9JZ66,A0A0C2XG51,A0A158QZT6,A0A165QYQ9,T0SAU8,R7YY92,A0A3S1A0C3,A0A074YJ47,A0A2K1J482,A0A1Q3ENA6,O04379,A0A371I3C8,M8AEW7,A8P0D4,A0A2K3NY65,F4NYW7,A0A409Y6G2,A0A0L0HAB7,D8PZT7,A0A1D1W4K0,A7RQ46,W4YU94,A7BJS5,D8SNM6,A0A1J8PPA3,X1WG39,M5FQK2,Q69VD5,A0A2R6NSC2,A0A0D8XL16,A0A016WPN3,Q9QZ81,G5EES3,A0A0K0EFP6,Q8CJG0,A0A1D5NTU6,V2WTL2,A0A0V0YLH8,A0A139WDH0,A0A0R3W9Q7,H3DS31,A0A1Y1HWP2,G4T5G9,B7QCC4,A0A0B2UV00,M7BCJ9,E9GN30,Q7PZ41,A0A077Z361,R7U9I3,A0A1X7V1N5,A0A0K0JDP1,A0A0N4UKJ1,A0A498N3A3,A0A3M0IQP5,A0A0L8GBV4,Q32KD4,A0A1J1JBJ0,E0W4C3,A0A482XDA9,A0A3P7EJD6,J9K2Z4,A0A2J7Q8V4,T1IBM6,V3ZRX0,A0A210QKF7,A0A423TSS1,K1PT78,A0A267E8R7,A0A1D2N447,A0A226D7A9,F6YK55,T1KTE4,A0A2C9JGZ6,A0A1V9X9F0,K5X5Z7,A0A3Q0KUG5,T1FY40,1YVU,1Z26,5AWH,5G5T,5I4A,6QZK,7R8K,A0A1I7IXT4,A0A2W1JZ37,A0A2S7WBN3,A0A328VKE4,A0A420DFE6,A0A4V1VDY2,A0A368P5I0,C4L1M1,A0A4R1RMM2,A0A1Y2RDH8,Q11QW7,A0A1M5ZSR3,A0A0K8QX04,A0A0M2PXX3,K9TPA9,A0A1L3JHM3,A0A1W6MIP2,A0A1C0UUC4,A0A2U2J9E0,A0A2Z6E1D5,A0A0F4NXW8,A0A142XB92,L8D0R3,B1XJG0,A0A326U7G5,A0A3D8L290,H1KXR6,A0A1Q4R485,K9U8J6,A0A097QRL6,K9RC91,A0A0D8ZUC0,A0A139XGN8,A0A1T4Y3A2,B6YTQ5,A0A0B0H9B4,A0YYT3,A0A2T1EFY0,G6FTN0,R6KUL9,A0A433NB65,K9UQR0,A0A2T1G8M7,K9VUN0,B7GJX9,K9ZDE3,B0JXD6,A0A2T1LS63,A0A1Z4K1Y3,A0A2Z6E0R7,A0A1N6SSK9,A0A0P4UVI8,A0A0V7ZCG4,A0A1J0AGK2,A0A2G9DT08,K9UEV4,Q9L1X1,A0A060HNJ0,A0A235B542,R5XQK4,A0A1H3LE92,A0A496APJ8,A0A062U2W9,H0HWQ5,A0A1V9G9U4,A0A1I2ZGP1,A0A317EJY3,A0A1I2BD20,F8ERC7,A0A1A5X8H4,A0A1I2T6Q1,A0A1R3T9N6,A0A0Q2M2Z1,H8KXJ0,D3S0S6,A0A2D1U4H7,I3TE64,A0A0B7I4Z6,A0LL61,Q8DKB1,A0A139WY18,A0A1J1EK56,A0A2T1E1K4,A0A1Q8ZD62,A0A4Q6XKV6,A0A1Z3HNN4,A0A239JE83,A0A2N4XBY2,Q53W94,R5JEI2,A0A0Q0ZC47,A0A2T0XH18,A0A1V4CHV0,A0A1K1RQP7,A0A2T1EKT1,A0A1N6LUI7,A0A0P0NGR6,A0A1X7IML5,A0A0A2LKJ7,K1L112,A0A0U3AL92,A0A1H3A054,E0UCX3,K9XZC6,A0A0C1VHB4,Q31N05,A0A0C5JKF3,R5NJJ8,A5D4D9,Q2JI93,A0A142Y7A9,A0A432MEQ5,A0A372DKU2,A0A3R7KLK4,C1F5Q7,A0A4R3EV39,A0A1P8WP90,A0A222F7P0,A0A1C9VH88,A0A2T2YMB1,A0A329TD61,A0A101R2A0,A0A1E3XF49,A0A1U9ND56,A0A4R7BQC4,A0A1H3DGN3,A0A1Q1FPH0,E0TGY3,A0A259TUP4,F6EYI8,A0A2S9Q9J0,A0A4Q2UIU6,A0A1H0LH25,A0A318LG42,L0JS08,A0A345E7N0,M0AF24,A0A1W2A082,A0A1H3X247,A0A0C1XUA0,M0D2X3,A0A2R5G167,A0A346PK63,R7RTW6,A0A1H2RBI2,A0A1C3ZXN2,B9LVP8,M5RSF0,W0JW77,B7K585,F8D8G0,A0A343TL88,L0AJX6,A0A2A5QS34,A0A343JEE2,A0A3P3RGE5,A0A329TBQ3,A0A285N2A8,A0A0W1S8B8,A0A1V4C8L7,L9VRQ2,E4NRV1,A0A1I6HGN0,A0A1I0NI68,,",366,37
"1026","C.H5.13","C.L11.2",337,178,159,4.32693802558123,"4F1N,4F3T,4KRE,5GUH,5VM9,6KR6,6OON,7KX7,A0A163JTZ6,A0A196SDB4,J9D5G4,C4LVV2,A0A2P6N8X7,A8BCK6,A0A0G4H2S4,T1H8B3,R1FDF0,S4RWI0,D2VMG4,A0A074TLL7,A0A0D1ZAJ4,Q1K660,F4PH46,A0A3M7S814,A0A164ZA52,A0A383WDW5,Q54G64,S7WCF7,I0YVB2,R7QGN7,C1DZY0,A0A2C5Z0M1,A0CB11,R9ACY5,D3BMP8,A0A1Z5TVE5,W7XD45,A0A1U7LLR0,A0A4S2MWZ7,K1VVQ6,A0A158P1R9,G7DVX0,V6R0U9,G4N9J3,E3KLI3,B7Q5I1,A0A1E3QC61,D5GGK8,S8ANP9,A0A139AUH8,L2GMR6,U4LBG4,A0A177URI1,O74957,A0A3N4IGK1,A6N7Y9,A0A0E9NDK5,T1KZ60,A0A250WXN5,A0A2G8JLH3,Q5KAT1,L2GUF2,W2T741,A0A1W0E4B5,A0A2J7QB22,S4RYE2,A0A2K3CW87,A0A388KES6,A0A226EFL3,A0A3S3PD82,A0A1S3J512,G0QTT2,A0A1J1HRI1,C4V9J2,Q9JMB7,A0A075AN09,Q5TW24,U5HIG6,A0A401PRI6,Q96J94,A0A2B4RHN2,G2QEV0,A0A397UU01,A0A2T7PFL8,K7ISV0,A0A024FT57,H3HCL6,A0A0G4IME3,E9FUN9,A0A1S3CYL5,D7FQK3,A0A1Y1YHC8,T1GSU4,F4S231,A0A1D8PMK0,A0A2G5B1D8,Q5BD61,A0A1C7M8P2,A0A4D8YSQ3,A0A158PJG6,J9JZ66,A0A0C2XG51,A0A158QZT6,A0A165QYQ9,T0SAU8,R7YY92,A0A3S1A0C3,A0A074YJ47,A0A2K1J482,A0A1Q3ENA6,O04379,A0A371I3C8,M8AEW7,A8P0D4,A0A2K3NY65,F4NYW7,A0A409Y6G2,A0A0L0HAB7,D8PZT7,A0A1D1W4K0,A7RQ46,W4YU94,A7BJS5,D8SNM6,A0A1J8PPA3,X1WG39,M5FQK2,Q69VD5,A0A2R6NSC2,A0A0D8XL16,A0A016WPN3,Q9QZ81,G5EES3,A0A0K0EFP6,Q8CJG0,A0A1D5NTU6,V2WTL2,A0A0V0YLH8,A0A139WDH0,A0A0R3W9Q7,H3DS31,A0A1Y1HWP2,G4T5G9,B7QCC4,A0A0B2UV00,M7BCJ9,E9GN30,Q7PZ41,A0A077Z361,R7U9I3,A0A1X7V1N5,A0A0K0JDP1,A0A0N4UKJ1,A0A498N3A3,A0A3M0IQP5,A0A0L8GBV4,Q32KD4,A0A1J1JBJ0,E0W4C3,A0A482XDA9,A0A3P7EJD6,J9K2Z4,A0A2J7Q8V4,T1IBM6,V3ZRX0,A0A210QKF7,A0A423TSS1,K1PT78,A0A267E8R7,A0A1D2N447,A0A226D7A9,F6YK55,T1KTE4,A0A2C9JGZ6,A0A1V9X9F0,K5X5Z7,A0A3Q0KUG5,T1FY40,1YVU,1Z26,3DLB,5AWH,5G5T,5I4A,6QZK,E8N0K8,A0A1I7IXT4,A0A2W1JZ37,A0A2S7WBN3,A0A328VKE4,A0A420DFE6,A0A4V1VDY2,A0A368P5I0,A0A4R1RMM2,A0A1Y2RDH8,Q11QW7,A0A1M5ZSR3,A0A0K8QX04,A0A0M2PXX3,K9TPA9,A0A1L3JHM3,A0A1W6MIP2,A0A1C0UUC4,A0A2U2J9E0,A0A2Z6E1D5,A0A0F4NXW8,B1XJG0,A0A326U7G5,A0A3D8L290,A0A1Q4R485,K9U8J6,A0A097QRL6,K9RC91,A0A0D8ZUC0,A0A139XGN8,A0A1T4Y3A2,Q5P0R2,B6YTQ5,A0YYT3,A0A2T1EFY0,G6FTN0,A0A433NB65,A0A1Z4L0A1,K9UQR0,A0A2T1G8M7,K9VUN0,K9ZDE3,B0JXD6,A0A2T1LS63,A0A1Z4K1Y3,A0A2Z6E0R7,A0A0P4UVI8,A0A0V7ZCG4,A0A1J0AGK2,K9PFF9,A0A2G9DT08,K9UEV4,Q9L1X1,A0A1H3LE92,A0A496APJ8,A0A1V9G9U4,S7VLM7,A0A1A5X8H4,A0A1I2T6Q1,A0A1R3T9N6,A0A0Q2M2Z1,H8KXJ0,D3S0S6,A0A2D1U4H7,I3TE64,A0A0B7I4Z6,A0LL61,Q8DKB1,A0A139WY18,A0A1J1EK56,A0A2T1E1K4,A0A1Q8ZD62,A0A4Q6XKV6,A0A1Z3HNN4,A0A239JE83,A0A2N4XBY2,Q53W94,R5JEI2,A0A0Q0ZC47,A0A2T0XH18,A0A1V4CHV0,A0A1K1RQP7,A0A2T1EKT1,A0A1N6LUI7,A0A0P0NGR6,A0A1X7IML5,A0A0A2LKJ7,K1L112,A0A0U3AL92,A0A1H3A054,E0UCX3,K9XZC6,A0A0C1VHB4,Q31N05,A0A0C5JKF3,R5NJJ8,A5D4D9,Q2JI93,A0A142Y7A9,A0A432MEQ5,A0A372DKU2,C1F5Q7,A0A4R3EV39,A0A1P8WP90,A0A222F7P0,A0A1C9VH88,A0A2T2YMB1,A0A329TD61,A0A101R2A0,A0A1E3XF49,A0A1U9ND56,A0A4R7BQC4,A0A1Q1FPH0,E0TGY3,A0A259TUP4,F6EYI8,A0A2S9Q9J0,A0A4Q2UIU6,A0A1H0LH25,A0A318LG42,H1YCU5,L0JS08,A0A1Q5ZS75,A0A345E7N0,M0AF24,A0A1W2A082,A0A1H3X247,A0A0C1XUA0,M0D2X3,A0A2R5G167,A0A346PK63,R7RTW6,A0A1H2RBI2,A0A1C3ZXN2,B9LVP8,M5RSF0,W0JW77,B7K585,F8D8G0,A0A343TL88,L0AJX6,A0A2A5QS34,A0A343JEE2,A0A3P3RGE5,A0A329TBQ3,A0A285N2A8,A0A0W1S8B8,A0A1V4C8L7,L9VRQ2,E4NRV1,A0A1I6HGN0,A0A1I0NI68,,",366,37
"1027","C.H5.3","C.H5.7",306,178,128,3.60634655898876,"4F1N,4F3T,4KRE,5GUH,5VM9,6KR6,6OON,7KX7,7SWF,A0A163JTZ6,A0A0N4X8S8,A0A196SDB4,J9D5G4,Q389P5,C4LVV2,A0A2P6N8X7,A8BCK6,A2DPV7,T1H8B3,S4RWI0,D2VMG4,A0A074TLL7,A0A0D1ZAJ4,Q1K660,F4PH46,A0A3M7S814,A0A164ZA52,A0A383WDW5,S7WCF7,I0YVB2,R7QGN7,C1DZY0,A0A2C5Z0M1,A0CB11,R9ACY5,D3BMP8,A0A1Z5TVE5,W7XD45,A0A1U7LLR0,A0A4S2MWZ7,K1VVQ6,A0A158P1R9,G7DVX0,V6R0U9,G4N9J3,E3KLI3,B7Q5I1,A0A1E3QC61,D5GGK8,S8ANP9,A0A139AUH8,L2GMR6,U4LBG4,A0A177URI1,O74957,A0A3N4IGK1,A6N7Y9,A0A0E9NDK5,T1KZ60,A0A250WXN5,A0A2G8JLH3,Q5KAT1,L2GUF2,W2T741,A0A1W0E4B5,A0A2J7QB22,S4RYE2,A0A2K3CW87,A0A388KES6,A0A226EFL3,A0A3S3PD82,A0A0L0TEV1,A0A1S3J512,G0QTT2,A0A1J1HRI1,C4V9J2,Q9JMB7,A0A075AN09,Q5TW24,U5HIG6,A0A401PRI6,Q96J94,A0A2B4RHN2,G2QEV0,A0A397UU01,A0A2T7PFL8,K7ISV0,A0A024FT57,H3HCL6,A0A0G4IME3,A0A1S3CYL5,D7FQK3,A0A1Y1YHC8,T1GSU4,F4S231,A0A1D8PMK0,A0A2G5B1D8,Q5BD61,A0A1C7M8P2,A0A4D8YSQ3,A0A158PJG6,J9JZ66,A0A0C2XG51,A0A158QZT6,T0SAU8,R7YY92,A0A3S1A0C3,A0A074YJ47,A0A2K1J482,A0A1Q3ENA6,O04379,A0A371I3C8,M8AEW7,A8P0D4,A0A2K3NY65,F4NYW7,A0A409Y6G2,A0A0L0HAB7,D8PZT7,A0A1D1W4K0,A7RQ46,W4YU94,A7BJS5,D8SNM6,A0A1J8PPA3,X1WG39,M5FQK2,Q69VD5,A0A2R6NSC2,A0A0D8XL16,A0A016WPN3,Q9QZ81,G5EES3,A0A0K0EFP6,Q8CJG0,A0A1D5NTU6,V2WTL2,A0A0V0YLH8,A0A139WDH0,A0A0R3W9Q7,H3DS31,A0A1Y1HWP2,G4T5G9,B7QCC4,A0A0B2UV00,M7BCJ9,E9GN30,Q7PZ41,A0A077Z361,R7U9I3,A0A1X7V1N5,A0A0K0JDP1,A0A0N4UKJ1,A0A498N3A3,A0A3M0IQP5,A0A0L8GBV4,Q32KD4,A0A1J1JBJ0,E0W4C3,A0A482XDA9,A0A3P7EJD6,J9K2Z4,A0A2J7Q8V4,T1IBM6,V3ZRX0,A0A210QKF7,A0A423TSS1,K1PT78,A0A267E8R7,A0A1D2N447,A0A226D7A9,F6YK55,T1KTE4,A0A2C9JGZ6,A0A1V9X9F0,K5X5Z7,A0A3Q0KUG5,T1FY40,1YVU,1Z26,3DLB,5AWH,5G5T,5I4A,6QZK,7R8K,A0A1I7IXT4,A0A2W1JZ37,A0A2S7WBN3,A0A420DFE6,A0A4V1VDY2,A0A368P5I0,A0A1Y2RDH8,Q11QW7,A0A0M2PXX3,A0A1I3LMA1,A0A1W6MIP2,A0A1C0UUC4,A0A2U2J9E0,A0A2Z6E1D5,A0A0F4NXW8,L8D0R3,B1XJG0,A0A0D8ZUC0,A0A1T4Y3A2,Q5P0R2,A0YYT3,R6KUL9,A0A433NB65,K9UQR0,A0A2T1G8M7,B0JXD6,A0A2T1LS63,A0A1Z4K1Y3,A0A2Z6E0R7,A0A0V7ZCG4,A0A1J0AGK2,K9PFF9,A0A2G9DT08,Q9L1X1,A0A235B542,R5XQK4,A0A1H3LE92,A0A062U2W9,H0HWQ5,A0A1I2ZGP1,A0A317EJY3,A0A1I2BD20,F8ERC7,S7VLM7,A0A1A5X8H4,A0A1I2T6Q1,A0A1R3T9N6,A0A0Q2M2Z1,D3S0S6,A0A0B7I4Z6,A0LL61,Q8DKB1,A0A1J1EK56,A0A4Q6XKV6,A0A239JE83,A0A2N4XBY2,Q53W94,R5JEI2,A0A0Q0ZC47,A0A2T0XH18,A0A1V4CHV0,A0A1K1RQP7,A0A2T1EKT1,A0A1N6LUI7,A0A0P0NGR6,A0A1X7IML5,A0A0A2LKJ7,K1L112,A0A0U3AL92,A0A1H3A054,E0UCX3,K9XZC6,B9LVW4,A0A0C1VHB4,Q31N05,A0A0C5JKF3,R5NJJ8,A5D4D9,Q2JI93,A0A142Y7A9,A0A432MEQ5,A0A372DKU2,A0A3R7KLK4,C1F5Q7,A0A4R3EV39,A0A1P8WP90,A0A222F7P0,A0A1C9VH88,A0A329TD61,A0A101R2A0,A0A1E3XF49,A0A1U9ND56,A0A4R7BQC4,A0A1H3DGN3,A0A1Q1FPH0,E0TGY3,A0A259TUP4,F6EYI8,A0A2S9Q9J0,A0A4Q2UIU6,A0A1H0LH25,A0A318LG42,H1YCU5,A0A1Q5ZS75,A0A345E7N0,A0A1W2A082,A0A1H3X247,A0A0C1XUA0,M0D2X3,A0A2R5G167,R7RTW6,A0A1H2RBI2,A0A1C3ZXN2,M5RSF0,W0JW77,F8D8G0,L0AJX6,A0A343JEE2,A0A1V4C8L7,A0A1I0NI68,,",366,37
"1029","C.H7.11","C.H7.13",264,178,86,1.95969427750196,"4F1N,4F3T,4KRE,5GUH,5VM9,6KR6,6OON,7KX7,7SWF,A0A163JTZ6,A0A0N4X8S8,A0A196SDB4,J9D5G4,C4LVV2,A0A2P6N8X7,A2DPV7,A0A0G4H2S4,T1H8B3,R1FDF0,S4RWI0,D2VMG4,A0A0D1ZAJ4,Q1K660,F4PH46,A0A3M7S814,A0A164ZA52,A0A383WDW5,Q54G64,S7WCF7,I0YVB2,R7QGN7,C1DZY0,A0A2C5Z0M1,A0CB11,R9ACY5,D3BMP8,A0A1Z5TVE5,W7XD45,A0A1U7LLR0,A0A4S2MWZ7,K1VVQ6,A0A158P1R9,G7DVX0,V6R0U9,G4N9J3,E3KLI3,B7Q5I1,A0A1E3QC61,D5GGK8,S8ANP9,A0A139AUH8,L2GMR6,U4LBG4,A0A177URI1,O74957,A0A3N4IGK1,A6N7Y9,A0A0E9NDK5,T1KZ60,A0A250WXN5,A0A2G8JLH3,Q5KAT1,L2GUF2,W2T741,A0A1W0E4B5,A0A2J7QB22,A0A2K3CW87,A0A226EFL3,A0A3S3PD82,A0A0L0TEV1,A0A1S3J512,G0QTT2,A0A1J1HRI1,C4V9J2,Q9JMB7,A0A075AN09,Q5TW24,U5HIG6,A0A401PRI6,Q96J94,A0A2B4RHN2,G2QEV0,A0A397UU01,A0A2T7PFL8,K7ISV0,A0A024FT57,H3HCL6,A0A0G4IME3,E9FUN9,A0A1S3CYL5,D7FQK3,A0A1Y1YHC8,T1GSU4,F4S231,A0A1D8PMK0,A0A2G5B1D8,Q5BD61,A0A1C7M8P2,A0A4D8YSQ3,A0A158PJG6,J9JZ66,A0A0C2XG51,A0A158QZT6,A0A165QYQ9,T0SAU8,R7YY92,A0A3S1A0C3,A0A074YJ47,A0A2K1J482,A0A1Q3ENA6,O04379,A0A371I3C8,M8AEW7,A8P0D4,A0A2K3NY65,F4NYW7,A0A409Y6G2,A0A0L0HAB7,D8PZT7,A0A1D1W4K0,A7RQ46,W4YU94,A7BJS5,D8SNM6,A0A1J8PPA3,X1WG39,M5FQK2,Q69VD5,A0A2R6NSC2,A0A0D8XL16,A0A016WPN3,Q9QZ81,G5EES3,A0A0K0EFP6,Q8CJG0,A0A1D5NTU6,V2WTL2,A0A0V0YLH8,A0A139WDH0,A0A0R3W9Q7,H3DS31,A0A1Y1HWP2,G4T5G9,B7QCC4,A0A0B2UV00,M7BCJ9,E9GN30,Q7PZ41,A0A077Z361,R7U9I3,A0A1X7V1N5,A0A0K0JDP1,A0A0N4UKJ1,A0A498N3A3,A0A3M0IQP5,A0A0L8GBV4,Q32KD4,A0A1J1JBJ0,E0W4C3,A0A482XDA9,A0A3P7EJD6,J9K2Z4,A0A2J7Q8V4,T1IBM6,V3ZRX0,A0A210QKF7,A0A423TSS1,K1PT78,A0A267E8R7,A0A1D2N447,A0A226D7A9,F6YK55,T1KTE4,A0A2C9JGZ6,A0A1V9X9F0,K5X5Z7,A0A3Q0KUG5,T1FY40,1YVU,1Z26,3DLB,5AWH,5I4A,6QZK,A0A2W1JZ37,A0A2S7WBN3,A0A420DFE6,C4L1M1,A0A1Y2RDH8,A0A1M5ZSR3,A0A0K8QX04,A0A0M2PXX3,A0A1I3LMA1,A0A1W6MIP2,A0A1C0UUC4,A0A2U2J9E0,A0A2Z6E1D5,A0A0F4NXW8,A0A142XB92,L8D0R3,B1XJG0,A0A097QRL6,Q5P0R2,B6YTQ5,A0A0B0H9B4,R6KUL9,B7GJX9,A0A0P6X5X2,A0A2Z6E0R7,A0A1N6SSK9,A0A060HNJ0,A0A235B542,R5XQK4,A0A1H3LE92,A0A496APJ8,A0A1V9G9U4,A0A0Q2M2Z1,I3TE64,Q8DKB1,A0A139WY18,A0A1J1EK56,A0A2T1E1K4,A0A1Q8ZD62,A0A1Z3HNN4,Q53W94,A0A2T1EKT1,E0UCX3,K9XZC6,B9LVW4,A0A0C1VHB4,Q31N05,R5NJJ8,Q2JI93,A0A432MEQ5,A0A329TD61,A0A1E3XF49,A0A1H3DGN3,A0A1Q1FPH0,H1YCU5,A0A1Q5ZS75,A0A345E7N0,A0A1W2A082,A0A1H3X247,A0A0C1XUA0,A0A2R5G167,A0A346PK63,R7RTW6,A0A1H2RBI2,A0A1C3ZXN2,B9LVP8,M5RSF0,W0JW77,B7K585,A0A343TL88,L0AJX6,A0A2A5QS34,A0A343JEE2,A0A3P3RGE5,A0A329TBQ3,A0A285N2A8,A0A0W1S8B8,L9VRQ2,E4NRV1,A0A1I6HGN0,,",366,37
"1031","C.H7.13","C.H7.15",283,178,105,1.99218833600856,"4F1N,4F3T,4KRE,5GUH,5VM9,6KR6,6OON,7KX7,7SWF,A0A163JTZ6,A0A0N4X8S8,A0A196SDB4,J9D5G4,C4LVV2,A0A2P6N8X7,A8BCK6,A2DPV7,T1H8B3,R1FDF0,S4RWI0,D2VMG4,A0A0D1ZAJ4,Q1K660,F4PH46,A0A3M7S814,A0A164ZA52,A0A383WDW5,Q54G64,S7WCF7,I0YVB2,R7QGN7,C1DZY0,A0A2C5Z0M1,A0CB11,R9ACY5,D3BMP8,A0A1Z5TVE5,W7XD45,A0A1U7LLR0,A0A4S2MWZ7,K1VVQ6,A0A158P1R9,G7DVX0,V6R0U9,G4N9J3,E3KLI3,B7Q5I1,A0A1E3QC61,D5GGK8,S8ANP9,A0A139AUH8,L2GMR6,U4LBG4,A0A177URI1,O74957,A0A3N4IGK1,A6N7Y9,A0A0E9NDK5,T1KZ60,A0A250WXN5,A0A2G8JLH3,Q5KAT1,L2GUF2,W2T741,A0A1W0E4B5,A0A2J7QB22,A0A2K3CW87,A0A226EFL3,A0A3S3PD82,A0A0L0TEV1,A0A1S3J512,G0QTT2,A0A1J1HRI1,C4V9J2,Q9JMB7,A0A075AN09,Q5TW24,U5HIG6,A0A401PRI6,Q96J94,A0A2B4RHN2,G2QEV0,A0A397UU01,A0A2T7PFL8,K7ISV0,A0A024FT57,H3HCL6,A0A0G4IME3,E9FUN9,A0A1S3CYL5,D7FQK3,A0A1Y1YHC8,T1GSU4,F4S231,A0A1D8PMK0,A0A2G5B1D8,Q5BD61,A0A1C7M8P2,A0A4D8YSQ3,A0A158PJG6,J9JZ66,A0A0C2XG51,A0A158QZT6,A0A165QYQ9,T0SAU8,R7YY92,A0A3S1A0C3,A0A074YJ47,A0A2K1J482,A0A1Q3ENA6,O04379,A0A371I3C8,M8AEW7,A8P0D4,A0A2K3NY65,F4NYW7,A0A409Y6G2,A0A0L0HAB7,D8PZT7,A0A1D1W4K0,A7RQ46,W4YU94,A7BJS5,D8SNM6,A0A1J8PPA3,X1WG39,M5FQK2,Q69VD5,A0A2R6NSC2,A0A0D8XL16,A0A016WPN3,Q9QZ81,G5EES3,A0A0K0EFP6,Q8CJG0,A0A1D5NTU6,V2WTL2,A0A0V0YLH8,A0A139WDH0,A0A0R3W9Q7,H3DS31,A0A1Y1HWP2,G4T5G9,B7QCC4,A0A0B2UV00,M7BCJ9,E9GN30,Q7PZ41,A0A077Z361,R7U9I3,A0A1X7V1N5,A0A0K0JDP1,A0A0N4UKJ1,A0A498N3A3,A0A3M0IQP5,A0A0L8GBV4,Q32KD4,A0A1J1JBJ0,E0W4C3,A0A482XDA9,A0A3P7EJD6,J9K2Z4,A0A2J7Q8V4,T1IBM6,V3ZRX0,A0A210QKF7,A0A423TSS1,K1PT78,A0A267E8R7,A0A1D2N447,A0A226D7A9,F6YK55,T1KTE4,A0A2C9JGZ6,A0A1V9X9F0,K5X5Z7,A0A3Q0KUG5,T1FY40,1YVU,1Z26,3DLB,5AWH,5I4A,6QZK,7R8K,E8N0K8,A0A328VKE4,C4L1M1,A0A1Y2RDH8,A0A1M5ZSR3,A0A0M2PXX3,A0A1I3LMA1,K9TPA9,A0A1C0UUC4,A0A2U2J9E0,B1XJG0,A0A326U7G5,A0A3D8L290,A0A1Q4R485,K9U8J6,A0A097QRL6,K9RC91,A0A0D8ZUC0,A0A139XGN8,B6YTQ5,A0A0B0H9B4,A0YYT3,A0A2T1EFY0,G6FTN0,R6KUL9,A0A433NB65,A0A1Z4L0A1,K9UQR0,A0A2T1G8M7,K9VUN0,B7GJX9,K9ZDE3,B0JXD6,A0A2T1LS63,A0A1Z4K1Y3,A0A1N6SSK9,A0A0P4UVI8,A0A0V7ZCG4,A0A1J0AGK2,K9PFF9,K9UEV4,A0A060HNJ0,A0A235B542,R5XQK4,A0A1H3LE92,A0A496APJ8,A0A062U2W9,H0HWQ5,A0A1I2ZGP1,A0A317EJY3,A0A1I2BD20,F8ERC7,A0A0Q2M2Z1,Q8DKB1,A0A1J1EK56,A0A1Z3HNN4,Q53W94,A0A2T1EKT1,E0UCX3,K9XZC6,B9LVW4,A0A0C1VHB4,Q31N05,R5NJJ8,Q2JI93,A0A432MEQ5,A0A329TD61,A0A1E3XF49,A0A1Q1FPH0,H1YCU5,L0JS08,A0A1Q5ZS75,A0A345E7N0,M0AF24,A0A1W2A082,A0A1H3X247,A0A0C1XUA0,M0D2X3,A0A2R5G167,A0A346PK63,R7RTW6,A0A1H2RBI2,A0A1C3ZXN2,B9LVP8,M5RSF0,W0JW77,B7K585,A0A343TL88,L0AJX6,A0A2A5QS34,A0A343JEE2,A0A3P3RGE5,A0A329TBQ3,A0A285N2A8,A0A0W1S8B8,L9VRQ2,E4NRV1,A0A1I6HGN0,,",366,37
"1034","C.H8.13","C.H8.17",262,178,84,2.6722177635099,"4F1N,4F3T,4KRE,5GUH,5VM9,6KR6,6OON,7KX7,7SWF,A0A163JTZ6,A0A0N4X8S8,A0A196SDB4,J9D5G4,Q389P5,C4LVV2,A0A2P6N8X7,A8BCK6,A2DPV7,A0A0G4H2S4,T1H8B3,R1FDF0,S4RWI0,D2VMG4,A0A074TLL7,A0A0D1ZAJ4,Q1K660,F4PH46,A0A3M7S814,A0A164ZA52,A0A383WDW5,Q54G64,S7WCF7,I0YVB2,R7QGN7,C1DZY0,A0A2C5Z0M1,A0CB11,R9ACY5,D3BMP8,A0A1Z5TVE5,W7XD45,A0A1U7LLR0,A0A4S2MWZ7,K1VVQ6,G7DVX0,V6R0U9,G4N9J3,E3KLI3,B7Q5I1,A0A1E3QC61,D5GGK8,S8ANP9,A0A139AUH8,L2GMR6,U4LBG4,A0A177URI1,O74957,A0A3N4IGK1,A6N7Y9,A0A0E9NDK5,T1KZ60,A0A250WXN5,Q5KAT1,L2GUF2,W2T741,A0A1W0E4B5,A0A2J7QB22,A0A2K3CW87,A0A388KES6,A0A226EFL3,A0A3S3PD82,A0A0L0TEV1,G0QTT2,A0A1J1HRI1,C4V9J2,Q9JMB7,A0A075AN09,Q5TW24,U5HIG6,A0A401PRI6,Q96J94,G2QEV0,A0A397UU01,A0A2T7PFL8,K7ISV0,A0A024FT57,H3HCL6,A0A0G4IME3,E9FUN9,A0A1S3CYL5,D7FQK3,A0A1Y1YHC8,T1GSU4,F4S231,A0A1D8PMK0,A0A2G5B1D8,Q5BD61,A0A1C7M8P2,A0A4D8YSQ3,A0A158PJG6,J9JZ66,A0A0C2XG51,A0A158QZT6,A0A165QYQ9,T0SAU8,R7YY92,A0A3S1A0C3,A0A074YJ47,A0A2K1J482,A0A1Q3ENA6,O04379,A0A371I3C8,M8AEW7,A8P0D4,A0A2K3NY65,F4NYW7,A0A409Y6G2,A0A0L0HAB7,D8PZT7,A0A1D1W4K0,A7RQ46,W4YU94,A7BJS5,D8SNM6,A0A1J8PPA3,X1WG39,M5FQK2,Q69VD5,A0A2R6NSC2,A0A0D8XL16,A0A016WPN3,Q9QZ81,G5EES3,A0A0K0EFP6,Q8CJG0,A0A1D5NTU6,V2WTL2,A0A0V0YLH8,A0A139WDH0,A0A0R3W9Q7,H3DS31,A0A1Y1HWP2,G4T5G9,B7QCC4,A0A0B2UV00,M7BCJ9,E9GN30,Q7PZ41,A0A077Z361,R7U9I3,A0A1X7V1N5,A0A0K0JDP1,A0A0N4UKJ1,A0A498N3A3,A0A3M0IQP5,A0A0L8GBV4,Q32KD4,A0A1J1JBJ0,E0W4C3,A0A482XDA9,A0A3P7EJD6,J9K2Z4,A0A2J7Q8V4,T1IBM6,V3ZRX0,A0A210QKF7,A0A423TSS1,K1PT78,A0A267E8R7,A0A1D2N447,A0A226D7A9,F6YK55,T1KTE4,A0A2C9JGZ6,A0A1V9X9F0,K5X5Z7,A0A3Q0KUG5,T1FY40,1YVU,1Z26,5AWH,5G5T,6QZK,7R8K,A0A1I7IXT4,A0A2W1JZ37,A0A2S7WBN3,A0A420DFE6,E0ST67,A0A4V1VDY2,A0A368P5I0,C4L1M1,A0A4R1RMM2,A0A1Y2RDH8,Q11QW7,A0A0K8QX04,A0A0M2PXX3,A0A1I3LMA1,A0A1L3JHM3,A0A1W6MIP2,A0A1C0UUC4,A0A2U2J9E0,A0A142XB92,A0A3D8L290,H1KXR6,A0A1T4Y3A2,A0A0B0H9B4,R6KUL9,B7GJX9,A0A0P6X5X2,A0A1N6SSK9,A0A2G9DT08,A0A060HNJ0,A0A235B542,R5XQK4,A0A1H3LE92,A0A496APJ8,A0A062U2W9,H0HWQ5,A0A1V9G9U4,A0A1I2ZGP1,A0A317EJY3,A0A1I2BD20,F8ERC7,A0A1A5X8H4,A0A1R3T9N6,A0A0Q2M2Z1,D3S0S6,I3TE64,A0LL61,A0A139WY18,A0A2T1E1K4,A0A1Q8ZD62,A0A1Z3HNN4,A0A1V4CHV0,A0A1K1RQP7,A0A0A2LKJ7,R5NJJ8,A5D4D9,A0A222F7P0,A0A329TD61,A0A101R2A0,A0A1E3XF49,A0A1Q1FPH0,F6EYI8,A0A2S9Q9J0,H1YCU5,A0A1Q5ZS75,A0A345E7N0,A0A1W2A082,A0A1H3X247,A0A0C1XUA0,R7RTW6,A0A1H2RBI2,A0A1C3ZXN2,B9LVP8,M5RSF0,W0JW77,L0AJX6,A0A2A5QS34,A0A343JEE2,A0A285N2A8,,",366,37
"1036","C.H9.10","C.H9.7",358,178,180,3.35480649188514,"4F1N,4F3T,4KRE,5GUH,5VM9,6KR6,6OON,7KX7,7SWF,A0A163JTZ6,J9D5G4,Q389P5,C4LVV2,A0A2P6N8X7,A8BCK6,A2DPV7,A0A0G4H2S4,R1FDF0,D2VMG4,A0A074TLL7,A0A0D1ZAJ4,Q1K660,F4PH46,A0A3M7S814,A0A164ZA52,A0A383WDW5,Q54G64,S7WCF7,I0YVB2,R7QGN7,C1DZY0,A0A2C5Z0M1,A0CB11,R9ACY5,D3BMP8,A0A1Z5TVE5,W7XD45,A0A1U7LLR0,A0A4S2MWZ7,K1VVQ6,A0A158P1R9,G7DVX0,V6R0U9,G4N9J3,E3KLI3,B7Q5I1,A0A1E3QC61,D5GGK8,S8ANP9,A0A139AUH8,L2GMR6,U4LBG4,A0A177URI1,O74957,A0A3N4IGK1,A6N7Y9,A0A0E9NDK5,T1KZ60,A0A250WXN5,A0A2G8JLH3,Q5KAT1,L2GUF2,W2T741,A0A1W0E4B5,A0A2J7QB22,S4RYE2,A0A2K3CW87,A0A388KES6,A0A226EFL3,A0A3S3PD82,A0A0L0TEV1,A0A1S3J512,G0QTT2,A0A1J1HRI1,Q9JMB7,A0A075AN09,Q5TW24,U5HIG6,A0A401PRI6,Q96J94,A0A2B4RHN2,G2QEV0,A0A397UU01,A0A2T7PFL8,K7ISV0,A0A024FT57,H3HCL6,A0A0G4IME3,E9FUN9,A0A1S3CYL5,D7FQK3,A0A1Y1YHC8,T1GSU4,F4S231,A0A1D8PMK0,A0A2G5B1D8,Q5BD61,A0A1C7M8P2,A0A4D8YSQ3,A0A158PJG6,J9JZ66,A0A0C2XG51,A0A158QZT6,A0A165QYQ9,T0SAU8,R7YY92,A0A3S1A0C3,A0A074YJ47,A0A2K1J482,A0A1Q3ENA6,O04379,A0A371I3C8,M8AEW7,A8P0D4,A0A2K3NY65,F4NYW7,A0A409Y6G2,A0A0L0HAB7,D8PZT7,A0A1D1W4K0,A7RQ46,W4YU94,A7BJS5,D8SNM6,A0A1J8PPA3,X1WG39,M5FQK2,Q69VD5,A0A2R6NSC2,A0A0D8XL16,A0A016WPN3,Q9QZ81,G5EES3,A0A0K0EFP6,Q8CJG0,A0A1D5NTU6,V2WTL2,A0A0V0YLH8,A0A139WDH0,A0A0R3W9Q7,H3DS31,A0A1Y1HWP2,G4T5G9,B7QCC4,A0A0B2UV00,M7BCJ9,E9GN30,Q7PZ41,A0A077Z361,R7U9I3,A0A1X7V1N5,A0A0K0JDP1,A0A0N4UKJ1,A0A498N3A3,A0A3M0IQP5,A0A0L8GBV4,Q32KD4,A0A1J1JBJ0,E0W4C3,A0A482XDA9,A0A3P7EJD6,J9K2Z4,A0A2J7Q8V4,T1IBM6,V3ZRX0,A0A210QKF7,A0A423TSS1,K1PT78,A0A267E8R7,A0A1D2N447,A0A226D7A9,F6YK55,T1KTE4,A0A2C9JGZ6,A0A1V9X9F0,K5X5Z7,A0A3Q0KUG5,T1FY40,1YVU,1Z26,3DLB,5AWH,5G5T,5I4A,6QZK,7R8K,A0A1I7IXT4,A0A2W1JZ37,A0A2S7WBN3,A0A328VKE4,A0A420DFE6,E0ST67,A0A4V1VDY2,A0A368P5I0,C4L1M1,A0A4R1RMM2,A0A1Y2RDH8,Q11QW7,A0A1M5ZSR3,A0A0K8QX04,A0A0M2PXX3,K9TPA9,A0A1L3JHM3,A0A1W6MIP2,A0A1C0UUC4,A0A2U2J9E0,A0A2Z6E1D5,A0A0F4NXW8,A0A142XB92,L8D0R3,B1XJG0,A0A326U7G5,A0A3D8L290,A0A1Q4R485,K9U8J6,A0A097QRL6,K9RC91,A0A0D8ZUC0,A0A139XGN8,A0A1T4Y3A2,Q5P0R2,B6YTQ5,A0A0B0H9B4,A0YYT3,A0A2T1EFY0,G6FTN0,R6KUL9,A0A433NB65,A0A1Z4L0A1,K9UQR0,A0A2T1G8M7,K9VUN0,B7GJX9,A0A0P6X5X2,K9ZDE3,B0JXD6,A0A2T1LS63,A0A1Z4K1Y3,A0A2Z6E0R7,A0A1N6SSK9,A0A0P4UVI8,A0A0V7ZCG4,A0A1J0AGK2,K9PFF9,A0A2G9DT08,K9UEV4,Q9L1X1,A0A060HNJ0,A0A235B542,R5XQK4,A0A1H3LE92,A0A496APJ8,A0A062U2W9,H0HWQ5,A0A1V9G9U4,A0A1I2ZGP1,A0A317EJY3,A0A1I2BD20,F8ERC7,S7VLM7,A0A1A5X8H4,A0A1I2T6Q1,A0A1R3T9N6,A0A0Q2M2Z1,H8KXJ0,D3S0S6,A0A2D1U4H7,I3TE64,A0A0B7I4Z6,A0LL61,Q8DKB1,A0A139WY18,A0A1J1EK56,A0A2T1E1K4,A0A1Q8ZD62,A0A4Q6XKV6,A0A1Z3HNN4,A0A239JE83,A0A2N4XBY2,Q53W94,R5JEI2,A0A0Q0ZC47,A0A2T0XH18,A0A1V4CHV0,A0A1K1RQP7,A0A2T1EKT1,A0A1N6LUI7,A0A0P0NGR6,A0A1X7IML5,A0A0A2LKJ7,K1L112,A0A0U3AL92,A0A1H3A054,E0UCX3,K9XZC6,B9LVW4,A0A0C1VHB4,Q31N05,A0A0C5JKF3,R5NJJ8,A5D4D9,Q2JI93,A0A142Y7A9,A0A432MEQ5,A0A372DKU2,A0A3R7KLK4,C1F5Q7,A0A4R3EV39,A0A1P8WP90,A0A222F7P0,A0A1C9VH88,A0A2T2YMB1,A0A329TD61,A0A101R2A0,A0A1E3XF49,A0A1U9ND56,A0A4R7BQC4,A0A1H3DGN3,A0A1Q1FPH0,E0TGY3,A0A259TUP4,F6EYI8,A0A2S9Q9J0,A0A4Q2UIU6,A0A1H0LH25,A0A318LG42,H1YCU5,L0JS08,A0A1Q5ZS75,A0A345E7N0,M0AF24,A0A1W2A082,A0A1H3X247,A0A0C1XUA0,M0D2X3,A0A2R5G167,A0A346PK63,R7RTW6,A0A1H2RBI2,A0A1C3ZXN2,B9LVP8,M5RSF0,W0JW77,B7K585,F8D8G0,A0A343TL88,L0AJX6,A0A2A5QS34,A0A343JEE2,A0A3P3RGE5,A0A329TBQ3,A0A285N2A8,A0A0W1S8B8,A0A1V4C8L7,L9VRQ2,E4NRV1,A0A1I6HGN0,A0A1I0NI68,,",366,37
"1038","C.L21.16","C.S15.5",325,178,147,2.30394404952992,"4F1N,4F3T,4KRE,5GUH,5VM9,6KR6,6OON,7KX7,7SWF,A0A163JTZ6,A0A0N4X8S8,A0A196SDB4,J9D5G4,Q389P5,C4LVV2,A2DPV7,A0A0G4H2S4,R1FDF0,D2VMG4,A0A074TLL7,A0A0D1ZAJ4,Q1K660,F4PH46,A0A3M7S814,A0A164ZA52,A0A383WDW5,Q54G64,S7WCF7,I0YVB2,R7QGN7,C1DZY0,A0A2C5Z0M1,A0CB11,R9ACY5,D3BMP8,A0A1Z5TVE5,W7XD45,A0A1U7LLR0,A0A4S2MWZ7,K1VVQ6,A0A158P1R9,G7DVX0,V6R0U9,G4N9J3,E3KLI3,A0A1E3QC61,D5GGK8,S8ANP9,A0A139AUH8,L2GMR6,U4LBG4,A0A177URI1,O74957,A0A3N4IGK1,A6N7Y9,A0A0E9NDK5,T1KZ60,A0A250WXN5,A0A2G8JLH3,Q5KAT1,L2GUF2,W2T741,A0A1W0E4B5,A0A2J7QB22,S4RYE2,A0A2K3CW87,A0A388KES6,A0A226EFL3,A0A3S3PD82,A0A0L0TEV1,A0A1S3J512,G0QTT2,A0A1J1HRI1,C4V9J2,Q9JMB7,A0A075AN09,Q5TW24,U5HIG6,A0A401PRI6,Q96J94,A0A2B4RHN2,G2QEV0,A0A397UU01,A0A2T7PFL8,K7ISV0,A0A024FT57,H3HCL6,A0A0G4IME3,E9FUN9,A0A1S3CYL5,D7FQK3,A0A1Y1YHC8,T1GSU4,F4S231,A0A1D8PMK0,A0A2G5B1D8,Q5BD61,A0A1C7M8P2,A0A4D8YSQ3,A0A158PJG6,J9JZ66,A0A0C2XG51,A0A158QZT6,A0A165QYQ9,T0SAU8,R7YY92,A0A3S1A0C3,A0A074YJ47,A0A2K1J482,A0A1Q3ENA6,O04379,A0A371I3C8,M8AEW7,A8P0D4,A0A2K3NY65,F4NYW7,A0A409Y6G2,A0A0L0HAB7,D8PZT7,A0A1D1W4K0,A7RQ46,W4YU94,A7BJS5,D8SNM6,A0A1J8PPA3,X1WG39,M5FQK2,Q69VD5,A0A2R6NSC2,A0A0D8XL16,A0A016WPN3,Q9QZ81,G5EES3,A0A0K0EFP6,Q8CJG0,A0A1D5NTU6,V2WTL2,A0A0V0YLH8,A0A139WDH0,A0A0R3W9Q7,H3DS31,A0A1Y1HWP2,G4T5G9,B7QCC4,A0A0B2UV00,M7BCJ9,E9GN30,Q7PZ41,A0A077Z361,R7U9I3,A0A1X7V1N5,A0A0K0JDP1,A0A0N4UKJ1,A0A498N3A3,A0A3M0IQP5,A0A0L8GBV4,Q32KD4,A0A1J1JBJ0,E0W4C3,A0A482XDA9,A0A3P7EJD6,J9K2Z4,A0A2J7Q8V4,T1IBM6,V3ZRX0,A0A210QKF7,A0A423TSS1,K1PT78,A0A267E8R7,A0A1D2N447,A0A226D7A9,F6YK55,T1KTE4,A0A2C9JGZ6,A0A1V9X9F0,K5X5Z7,A0A3Q0KUG5,T1FY40,1YVU,1Z26,3DLB,5AWH,5G5T,5I4A,6QZK,E8N0K8,A0A328VKE4,E0ST67,C4L1M1,Q11QW7,A0A0K8QX04,K9TPA9,A0A142XB92,A0A326U7G5,A0A3D8L290,A0A1Q4R485,K9U8J6,K9RC91,A0A0D8ZUC0,A0A139XGN8,A0A1T4Y3A2,A0A0B0H9B4,A0YYT3,A0A2T1EFY0,G6FTN0,R6KUL9,A0A433NB65,A0A1Z4L0A1,K9UQR0,A0A2T1G8M7,K9VUN0,B7GJX9,A0A0P6X5X2,K9ZDE3,B0JXD6,A0A2T1LS63,A0A1Z4K1Y3,A0A1N6SSK9,A0A0P4UVI8,A0A0V7ZCG4,A0A1J0AGK2,K9PFF9,A0A2G9DT08,K9UEV4,Q9L1X1,A0A060HNJ0,A0A235B542,R5XQK4,A0A1H3LE92,A0A496APJ8,A0A062U2W9,H0HWQ5,A0A1V9G9U4,A0A1I2ZGP1,A0A317EJY3,A0A1I2BD20,F8ERC7,S7VLM7,A0A1A5X8H4,A0A1I2T6Q1,A0A1R3T9N6,A0A0Q2M2Z1,H8KXJ0,A0A2D1U4H7,A0A0B7I4Z6,A0LL61,A0A139WY18,A0A1J1EK56,A0A2T1E1K4,A0A1Q8ZD62,A0A4Q6XKV6,A0A1Z3HNN4,A0A239JE83,A0A2N4XBY2,Q53W94,R5JEI2,A0A0Q0ZC47,A0A2T0XH18,A0A1V4CHV0,A0A1K1RQP7,A0A1N6LUI7,A0A0P0NGR6,A0A1X7IML5,A0A0A2LKJ7,K1L112,A0A0U3AL92,A0A1H3A054,B9LVW4,A0A0C5JKF3,R5NJJ8,A5D4D9,A0A142Y7A9,A0A432MEQ5,A0A372DKU2,C1F5Q7,A0A4R3EV39,A0A1P8WP90,A0A222F7P0,A0A1C9VH88,A0A2T2YMB1,A0A329TD61,A0A101R2A0,A0A1E3XF49,A0A1U9ND56,A0A4R7BQC4,A0A1Q1FPH0,E0TGY3,A0A259TUP4,F6EYI8,A0A2S9Q9J0,A0A4Q2UIU6,A0A1H0LH25,A0A318LG42,H1YCU5,L0JS08,A0A1Q5ZS75,A0A345E7N0,M0AF24,A0A1W2A082,A0A1H3X247,A0A0C1XUA0,M0D2X3,A0A2R5G167,A0A346PK63,R7RTW6,A0A1H2RBI2,A0A1C3ZXN2,B9LVP8,M5RSF0,W0JW77,B7K585,F8D8G0,A0A343TL88,L0AJX6,A0A2A5QS34,A0A343JEE2,A0A3P3RGE5,A0A329TBQ3,A0A285N2A8,A0A0W1S8B8,A0A1V4C8L7,L9VRQ2,E4NRV1,A0A1I6HGN0,A0A1I0NI68,,",366,37
"1042","C.S11.5","C.S8.5",347,178,169,1.93255102719234,"4F1N,4F3T,4KRE,5GUH,5VM9,6KR6,6OON,A0A163JTZ6,A0A0N4X8S8,A0A196SDB4,J9D5G4,C4LVV2,A0A2P6N8X7,A8BCK6,A2DPV7,A0A0G4H2S4,T1H8B3,R1FDF0,S4RWI0,D2VMG4,A0A074TLL7,A0A0D1ZAJ4,Q1K660,F4PH46,A0A3M7S814,A0A164ZA52,A0A383WDW5,Q54G64,S7WCF7,I0YVB2,R7QGN7,C1DZY0,A0A2C5Z0M1,A0CB11,R9ACY5,D3BMP8,A0A1Z5TVE5,W7XD45,A0A1U7LLR0,A0A4S2MWZ7,K1VVQ6,A0A158P1R9,G7DVX0,V6R0U9,G4N9J3,E3KLI3,B7Q5I1,A0A1E3QC61,D5GGK8,S8ANP9,A0A139AUH8,L2GMR6,U4LBG4,A0A177URI1,O74957,A0A3N4IGK1,A6N7Y9,A0A0E9NDK5,T1KZ60,A0A250WXN5,A0A2G8JLH3,Q5KAT1,L2GUF2,W2T741,A0A1W0E4B5,A0A2J7QB22,A0A2K3CW87,A0A226EFL3,A0A3S3PD82,A0A0L0TEV1,A0A1S3J512,G0QTT2,A0A1J1HRI1,C4V9J2,Q9JMB7,A0A075AN09,Q5TW24,U5HIG6,A0A401PRI6,Q96J94,A0A2B4RHN2,G2QEV0,A0A397UU01,A0A2T7PFL8,K7ISV0,A0A024FT57,H3HCL6,A0A0G4IME3,E9FUN9,A0A1S3CYL5,D7FQK3,A0A1Y1YHC8,T1GSU4,F4S231,A0A1D8PMK0,A0A2G5B1D8,Q5BD61,A0A1C7M8P2,A0A4D8YSQ3,A0A158PJG6,J9JZ66,A0A0C2XG51,A0A158QZT6,A0A165QYQ9,T0SAU8,R7YY92,A0A3S1A0C3,A0A074YJ47,A0A2K1J482,A0A1Q3ENA6,O04379,A0A371I3C8,M8AEW7,A8P0D4,A0A2K3NY65,F4NYW7,A0A409Y6G2,A0A0L0HAB7,D8PZT7,A0A1D1W4K0,A7RQ46,W4YU94,A7BJS5,D8SNM6,A0A1J8PPA3,X1WG39,M5FQK2,Q69VD5,A0A2R6NSC2,A0A0D8XL16,A0A016WPN3,Q9QZ81,G5EES3,A0A0K0EFP6,Q8CJG0,A0A1D5NTU6,V2WTL2,A0A0V0YLH8,A0A139WDH0,A0A0R3W9Q7,H3DS31,A0A1Y1HWP2,G4T5G9,B7QCC4,A0A0B2UV00,M7BCJ9,E9GN30,Q7PZ41,A0A077Z361,R7U9I3,A0A1X7V1N5,A0A0K0JDP1,A0A0N4UKJ1,A0A498N3A3,A0A3M0IQP5,A0A0L8GBV4,Q32KD4,A0A1J1JBJ0,E0W4C3,A0A482XDA9,A0A3P7EJD6,J9K2Z4,A0A2J7Q8V4,T1IBM6,V3ZRX0,A0A210QKF7,A0A423TSS1,K1PT78,A0A267E8R7,A0A1D2N447,A0A226D7A9,F6YK55,T1KTE4,A0A2C9JGZ6,A0A1V9X9F0,K5X5Z7,A0A3Q0KUG5,T1FY40,1YVU,1Z26,3DLB,5AWH,5G5T,5I4A,6QZK,7R8K,E8N0K8,A0A1I7IXT4,A0A2W1JZ37,A0A328VKE4,A0A420DFE6,E0ST67,A0A4V1VDY2,A0A368P5I0,C4L1M1,A0A4R1RMM2,Q11QW7,A0A1M5ZSR3,A0A0K8QX04,A0A0M2PXX3,A0A1I3LMA1,K9TPA9,A0A1L3JHM3,A0A1W6MIP2,A0A1C0UUC4,A0A2U2J9E0,A0A2Z6E1D5,A0A0F4NXW8,A0A142XB92,L8D0R3,B1XJG0,A0A326U7G5,A0A3D8L290,H1KXR6,A0A1Q4R485,K9U8J6,A0A097QRL6,K9RC91,A0A0D8ZUC0,A0A139XGN8,A0A1T4Y3A2,Q5P0R2,B6YTQ5,A0A0B0H9B4,A0YYT3,A0A2T1EFY0,G6FTN0,R6KUL9,A0A433NB65,A0A1Z4L0A1,K9UQR0,A0A2T1G8M7,K9VUN0,B7GJX9,A0A0P6X5X2,K9ZDE3,B0JXD6,A0A2T1LS63,A0A1Z4K1Y3,A0A2Z6E0R7,A0A1N6SSK9,A0A0P4UVI8,A0A0V7ZCG4,A0A1J0AGK2,K9PFF9,A0A2G9DT08,K9UEV4,Q9L1X1,A0A060HNJ0,A0A235B542,R5XQK4,A0A1H3LE92,A0A496APJ8,A0A062U2W9,H0HWQ5,A0A1V9G9U4,A0A1I2ZGP1,A0A317EJY3,A0A1I2BD20,F8ERC7,A0A1A5X8H4,A0A1I2T6Q1,A0A1R3T9N6,A0A0Q2M2Z1,H8KXJ0,D3S0S6,A0A2D1U4H7,I3TE64,A0LL61,Q8DKB1,A0A139WY18,A0A1J1EK56,A0A2T1E1K4,A0A1Q8ZD62,A0A1Z3HNN4,A0A2N4XBY2,Q53W94,A0A1V4CHV0,A0A2T1EKT1,A0A1N6LUI7,A0A1X7IML5,K1L112,A0A0U3AL92,A0A1H3A054,E0UCX3,K9XZC6,A0A0C1VHB4,Q31N05,A0A0C5JKF3,R5NJJ8,Q2JI93,A0A142Y7A9,A0A432MEQ5,A0A372DKU2,A0A3R7KLK4,C1F5Q7,A0A4R3EV39,A0A1P8WP90,A0A222F7P0,A0A1C9VH88,A0A2T2YMB1,A0A329TD61,A0A101R2A0,A0A1E3XF49,A0A1U9ND56,A0A4R7BQC4,A0A1H3DGN3,A0A1Q1FPH0,E0TGY3,A0A259TUP4,F6EYI8,A0A2S9Q9J0,A0A4Q2UIU6,A0A1H0LH25,A0A318LG42,H1YCU5,L0JS08,A0A1Q5ZS75,A0A345E7N0,M0AF24,A0A1W2A082,A0A1H3X247,A0A0C1XUA0,M0D2X3,A0A2R5G167,A0A346PK63,R7RTW6,A0A1H2RBI2,A0A1C3ZXN2,B9LVP8,M5RSF0,W0JW77,B7K585,F8D8G0,A0A343TL88,L0AJX6,A0A2A5QS34,A0A343JEE2,A0A3P3RGE5,A0A329TBQ3,A0A285N2A8,A0A0W1S8B8,A0A1V4C8L7,L9VRQ2,E4NRV1,A0A1I6HGN0,A0A1I0NI68,,",366,37
"1043","C.S11.6","C.S12.5",343,178,165,1.81062308478039,"4F1N,4F3T,4KRE,5GUH,5VM9,6KR6,6OON,7KX7,A0A163JTZ6,A0A0N4X8S8,A0A196SDB4,J9D5G4,Q389P5,C4LVV2,A0A2P6N8X7,A8BCK6,A2DPV7,A0A0G4H2S4,T1H8B3,R1FDF0,S4RWI0,D2VMG4,A0A074TLL7,A0A0D1ZAJ4,Q1K660,F4PH46,A0A3M7S814,A0A164ZA52,A0A383WDW5,Q54G64,S7WCF7,I0YVB2,R7QGN7,C1DZY0,A0A2C5Z0M1,A0CB11,R9ACY5,D3BMP8,A0A1Z5TVE5,W7XD45,A0A1U7LLR0,A0A4S2MWZ7,K1VVQ6,A0A158P1R9,G7DVX0,V6R0U9,G4N9J3,E3KLI3,B7Q5I1,A0A1E3QC61,D5GGK8,S8ANP9,A0A139AUH8,L2GMR6,U4LBG4,A0A177URI1,O74957,A0A3N4IGK1,A6N7Y9,A0A0E9NDK5,A0A250WXN5,A0A2G8JLH3,Q5KAT1,L2GUF2,W2T741,A0A1W0E4B5,A0A2J7QB22,A0A2K3CW87,A0A226EFL3,A0A3S3PD82,A0A0L0TEV1,A0A1S3J512,G0QTT2,A0A1J1HRI1,C4V9J2,Q9JMB7,A0A075AN09,Q5TW24,U5HIG6,A0A401PRI6,Q96J94,A0A2B4RHN2,G2QEV0,A0A397UU01,A0A2T7PFL8,K7ISV0,A0A024FT57,H3HCL6,A0A0G4IME3,E9FUN9,A0A1S3CYL5,D7FQK3,A0A1Y1YHC8,T1GSU4,F4S231,A0A1D8PMK0,A0A2G5B1D8,Q5BD61,A0A1C7M8P2,A0A4D8YSQ3,A0A158PJG6,J9JZ66,A0A0C2XG51,A0A158QZT6,A0A165QYQ9,T0SAU8,R7YY92,A0A3S1A0C3,A0A074YJ47,A0A2K1J482,A0A1Q3ENA6,O04379,A0A371I3C8,A8P0D4,A0A2K3NY65,F4NYW7,A0A409Y6G2,A0A0L0HAB7,D8PZT7,A0A1D1W4K0,A7RQ46,W4YU94,A7BJS5,D8SNM6,A0A1J8PPA3,X1WG39,M5FQK2,Q69VD5,A0A2R6NSC2,A0A0D8XL16,A0A016WPN3,Q9QZ81,G5EES3,A0A0K0EFP6,Q8CJG0,A0A1D5NTU6,V2WTL2,A0A0V0YLH8,A0A139WDH0,A0A0R3W9Q7,H3DS31,A0A1Y1HWP2,G4T5G9,B7QCC4,A0A0B2UV00,M7BCJ9,E9GN30,Q7PZ41,A0A077Z361,R7U9I3,A0A1X7V1N5,A0A0K0JDP1,A0A0N4UKJ1,A0A498N3A3,A0A3M0IQP5,A0A0L8GBV4,Q32KD4,A0A1J1JBJ0,E0W4C3,A0A482XDA9,A0A3P7EJD6,J9K2Z4,A0A2J7Q8V4,T1IBM6,V3ZRX0,A0A210QKF7,A0A423TSS1,K1PT78,A0A267E8R7,A0A1D2N447,A0A226D7A9,F6YK55,T1KTE4,A0A2C9JGZ6,A0A1V9X9F0,K5X5Z7,A0A3Q0KUG5,T1FY40,1YVU,3DLB,5AWH,5G5T,5I4A,6QZK,7R8K,E8N0K8,A0A328VKE4,E0ST67,C4L1M1,A0A0M2PXX3,A0A1I3LMA1,K9TPA9,A0A1C0UUC4,A0A2Z6E1D5,A0A0F4NXW8,A0A142XB92,L8D0R3,B1XJG0,A0A326U7G5,A0A1Q4R485,K9U8J6,A0A097QRL6,K9RC91,A0A0D8ZUC0,A0A139XGN8,A0A1T4Y3A2,Q5P0R2,B6YTQ5,A0A0B0H9B4,A0YYT3,A0A2T1EFY0,G6FTN0,R6KUL9,A0A433NB65,A0A1Z4L0A1,K9UQR0,A0A2T1G8M7,K9VUN0,B7GJX9,A0A0P6X5X2,K9ZDE3,B0JXD6,A0A2T1LS63,A0A1Z4K1Y3,A0A2Z6E0R7,A0A1N6SSK9,A0A0P4UVI8,A0A0V7ZCG4,A0A1J0AGK2,K9PFF9,A0A2G9DT08,K9UEV4,Q9L1X1,A0A060HNJ0,A0A235B542,R5XQK4,A0A1H3LE92,A0A496APJ8,A0A062U2W9,H0HWQ5,A0A1V9G9U4,A0A1I2ZGP1,A0A317EJY3,A0A1I2BD20,F8ERC7,S7VLM7,A0A1A5X8H4,A0A1I2T6Q1,A0A1R3T9N6,H8KXJ0,D3S0S6,A0A2D1U4H7,I3TE64,A0A0B7I4Z6,A0LL61,Q8DKB1,A0A139WY18,A0A1J1EK56,A0A2T1E1K4,A0A1Q8ZD62,A0A4Q6XKV6,A0A1Z3HNN4,A0A239JE83,A0A2N4XBY2,Q53W94,R5JEI2,A0A0Q0ZC47,A0A2T0XH18,A0A1V4CHV0,A0A1K1RQP7,A0A2T1EKT1,A0A1N6LUI7,A0A0P0NGR6,A0A1X7IML5,A0A0A2LKJ7,K1L112,A0A0U3AL92,A0A1H3A054,E0UCX3,K9XZC6,B9LVW4,A0A0C1VHB4,Q31N05,A0A0C5JKF3,R5NJJ8,A5D4D9,Q2JI93,A0A142Y7A9,A0A432MEQ5,A0A372DKU2,A0A3R7KLK4,C1F5Q7,A0A4R3EV39,A0A1P8WP90,A0A222F7P0,A0A1C9VH88,A0A2T2YMB1,A0A329TD61,A0A101R2A0,A0A1E3XF49,A0A1U9ND56,A0A4R7BQC4,A0A1H3DGN3,A0A1Q1FPH0,E0TGY3,A0A259TUP4,F6EYI8,A0A2S9Q9J0,A0A4Q2UIU6,A0A1H0LH25,A0A318LG42,H1YCU5,L0JS08,A0A1Q5ZS75,A0A345E7N0,M0AF24,A0A1W2A082,A0A1H3X247,A0A0C1XUA0,M0D2X3,A0A2R5G167,A0A346PK63,R7RTW6,A0A1H2RBI2,A0A1C3ZXN2,B9LVP8,M5RSF0,W0JW77,B7K585,F8D8G0,A0A343TL88,L0AJX6,A0A2A5QS34,A0A343JEE2,A0A3P3RGE5,A0A329TBQ3,A0A285N2A8,A0A0W1S8B8,A0A1V4C8L7,L9VRQ2,E4NRV1,A0A1I6HGN0,A0A1I0NI68,,",366,37
"1045","C.S14.1","C.S15.4",303,178,125,2.30737078651685,"4F1N,4F3T,4KRE,5GUH,5VM9,6KR6,6OON,7KX7,7SWF,A0A163JTZ6,A0A0N4X8S8,A0A196SDB4,J9D5G4,Q389P5,C4LVV2,A2DPV7,A0A0G4H2S4,R1FDF0,D2VMG4,A0A074TLL7,A0A0D1ZAJ4,Q1K660,F4PH46,A0A3M7S814,A0A164ZA52,A0A383WDW5,Q54G64,S7WCF7,I0YVB2,R7QGN7,C1DZY0,A0A2C5Z0M1,A0CB11,R9ACY5,D3BMP8,A0A1Z5TVE5,W7XD45,A0A1U7LLR0,A0A4S2MWZ7,K1VVQ6,A0A158P1R9,G7DVX0,V6R0U9,G4N9J3,E3KLI3,A0A1E3QC61,D5GGK8,S8ANP9,A0A139AUH8,L2GMR6,U4LBG4,A0A177URI1,O74957,A0A3N4IGK1,A6N7Y9,A0A0E9NDK5,T1KZ60,A0A250WXN5,A0A2G8JLH3,Q5KAT1,L2GUF2,W2T741,A0A1W0E4B5,A0A2J7QB22,S4RYE2,A0A2K3CW87,A0A388KES6,A0A226EFL3,A0A3S3PD82,A0A0L0TEV1,A0A1S3J512,G0QTT2,A0A1J1HRI1,C4V9J2,Q9JMB7,A0A075AN09,Q5TW24,U5HIG6,A0A401PRI6,Q96J94,A0A2B4RHN2,G2QEV0,A0A397UU01,A0A2T7PFL8,K7ISV0,A0A024FT57,H3HCL6,A0A0G4IME3,E9FUN9,A0A1S3CYL5,D7FQK3,A0A1Y1YHC8,T1GSU4,F4S231,A0A1D8PMK0,A0A2G5B1D8,Q5BD61,A0A1C7M8P2,A0A4D8YSQ3,A0A158PJG6,J9JZ66,A0A0C2XG51,A0A158QZT6,A0A165QYQ9,T0SAU8,R7YY92,A0A3S1A0C3,A0A074YJ47,A0A2K1J482,A0A1Q3ENA6,O04379,A0A371I3C8,M8AEW7,A8P0D4,A0A2K3NY65,F4NYW7,A0A409Y6G2,A0A0L0HAB7,D8PZT7,A0A1D1W4K0,A7RQ46,W4YU94,A7BJS5,D8SNM6,A0A1J8PPA3,X1WG39,M5FQK2,Q69VD5,A0A2R6NSC2,A0A0D8XL16,A0A016WPN3,Q9QZ81,G5EES3,A0A0K0EFP6,Q8CJG0,A0A1D5NTU6,V2WTL2,A0A0V0YLH8,A0A139WDH0,A0A0R3W9Q7,H3DS31,A0A1Y1HWP2,G4T5G9,B7QCC4,A0A0B2UV00,M7BCJ9,E9GN30,Q7PZ41,A0A077Z361,R7U9I3,A0A1X7V1N5,A0A0K0JDP1,A0A0N4UKJ1,A0A498N3A3,A0A3M0IQP5,A0A0L8GBV4,Q32KD4,A0A1J1JBJ0,E0W4C3,A0A482XDA9,A0A3P7EJD6,J9K2Z4,A0A2J7Q8V4,T1IBM6,V3ZRX0,A0A210QKF7,A0A423TSS1,K1PT78,A0A267E8R7,A0A1D2N447,A0A226D7A9,F6YK55,T1KTE4,A0A2C9JGZ6,A0A1V9X9F0,K5X5Z7,A0A3Q0KUG5,T1FY40,1YVU,1Z26,3DLB,5AWH,5I4A,6QZK,7R8K,E8N0K8,A0A328VKE4,A0A420DFE6,C4L1M1,A0A4R1RMM2,A0A1Y2RDH8,Q11QW7,A0A1M5ZSR3,A0A0K8QX04,A0A0M2PXX3,A0A1L3JHM3,A0A1W6MIP2,A0A1C0UUC4,A0A2U2J9E0,A0A3D8L290,A0A1Q4R485,A0A1T4Y3A2,A0A0B0H9B4,R6KUL9,A0A2T1G8M7,A0A0P6X5X2,A0A1N6SSK9,A0A2G9DT08,K9UEV4,Q9L1X1,A0A060HNJ0,A0A235B542,R5XQK4,A0A1H3LE92,A0A496APJ8,A0A062U2W9,H0HWQ5,A0A1V9G9U4,A0A1I2ZGP1,A0A317EJY3,A0A1I2BD20,F8ERC7,S7VLM7,A0A1A5X8H4,A0A1I2T6Q1,A0A1R3T9N6,A0A0Q2M2Z1,H8KXJ0,A0A2D1U4H7,A0A0B7I4Z6,A0LL61,A0A139WY18,A0A1J1EK56,A0A2T1E1K4,A0A1Q8ZD62,A0A4Q6XKV6,A0A1Z3HNN4,A0A239JE83,A0A2N4XBY2,Q53W94,R5JEI2,A0A0Q0ZC47,A0A2T0XH18,A0A1V4CHV0,A0A1K1RQP7,A0A1N6LUI7,A0A0P0NGR6,A0A1X7IML5,A0A0A2LKJ7,K1L112,A0A0U3AL92,A0A1H3A054,B9LVW4,A0A0C5JKF3,R5NJJ8,A5D4D9,A0A142Y7A9,A0A432MEQ5,C1F5Q7,A0A4R3EV39,A0A1P8WP90,A0A222F7P0,A0A1C9VH88,A0A2T2YMB1,A0A101R2A0,A0A1E3XF49,A0A1U9ND56,A0A1Q1FPH0,E0TGY3,A0A259TUP4,F6EYI8,A0A2S9Q9J0,A0A4Q2UIU6,A0A1H0LH25,A0A318LG42,H1YCU5,L0JS08,A0A1Q5ZS75,A0A345E7N0,M0AF24,A0A1W2A082,A0A0C1XUA0,M0D2X3,A0A2R5G167,A0A346PK63,R7RTW6,A0A1C3ZXN2,B9LVP8,M5RSF0,W0JW77,B7K585,F8D8G0,A0A343TL88,L0AJX6,A0A2A5QS34,A0A343JEE2,A0A3P3RGE5,A0A329TBQ3,A0A285N2A8,A0A0W1S8B8,L9VRQ2,E4NRV1,A0A1I6HGN0,,",366,37
"1049","C.S3.4","C.S5.3",342,178,164,1.31525760482324,"4F1N,4F3T,4KRE,5GUH,5VM9,6KR6,6OON,7KX7,7SWF,A0A163JTZ6,J9D5G4,Q389P5,C4LVV2,A8BCK6,A2DPV7,A0A0G4H2S4,T1H8B3,S4RWI0,D2VMG4,A0A074TLL7,A0A0D1ZAJ4,Q1K660,F4PH46,A0A3M7S814,A0A164ZA52,A0A383WDW5,Q54G64,S7WCF7,I0YVB2,R7QGN7,C1DZY0,A0A2C5Z0M1,A0CB11,R9ACY5,D3BMP8,A0A1Z5TVE5,W7XD45,A0A1U7LLR0,A0A4S2MWZ7,K1VVQ6,A0A158P1R9,G7DVX0,V6R0U9,G4N9J3,E3KLI3,B7Q5I1,A0A1E3QC61,D5GGK8,S8ANP9,A0A139AUH8,L2GMR6,U4LBG4,A0A177URI1,O74957,A0A3N4IGK1,A6N7Y9,A0A0E9NDK5,T1KZ60,A0A250WXN5,A0A2G8JLH3,Q5KAT1,L2GUF2,W2T741,A0A1W0E4B5,A0A2J7QB22,S4RYE2,A0A2K3CW87,A0A388KES6,A0A226EFL3,A0A3S3PD82,A0A0L0TEV1,A0A1S3J512,G0QTT2,A0A1J1HRI1,C4V9J2,Q9JMB7,A0A075AN09,Q5TW24,U5HIG6,A0A401PRI6,Q96J94,A0A2B4RHN2,G2QEV0,A0A397UU01,A0A2T7PFL8,K7ISV0,A0A024FT57,H3HCL6,A0A0G4IME3,E9FUN9,A0A1S3CYL5,D7FQK3,A0A1Y1YHC8,F4S231,A0A1D8PMK0,A0A2G5B1D8,Q5BD61,A0A1C7M8P2,A0A4D8YSQ3,A0A158PJG6,J9JZ66,A0A0C2XG51,A0A158QZT6,A0A165QYQ9,T0SAU8,R7YY92,A0A3S1A0C3,A0A074YJ47,A0A2K1J482,A0A1Q3ENA6,O04379,A0A371I3C8,M8AEW7,A8P0D4,A0A2K3NY65,F4NYW7,A0A409Y6G2,A0A0L0HAB7,D8PZT7,A0A1D1W4K0,A7RQ46,W4YU94,A7BJS5,D8SNM6,A0A1J8PPA3,X1WG39,M5FQK2,Q69VD5,A0A2R6NSC2,A0A0D8XL16,A0A016WPN3,Q9QZ81,G5EES3,A0A0K0EFP6,Q8CJG0,A0A1D5NTU6,V2WTL2,A0A0V0YLH8,A0A139WDH0,A0A0R3W9Q7,H3DS31,A0A1Y1HWP2,G4T5G9,B7QCC4,A0A0B2UV00,M7BCJ9,E9GN30,Q7PZ41,A0A077Z361,R7U9I3,A0A1X7V1N5,A0A0K0JDP1,A0A0N4UKJ1,A0A498N3A3,A0A3M0IQP5,A0A0L8GBV4,Q32KD4,A0A1J1JBJ0,E0W4C3,A0A482XDA9,A0A3P7EJD6,J9K2Z4,A0A2J7Q8V4,T1IBM6,V3ZRX0,A0A210QKF7,A0A423TSS1,K1PT78,A0A267E8R7,A0A1D2N447,A0A226D7A9,F6YK55,T1KTE4,A0A2C9JGZ6,A0A1V9X9F0,K5X5Z7,A0A3Q0KUG5,T1FY40,1YVU,1Z26,3DLB,5AWH,5G5T,5I4A,6QZK,7R8K,E8N0K8,A0A328VKE4,E0ST67,C4L1M1,A0A4R1RMM2,A0A1Y2RDH8,A0A0M2PXX3,A0A1I3LMA1,K9TPA9,A0A1C0UUC4,B1XJG0,A0A326U7G5,A0A3D8L290,A0A1Q4R485,K9U8J6,A0A097QRL6,K9RC91,A0A0D8ZUC0,A0A139XGN8,A0A1T4Y3A2,B6YTQ5,A0A0B0H9B4,A0YYT3,A0A2T1EFY0,G6FTN0,R6KUL9,A0A433NB65,A0A1Z4L0A1,K9UQR0,A0A2T1G8M7,K9VUN0,B7GJX9,A0A0P6X5X2,K9ZDE3,B0JXD6,A0A2T1LS63,A0A1Z4K1Y3,A0A1N6SSK9,A0A0P4UVI8,A0A0V7ZCG4,A0A1J0AGK2,K9PFF9,A0A2G9DT08,K9UEV4,Q9L1X1,A0A060HNJ0,A0A235B542,R5XQK4,A0A1H3LE92,A0A496APJ8,A0A062U2W9,H0HWQ5,A0A1V9G9U4,A0A1I2ZGP1,A0A317EJY3,A0A1I2BD20,F8ERC7,S7VLM7,A0A1A5X8H4,A0A1I2T6Q1,A0A1R3T9N6,A0A0Q2M2Z1,H8KXJ0,D3S0S6,A0A2D1U4H7,I3TE64,A0A0B7I4Z6,A0LL61,Q8DKB1,A0A139WY18,A0A1J1EK56,A0A2T1E1K4,A0A1Q8ZD62,A0A4Q6XKV6,A0A1Z3HNN4,A0A239JE83,A0A2N4XBY2,Q53W94,R5JEI2,A0A0Q0ZC47,A0A2T0XH18,A0A1V4CHV0,A0A1K1RQP7,A0A2T1EKT1,A0A1N6LUI7,A0A0P0NGR6,A0A1X7IML5,A0A0A2LKJ7,K1L112,A0A0U3AL92,A0A1H3A054,E0UCX3,K9XZC6,B9LVW4,A0A0C1VHB4,Q31N05,A0A0C5JKF3,R5NJJ8,A5D4D9,Q2JI93,A0A142Y7A9,A0A432MEQ5,A0A372DKU2,A0A3R7KLK4,C1F5Q7,A0A4R3EV39,A0A1P8WP90,A0A222F7P0,A0A1C9VH88,A0A2T2YMB1,A0A329TD61,A0A101R2A0,A0A1E3XF49,A0A1U9ND56,A0A4R7BQC4,A0A1H3DGN3,A0A1Q1FPH0,E0TGY3,A0A259TUP4,F6EYI8,A0A2S9Q9J0,A0A4Q2UIU6,A0A1H0LH25,A0A318LG42,H1YCU5,L0JS08,A0A1Q5ZS75,A0A345E7N0,M0AF24,A0A1W2A082,A0A1H3X247,A0A0C1XUA0,M0D2X3,A0A2R5G167,A0A346PK63,R7RTW6,A0A1H2RBI2,A0A1C3ZXN2,B9LVP8,M5RSF0,W0JW77,B7K585,F8D8G0,A0A343TL88,L0AJX6,A0A2A5QS34,A0A343JEE2,A0A3P3RGE5,A0A329TBQ3,A0A285N2A8,A0A0W1S8B8,A0A1V4C8L7,L9VRQ2,E4NRV1,A0A1I6HGN0,A0A1I0NI68,,",366,37
"1050","N.H3.12","N.H3.8",347,178,169,3.09362741838973,"4F1N,4F3T,4KRE,5GUH,5VM9,6KR6,6OON,7KX7,7SWF,A0A0N4X8S8,A0A196SDB4,Q389P5,C4LVV2,A2DPV7,A0A0G4H2S4,T1H8B3,R1FDF0,S4RWI0,D2VMG4,A0A074TLL7,A0A0D1ZAJ4,Q1K660,F4PH46,A0A3M7S814,A0A164ZA52,Q54G64,S7WCF7,I0YVB2,R7QGN7,C1DZY0,A0A2C5Z0M1,A0CB11,R9ACY5,D3BMP8,A0A1Z5TVE5,W7XD45,A0A1U7LLR0,A0A4S2MWZ7,K1VVQ6,A0A158P1R9,G7DVX0,V6R0U9,G4N9J3,E3KLI3,B7Q5I1,A0A1E3QC61,D5GGK8,S8ANP9,A0A139AUH8,L2GMR6,U4LBG4,A0A177URI1,O74957,A0A3N4IGK1,A6N7Y9,A0A0E9NDK5,T1KZ60,A0A250WXN5,A0A2G8JLH3,Q5KAT1,L2GUF2,W2T741,A0A1W0E4B5,A0A2J7QB22,S4RYE2,A0A2K3CW87,A0A388KES6,A0A226EFL3,A0A3S3PD82,A0A0L0TEV1,A0A1S3J512,G0QTT2,A0A1J1HRI1,C4V9J2,Q9JMB7,A0A075AN09,Q5TW24,U5HIG6,A0A401PRI6,Q96J94,A0A2B4RHN2,G2QEV0,A0A397UU01,A0A2T7PFL8,K7ISV0,A0A024FT57,H3HCL6,A0A0G4IME3,E9FUN9,A0A1S3CYL5,D7FQK3,A0A1Y1YHC8,T1GSU4,F4S231,A0A1D8PMK0,A0A2G5B1D8,Q5BD61,A0A1C7M8P2,A0A4D8YSQ3,A0A158PJG6,J9JZ66,A0A0C2XG51,A0A158QZT6,A0A165QYQ9,T0SAU8,R7YY92,A0A3S1A0C3,A0A074YJ47,A0A2K1J482,A0A1Q3ENA6,O04379,A0A371I3C8,M8AEW7,A8P0D4,A0A2K3NY65,F4NYW7,A0A409Y6G2,A0A0L0HAB7,D8PZT7,A0A1D1W4K0,A7RQ46,W4YU94,A7BJS5,D8SNM6,A0A1J8PPA3,X1WG39,M5FQK2,Q69VD5,A0A2R6NSC2,A0A0D8XL16,A0A016WPN3,Q9QZ81,G5EES3,A0A0K0EFP6,Q8CJG0,A0A1D5NTU6,V2WTL2,A0A0V0YLH8,A0A139WDH0,A0A0R3W9Q7,H3DS31,A0A1Y1HWP2,G4T5G9,B7QCC4,A0A0B2UV00,M7BCJ9,E9GN30,Q7PZ41,A0A077Z361,R7U9I3,A0A1X7V1N5,A0A0K0JDP1,A0A0N4UKJ1,A0A498N3A3,A0A3M0IQP5,A0A0L8GBV4,Q32KD4,A0A1J1JBJ0,E0W4C3,A0A482XDA9,A0A3P7EJD6,J9K2Z4,A0A2J7Q8V4,T1IBM6,V3ZRX0,A0A210QKF7,A0A423TSS1,K1PT78,A0A267E8R7,A0A1D2N447,A0A226D7A9,F6YK55,T1KTE4,A0A2C9JGZ6,A0A1V9X9F0,K5X5Z7,A0A3Q0KUG5,T1FY40,1YVU,1Z26,3DLB,5AWH,5G5T,5I4A,6QZK,7R8K,A0A1I7IXT4,A0A2W1JZ37,A0A2S7WBN3,A0A420DFE6,E0ST67,A0A4V1VDY2,A0A368P5I0,A0A4R1RMM2,A0A1Y2RDH8,A0A1M5ZSR3,A0A1I3LMA1,A0A1L3JHM3,A0A1W6MIP2,A0A2U2J9E0,A0A2Z6E1D5,A0A0F4NXW8,A0A142XB92,L8D0R3,A0A3D8L290,H1KXR6,A0A1Q4R485,K9U8J6,A0A097QRL6,K9RC91,A0A0D8ZUC0,A0A139XGN8,Q5P0R2,A0A0B0H9B4,A0YYT3,A0A2T1EFY0,G6FTN0,R6KUL9,A0A433NB65,K9UQR0,A0A2T1G8M7,K9VUN0,B7GJX9,A0A0P6X5X2,K9ZDE3,B0JXD6,A0A2T1LS63,A0A1Z4K1Y3,A0A2Z6E0R7,A0A1N6SSK9,A0A0P4UVI8,A0A0V7ZCG4,A0A1J0AGK2,K9PFF9,A0A2G9DT08,K9UEV4,Q9L1X1,A0A060HNJ0,A0A235B542,R5XQK4,A0A496APJ8,A0A062U2W9,H0HWQ5,A0A1V9G9U4,A0A1I2ZGP1,A0A317EJY3,A0A1I2BD20,F8ERC7,S7VLM7,A0A1A5X8H4,A0A1I2T6Q1,A0A1R3T9N6,A0A0Q2M2Z1,H8KXJ0,D3S0S6,A0A2D1U4H7,I3TE64,A0A0B7I4Z6,A0LL61,Q8DKB1,A0A139WY18,A0A1J1EK56,A0A2T1E1K4,A0A1Q8ZD62,A0A4Q6XKV6,A0A1Z3HNN4,A0A239JE83,A0A2N4XBY2,Q53W94,R5JEI2,A0A0Q0ZC47,A0A2T0XH18,A0A1V4CHV0,A0A1K1RQP7,A0A2T1EKT1,A0A1N6LUI7,A0A0P0NGR6,A0A1X7IML5,A0A0A2LKJ7,K1L112,A0A0U3AL92,A0A1H3A054,E0UCX3,K9XZC6,B9LVW4,A0A0C1VHB4,Q31N05,A0A0C5JKF3,R5NJJ8,A5D4D9,Q2JI93,A0A142Y7A9,A0A432MEQ5,A0A372DKU2,A0A3R7KLK4,C1F5Q7,A0A4R3EV39,A0A1P8WP90,A0A222F7P0,A0A1C9VH88,A0A2T2YMB1,A0A329TD61,A0A101R2A0,A0A1E3XF49,A0A1U9ND56,A0A4R7BQC4,A0A1H3DGN3,A0A1Q1FPH0,E0TGY3,A0A259TUP4,F6EYI8,A0A2S9Q9J0,A0A4Q2UIU6,A0A1H0LH25,A0A318LG42,H1YCU5,L0JS08,A0A1Q5ZS75,A0A345E7N0,M0AF24,A0A1W2A082,A0A1H3X247,A0A0C1XUA0,M0D2X3,A0A2R5G167,A0A346PK63,R7RTW6,A0A1H2RBI2,A0A1C3ZXN2,B9LVP8,M5RSF0,W0JW77,B7K585,F8D8G0,A0A343TL88,L0AJX6,A0A2A5QS34,A0A343JEE2,A0A3P3RGE5,A0A329TBQ3,A0A285N2A8,A0A0W1S8B8,A0A1V4C8L7,L9VRQ2,E4NRV1,A0A1I6HGN0,A0A1I0NI68,,",366,37
"1053","N.H4.2","N.S19.1",304,178,126,4.01400035669699,"4F1N,4F3T,4KRE,5GUH,5VM9,6KR6,6OON,7SWF,A0A163JTZ6,A0A0N4X8S8,J9D5G4,C4LVV2,A0A2P6N8X7,A8BCK6,A2DPV7,A0A0G4H2S4,T1H8B3,R1FDF0,S4RWI0,D2VMG4,A0A0D1ZAJ4,Q1K660,F4PH46,A0A3M7S814,A0A164ZA52,A0A383WDW5,Q54G64,S7WCF7,I0YVB2,R7QGN7,C1DZY0,A0A2C5Z0M1,A0CB11,R9ACY5,D3BMP8,A0A1Z5TVE5,W7XD45,A0A1U7LLR0,A0A4S2MWZ7,K1VVQ6,A0A158P1R9,G7DVX0,V6R0U9,G4N9J3,E3KLI3,A0A1E3QC61,D5GGK8,S8ANP9,A0A139AUH8,L2GMR6,U4LBG4,A0A177URI1,O74957,A0A3N4IGK1,A6N7Y9,A0A0E9NDK5,T1KZ60,A0A250WXN5,A0A2G8JLH3,Q5KAT1,L2GUF2,W2T741,A0A1W0E4B5,A0A2J7QB22,S4RYE2,A0A2K3CW87,A0A388KES6,A0A226EFL3,A0A3S3PD82,A0A0L0TEV1,A0A1S3J512,G0QTT2,A0A1J1HRI1,C4V9J2,Q9JMB7,A0A075AN09,Q5TW24,U5HIG6,A0A401PRI6,Q96J94,A0A2B4RHN2,G2QEV0,A0A397UU01,A0A2T7PFL8,K7ISV0,A0A024FT57,H3HCL6,A0A0G4IME3,E9FUN9,A0A1S3CYL5,D7FQK3,A0A1Y1YHC8,T1GSU4,F4S231,A0A1D8PMK0,A0A2G5B1D8,Q5BD61,A0A1C7M8P2,A0A4D8YSQ3,A0A158PJG6,J9JZ66,A0A0C2XG51,A0A158QZT6,A0A165QYQ9,T0SAU8,R7YY92,A0A3S1A0C3,A0A074YJ47,A0A2K1J482,A0A1Q3ENA6,O04379,A0A371I3C8,M8AEW7,A8P0D4,A0A2K3NY65,F4NYW7,A0A409Y6G2,A0A0L0HAB7,D8PZT7,A0A1D1W4K0,A7RQ46,W4YU94,A7BJS5,D8SNM6,A0A1J8PPA3,X1WG39,M5FQK2,Q69VD5,A0A2R6NSC2,A0A0D8XL16,A0A016WPN3,Q9QZ81,G5EES3,A0A0K0EFP6,Q8CJG0,A0A1D5NTU6,V2WTL2,A0A0V0YLH8,A0A139WDH0,A0A0R3W9Q7,H3DS31,A0A1Y1HWP2,G4T5G9,B7QCC4,A0A0B2UV00,M7BCJ9,E9GN30,Q7PZ41,A0A077Z361,R7U9I3,A0A1X7V1N5,A0A0K0JDP1,A0A0N4UKJ1,A0A498N3A3,A0A3M0IQP5,A0A0L8GBV4,Q32KD4,A0A1J1JBJ0,E0W4C3,A0A482XDA9,A0A3P7EJD6,J9K2Z4,A0A2J7Q8V4,T1IBM6,V3ZRX0,A0A210QKF7,A0A423TSS1,K1PT78,A0A267E8R7,A0A1D2N447,A0A226D7A9,F6YK55,T1KTE4,A0A2C9JGZ6,A0A1V9X9F0,K5X5Z7,A0A3Q0KUG5,T1FY40,1YVU,1Z26,3DLB,5G5T,5I4A,6QZK,7R8K,E0ST67,C4L1M1,A0A0M2PXX3,A0A1I3LMA1,A0A1C0UUC4,B1XJG0,A0A1T4Y3A2,A0A0B0H9B4,R6KUL9,B7GJX9,A0A1N6SSK9,A0A2G9DT08,Q9L1X1,A0A060HNJ0,A0A235B542,R5XQK4,A0A1H3LE92,A0A496APJ8,A0A062U2W9,H0HWQ5,A0A1V9G9U4,A0A1I2ZGP1,A0A317EJY3,A0A1I2BD20,F8ERC7,S7VLM7,A0A1A5X8H4,A0A1I2T6Q1,A0A1R3T9N6,A0A0Q2M2Z1,H8KXJ0,D3S0S6,A0A2D1U4H7,I3TE64,A0A0B7I4Z6,A0LL61,Q8DKB1,A0A139WY18,A0A1J1EK56,A0A2T1E1K4,A0A1Q8ZD62,A0A4Q6XKV6,A0A1Z3HNN4,A0A239JE83,A0A2N4XBY2,Q53W94,R5JEI2,A0A0Q0ZC47,A0A2T0XH18,A0A1V4CHV0,A0A1K1RQP7,A0A2T1EKT1,A0A1N6LUI7,A0A0P0NGR6,A0A1X7IML5,A0A0A2LKJ7,K1L112,A0A0U3AL92,A0A1H3A054,E0UCX3,K9XZC6,A0A0C1VHB4,Q31N05,A0A0C5JKF3,R5NJJ8,A5D4D9,Q2JI93,A0A142Y7A9,A0A432MEQ5,A0A372DKU2,C1F5Q7,A0A4R3EV39,A0A1P8WP90,A0A222F7P0,A0A1C9VH88,A0A2T2YMB1,A0A329TD61,A0A101R2A0,A0A1E3XF49,A0A1U9ND56,A0A4R7BQC4,A0A1Q1FPH0,E0TGY3,A0A259TUP4,F6EYI8,A0A2S9Q9J0,A0A4Q2UIU6,A0A1H0LH25,A0A318LG42,H1YCU5,L0JS08,A0A1Q5ZS75,A0A345E7N0,M0AF24,A0A1W2A082,A0A1H3X247,A0A0C1XUA0,M0D2X3,A0A346PK63,R7RTW6,A0A1H2RBI2,A0A1C3ZXN2,B9LVP8,W0JW77,B7K585,F8D8G0,A0A343TL88,L0AJX6,A0A2A5QS34,A0A343JEE2,A0A3P3RGE5,A0A329TBQ3,A0A285N2A8,A0A0W1S8B8,A0A1V4C8L7,L9VRQ2,E4NRV1,A0A1I6HGN0,A0A1I0NI68,,",366,37
"1061","N.S11.11","N.S12.2",321,178,143,2.154081873183,"4F1N,4F3T,4KRE,5GUH,5VM9,6KR6,6OON,7KX7,7SWF,A0A196SDB4,J9D5G4,C4LVV2,A0A2P6N8X7,A2DPV7,A0A0G4H2S4,T1H8B3,R1FDF0,S4RWI0,D2VMG4,A0A0D1ZAJ4,Q1K660,F4PH46,A0A3M7S814,A0A164ZA52,A0A383WDW5,Q54G64,S7WCF7,I0YVB2,R7QGN7,C1DZY0,A0A2C5Z0M1,A0CB11,R9ACY5,D3BMP8,A0A1Z5TVE5,W7XD45,A0A1U7LLR0,A0A4S2MWZ7,K1VVQ6,A0A158P1R9,G7DVX0,V6R0U9,G4N9J3,E3KLI3,B7Q5I1,A0A1E3QC61,D5GGK8,S8ANP9,A0A139AUH8,L2GMR6,U4LBG4,A0A177URI1,O74957,A0A3N4IGK1,A6N7Y9,A0A0E9NDK5,T1KZ60,A0A250WXN5,A0A2G8JLH3,Q5KAT1,L2GUF2,W2T741,A0A1W0E4B5,A0A2J7QB22,S4RYE2,A0A2K3CW87,A0A388KES6,A0A226EFL3,A0A3S3PD82,A0A0L0TEV1,A0A1S3J512,G0QTT2,A0A1J1HRI1,C4V9J2,Q9JMB7,A0A075AN09,Q5TW24,U5HIG6,A0A401PRI6,Q96J94,A0A2B4RHN2,G2QEV0,A0A397UU01,A0A2T7PFL8,K7ISV0,A0A024FT57,H3HCL6,A0A0G4IME3,E9FUN9,A0A1S3CYL5,D7FQK3,A0A1Y1YHC8,T1GSU4,F4S231,A0A1D8PMK0,A0A2G5B1D8,Q5BD61,A0A1C7M8P2,A0A4D8YSQ3,A0A158PJG6,J9JZ66,A0A0C2XG51,A0A158QZT6,A0A165QYQ9,T0SAU8,R7YY92,A0A3S1A0C3,A0A074YJ47,A0A2K1J482,A0A1Q3ENA6,O04379,A0A371I3C8,M8AEW7,A8P0D4,A0A2K3NY65,F4NYW7,A0A409Y6G2,A0A0L0HAB7,D8PZT7,A0A1D1W4K0,A7RQ46,W4YU94,A7BJS5,D8SNM6,A0A1J8PPA3,X1WG39,M5FQK2,Q69VD5,A0A2R6NSC2,A0A0D8XL16,A0A016WPN3,Q9QZ81,G5EES3,A0A0K0EFP6,Q8CJG0,A0A1D5NTU6,V2WTL2,A0A0V0YLH8,A0A139WDH0,A0A0R3W9Q7,H3DS31,A0A1Y1HWP2,G4T5G9,B7QCC4,A0A0B2UV00,M7BCJ9,E9GN30,Q7PZ41,A0A077Z361,R7U9I3,A0A1X7V1N5,A0A0K0JDP1,A0A0N4UKJ1,A0A498N3A3,A0A3M0IQP5,A0A0L8GBV4,Q32KD4,A0A1J1JBJ0,E0W4C3,A0A482XDA9,A0A3P7EJD6,J9K2Z4,A0A2J7Q8V4,T1IBM6,V3ZRX0,A0A210QKF7,A0A423TSS1,K1PT78,A0A267E8R7,A0A1D2N447,A0A226D7A9,F6YK55,T1KTE4,A0A2C9JGZ6,A0A1V9X9F0,K5X5Z7,A0A3Q0KUG5,T1FY40,1YVU,1Z26,3DLB,5AWH,5G5T,5I4A,6QZK,7R8K,A0A1I7IXT4,A0A2W1JZ37,A0A2S7WBN3,A0A420DFE6,A0A4V1VDY2,A0A368P5I0,C4L1M1,A0A4R1RMM2,A0A1Y2RDH8,A0A1M5ZSR3,A0A0K8QX04,A0A1I3LMA1,A0A1L3JHM3,A0A1W6MIP2,A0A2U2J9E0,B1XJG0,A0A3D8L290,A0A097QRL6,A0A1T4Y3A2,A0A0B0H9B4,R6KUL9,B7GJX9,A0A1N6SSK9,A0A2G9DT08,Q9L1X1,A0A060HNJ0,A0A235B542,R5XQK4,A0A1H3LE92,A0A496APJ8,A0A062U2W9,H0HWQ5,A0A1V9G9U4,A0A1I2ZGP1,A0A317EJY3,A0A1I2BD20,F8ERC7,S7VLM7,A0A1A5X8H4,A0A1I2T6Q1,A0A1R3T9N6,A0A0Q2M2Z1,H8KXJ0,D3S0S6,A0A2D1U4H7,I3TE64,A0A0B7I4Z6,A0LL61,Q8DKB1,A0A139WY18,A0A1J1EK56,A0A2T1E1K4,A0A1Q8ZD62,A0A4Q6XKV6,A0A1Z3HNN4,A0A239JE83,A0A2N4XBY2,Q53W94,R5JEI2,A0A0Q0ZC47,A0A2T0XH18,A0A1V4CHV0,A0A1K1RQP7,A0A2T1EKT1,A0A1N6LUI7,A0A0P0NGR6,A0A1X7IML5,A0A0A2LKJ7,K1L112,A0A0U3AL92,A0A1H3A054,E0UCX3,K9XZC6,B9LVW4,A0A0C1VHB4,Q31N05,A0A0C5JKF3,R5NJJ8,A5D4D9,Q2JI93,A0A142Y7A9,A0A432MEQ5,A0A372DKU2,A0A3R7KLK4,C1F5Q7,A0A4R3EV39,A0A1P8WP90,A0A222F7P0,A0A1C9VH88,A0A329TD61,A0A101R2A0,A0A1E3XF49,A0A1U9ND56,A0A4R7BQC4,A0A1H3DGN3,A0A1Q1FPH0,E0TGY3,A0A259TUP4,F6EYI8,A0A2S9Q9J0,A0A4Q2UIU6,A0A1H0LH25,A0A318LG42,H1YCU5,L0JS08,A0A1Q5ZS75,A0A345E7N0,M0AF24,A0A1W2A082,A0A1H3X247,A0A0C1XUA0,M0D2X3,A0A2R5G167,A0A346PK63,R7RTW6,A0A1H2RBI2,A0A1C3ZXN2,B9LVP8,M5RSF0,W0JW77,B7K585,F8D8G0,A0A343TL88,L0AJX6,A0A2A5QS34,A0A343JEE2,A0A3P3RGE5,A0A329TBQ3,A0A285N2A8,A0A0W1S8B8,A0A1V4C8L7,L9VRQ2,E4NRV1,A0A1I6HGN0,A0A1I0NI68,,",366,37
"1062","C.H1.10","C.H1.8",343,179,164,1.99034268973975,"4F1N,4F3T,4KRE,5GUH,5VM9,6KR6,6OON,7KX7,7SWF,A0A163JTZ6,A0A0N4X8S8,A0A196SDB4,Q389P5,C4LVV2,A0A2P6N8X7,A8BCK6,A2DPV7,A0A0G4H2S4,T1H8B3,S4RWI0,D2VMG4,A0A074TLL7,A0A0D1ZAJ4,Q1K660,F4PH46,A0A3M7S814,A0A164ZA52,A0A383WDW5,Q54G64,S7WCF7,I0YVB2,R7QGN7,A0A2C5Z0M1,A0CB11,R9ACY5,D3BMP8,A0A1Z5TVE5,W7XD45,A0A1U7LLR0,A0A4S2MWZ7,K1VVQ6,A0A158P1R9,G7DVX0,V6R0U9,G4N9J3,E3KLI3,B7Q5I1,A0A1E3QC61,D5GGK8,S8ANP9,A0A139AUH8,L2GMR6,U4LBG4,A0A177URI1,O74957,A0A3N4IGK1,A6N7Y9,A0A0E9NDK5,T1KZ60,A0A250WXN5,A0A2G8JLH3,Q5KAT1,L2GUF2,W2T741,A0A1W0E4B5,A0A2J7QB22,S4RYE2,A0A2K3CW87,A0A388KES6,A0A226EFL3,A0A3S3PD82,A0A0L0TEV1,A0A1S3J512,G0QTT2,A0A1J1HRI1,Q9JMB7,A0A075AN09,Q5TW24,U5HIG6,A0A401PRI6,Q96J94,A0A2B4RHN2,G2QEV0,A0A397UU01,A0A2T7PFL8,K7ISV0,A0A024FT57,H3HCL6,A0A0G4IME3,E9FUN9,A0A1S3CYL5,D7FQK3,A0A1Y1YHC8,T1GSU4,F4S231,A0A1D8PMK0,A0A2G5B1D8,Q5BD61,A0A1C7M8P2,A0A4D8YSQ3,A0A158PJG6,J9JZ66,A0A0C2XG51,A0A158QZT6,A0A165QYQ9,T0SAU8,R7YY92,A0A3S1A0C3,A0A074YJ47,A0A2K1J482,A0A1Q3ENA6,O04379,A0A371I3C8,M8AEW7,A8P0D4,A0A2K3NY65,F4NYW7,A0A409Y6G2,A0A0L0HAB7,D8PZT7,A0A1D1W4K0,A7RQ46,W4YU94,A7BJS5,D8SNM6,A0A1J8PPA3,X1WG39,M5FQK2,Q69VD5,A0A2R6NSC2,A0A0D8XL16,A0A016WPN3,Q9QZ81,G5EES3,A0A0K0EFP6,Q8CJG0,A0A1D5NTU6,V2WTL2,A0A0V0YLH8,A0A139WDH0,A0A0R3W9Q7,H3DS31,A0A1Y1HWP2,G4T5G9,B7QCC4,A0A0B2UV00,M7BCJ9,E9GN30,Q7PZ41,A0A077Z361,R7U9I3,A0A1X7V1N5,A0A0K0JDP1,A0A0N4UKJ1,A0A498N3A3,A0A3M0IQP5,A0A0L8GBV4,Q32KD4,A0A1J1JBJ0,E0W4C3,A0A482XDA9,A0A3P7EJD6,J9K2Z4,A0A2J7Q8V4,T1IBM6,V3ZRX0,A0A210QKF7,A0A423TSS1,K1PT78,A0A267E8R7,A0A1D2N447,A0A226D7A9,F6YK55,T1KTE4,A0A2C9JGZ6,A0A1V9X9F0,K5X5Z7,A0A3Q0KUG5,T1FY40,1YVU,1Z26,5AWH,5G5T,6QZK,7R8K,E8N0K8,A0A1I7IXT4,A0A2W1JZ37,A0A2S7WBN3,A0A328VKE4,A0A420DFE6,E0ST67,A0A4V1VDY2,A0A368P5I0,C4L1M1,A0A4R1RMM2,A0A1Y2RDH8,A0A1M5ZSR3,A0A0K8QX04,A0A0M2PXX3,A0A1I3LMA1,K9TPA9,A0A1L3JHM3,A0A1W6MIP2,A0A1C0UUC4,A0A2U2J9E0,A0A0F4NXW8,A0A142XB92,L8D0R3,A0A326U7G5,K9U8J6,A0A097QRL6,K9RC91,A0A139XGN8,A0A1T4Y3A2,Q5P0R2,B6YTQ5,A0A0B0H9B4,A0YYT3,A0A2T1EFY0,G6FTN0,R6KUL9,A0A433NB65,A0A1Z4L0A1,K9UQR0,A0A2T1G8M7,K9VUN0,B7GJX9,A0A0P6X5X2,K9ZDE3,B0JXD6,A0A2T1LS63,A0A1Z4K1Y3,A0A2Z6E0R7,A0A1N6SSK9,A0A0P4UVI8,A0A0V7ZCG4,A0A1J0AGK2,K9PFF9,A0A2G9DT08,K9UEV4,Q9L1X1,A0A060HNJ0,A0A235B542,R5XQK4,A0A1H3LE92,A0A496APJ8,A0A062U2W9,H0HWQ5,A0A1V9G9U4,A0A1I2ZGP1,A0A317EJY3,A0A1I2BD20,F8ERC7,S7VLM7,A0A1A5X8H4,A0A1I2T6Q1,A0A1R3T9N6,A0A0Q2M2Z1,H8KXJ0,D3S0S6,A0A2D1U4H7,I3TE64,A0A0B7I4Z6,A0LL61,A0A139WY18,A0A2T1E1K4,A0A1Q8ZD62,A0A4Q6XKV6,A0A1Z3HNN4,A0A239JE83,A0A2N4XBY2,R5JEI2,A0A0Q0ZC47,A0A2T0XH18,A0A1V4CHV0,A0A1K1RQP7,A0A1N6LUI7,A0A0P0NGR6,A0A1X7IML5,A0A0A2LKJ7,K1L112,A0A0U3AL92,A0A1H3A054,B9LVW4,A0A0C5JKF3,R5NJJ8,A5D4D9,A0A142Y7A9,A0A432MEQ5,A0A372DKU2,A0A3R7KLK4,C1F5Q7,A0A4R3EV39,A0A1P8WP90,A0A222F7P0,A0A1C9VH88,A0A2T2YMB1,A0A329TD61,A0A101R2A0,A0A1E3XF49,A0A1U9ND56,A0A4R7BQC4,A0A1H3DGN3,A0A1Q1FPH0,E0TGY3,A0A259TUP4,F6EYI8,A0A2S9Q9J0,A0A4Q2UIU6,A0A1H0LH25,A0A318LG42,H1YCU5,L0JS08,A0A1Q5ZS75,A0A345E7N0,M0AF24,A0A1W2A082,A0A1H3X247,A0A0C1XUA0,M0D2X3,A0A2R5G167,A0A346PK63,R7RTW6,A0A1H2RBI2,A0A1C3ZXN2,B9LVP8,M5RSF0,B7K585,F8D8G0,A0A343TL88,L0AJX6,A0A2A5QS34,A0A343JEE2,A0A3P3RGE5,A0A329TBQ3,A0A285N2A8,A0A0W1S8B8,A0A1V4C8L7,L9VRQ2,E4NRV1,A0A1I6HGN0,A0A1I0NI68,,",366,37
"1063","C.H10.1","C.H10.3",355,179,176,3.15594845099035,"4F1N,4F3T,4KRE,5GUH,5VM9,6KR6,6OON,7KX7,7SWF,A0A163JTZ6,J9D5G4,Q389P5,C4LVV2,A0A2P6N8X7,A8BCK6,A2DPV7,A0A0G4H2S4,R1FDF0,D2VMG4,A0A074TLL7,A0A0D1ZAJ4,Q1K660,F4PH46,A0A3M7S814,A0A164ZA52,A0A383WDW5,Q54G64,S7WCF7,I0YVB2,R7QGN7,C1DZY0,A0A2C5Z0M1,A0CB11,R9ACY5,D3BMP8,A0A1Z5TVE5,W7XD45,A0A1U7LLR0,A0A4S2MWZ7,K1VVQ6,A0A158P1R9,G7DVX0,V6R0U9,G4N9J3,E3KLI3,B7Q5I1,A0A1E3QC61,D5GGK8,S8ANP9,A0A139AUH8,L2GMR6,U4LBG4,A0A177URI1,O74957,A0A3N4IGK1,A6N7Y9,A0A0E9NDK5,T1KZ60,A0A250WXN5,A0A2G8JLH3,Q5KAT1,L2GUF2,W2T741,A0A1W0E4B5,A0A2J7QB22,S4RYE2,A0A2K3CW87,A0A388KES6,A0A226EFL3,A0A3S3PD82,A0A0L0TEV1,A0A1S3J512,G0QTT2,A0A1J1HRI1,C4V9J2,Q9JMB7,A0A075AN09,Q5TW24,U5HIG6,A0A401PRI6,Q96J94,A0A2B4RHN2,G2QEV0,A0A397UU01,A0A2T7PFL8,K7ISV0,A0A024FT57,H3HCL6,A0A0G4IME3,E9FUN9,A0A1S3CYL5,D7FQK3,A0A1Y1YHC8,T1GSU4,F4S231,A0A1D8PMK0,A0A2G5B1D8,Q5BD61,A0A1C7M8P2,A0A4D8YSQ3,A0A158PJG6,J9JZ66,A0A0C2XG51,A0A158QZT6,A0A165QYQ9,T0SAU8,R7YY92,A0A3S1A0C3,A0A074YJ47,A0A2K1J482,A0A1Q3ENA6,O04379,A0A371I3C8,M8AEW7,A8P0D4,A0A2K3NY65,F4NYW7,A0A409Y6G2,A0A0L0HAB7,D8PZT7,A0A1D1W4K0,A7RQ46,W4YU94,A7BJS5,D8SNM6,A0A1J8PPA3,X1WG39,M5FQK2,Q69VD5,A0A2R6NSC2,A0A0D8XL16,A0A016WPN3,Q9QZ81,G5EES3,A0A0K0EFP6,Q8CJG0,A0A1D5NTU6,V2WTL2,A0A0V0YLH8,A0A139WDH0,A0A0R3W9Q7,H3DS31,A0A1Y1HWP2,G4T5G9,B7QCC4,A0A0B2UV00,M7BCJ9,E9GN30,Q7PZ41,A0A077Z361,R7U9I3,A0A1X7V1N5,A0A0K0JDP1,A0A0N4UKJ1,A0A498N3A3,A0A3M0IQP5,A0A0L8GBV4,Q32KD4,A0A1J1JBJ0,E0W4C3,A0A482XDA9,A0A3P7EJD6,J9K2Z4,A0A2J7Q8V4,T1IBM6,V3ZRX0,A0A210QKF7,A0A423TSS1,K1PT78,A0A267E8R7,A0A1D2N447,A0A226D7A9,F6YK55,T1KTE4,A0A2C9JGZ6,A0A1V9X9F0,K5X5Z7,A0A3Q0KUG5,T1FY40,1YVU,1Z26,5AWH,5G5T,5I4A,6QZK,7R8K,A0A1I7IXT4,A0A2W1JZ37,A0A2S7WBN3,A0A328VKE4,A0A420DFE6,A0A4V1VDY2,A0A368P5I0,C4L1M1,A0A4R1RMM2,A0A1Y2RDH8,Q11QW7,A0A1M5ZSR3,A0A0K8QX04,A0A0M2PXX3,K9TPA9,A0A1L3JHM3,A0A1W6MIP2,A0A1C0UUC4,A0A2U2J9E0,A0A2Z6E1D5,A0A0F4NXW8,A0A142XB92,L8D0R3,B1XJG0,A0A326U7G5,A0A3D8L290,H1KXR6,A0A1Q4R485,K9U8J6,A0A097QRL6,K9RC91,A0A0D8ZUC0,A0A139XGN8,A0A1T4Y3A2,Q5P0R2,B6YTQ5,A0A0B0H9B4,A0YYT3,A0A2T1EFY0,G6FTN0,R6KUL9,A0A433NB65,A0A1Z4L0A1,K9UQR0,A0A2T1G8M7,K9VUN0,B7GJX9,K9ZDE3,B0JXD6,A0A2T1LS63,A0A1Z4K1Y3,A0A2Z6E0R7,A0A1N6SSK9,A0A0P4UVI8,A0A0V7ZCG4,A0A1J0AGK2,K9PFF9,A0A2G9DT08,K9UEV4,Q9L1X1,A0A060HNJ0,A0A235B542,R5XQK4,A0A1H3LE92,A0A496APJ8,A0A062U2W9,H0HWQ5,A0A1V9G9U4,A0A1I2ZGP1,A0A317EJY3,A0A1I2BD20,F8ERC7,A0A1A5X8H4,A0A1I2T6Q1,A0A1R3T9N6,A0A0Q2M2Z1,H8KXJ0,D3S0S6,A0A2D1U4H7,I3TE64,A0A0B7I4Z6,A0LL61,Q8DKB1,A0A139WY18,A0A1J1EK56,A0A2T1E1K4,A0A1Q8ZD62,A0A4Q6XKV6,A0A1Z3HNN4,A0A239JE83,A0A2N4XBY2,Q53W94,R5JEI2,A0A0Q0ZC47,A0A2T0XH18,A0A1V4CHV0,A0A1K1RQP7,A0A2T1EKT1,A0A1N6LUI7,A0A0P0NGR6,A0A1X7IML5,A0A0A2LKJ7,K1L112,A0A0U3AL92,A0A1H3A054,E0UCX3,K9XZC6,A0A0C1VHB4,Q31N05,A0A0C5JKF3,R5NJJ8,A5D4D9,Q2JI93,A0A142Y7A9,A0A432MEQ5,A0A372DKU2,A0A3R7KLK4,C1F5Q7,A0A4R3EV39,A0A1P8WP90,A0A222F7P0,A0A1C9VH88,A0A2T2YMB1,A0A329TD61,A0A101R2A0,A0A1E3XF49,A0A1U9ND56,A0A4R7BQC4,A0A1H3DGN3,A0A1Q1FPH0,E0TGY3,A0A259TUP4,F6EYI8,A0A2S9Q9J0,A0A4Q2UIU6,A0A1H0LH25,A0A318LG42,H1YCU5,L0JS08,A0A1Q5ZS75,A0A345E7N0,M0AF24,A0A1W2A082,A0A1H3X247,A0A0C1XUA0,M0D2X3,A0A2R5G167,A0A346PK63,R7RTW6,A0A1H2RBI2,A0A1C3ZXN2,B9LVP8,M5RSF0,W0JW77,B7K585,F8D8G0,A0A343TL88,L0AJX6,A0A2A5QS34,A0A343JEE2,A0A3P3RGE5,A0A329TBQ3,A0A285N2A8,A0A0W1S8B8,A0A1V4C8L7,L9VRQ2,E4NRV1,A0A1I6HGN0,A0A1I0NI68,,",366,37
"1064","C.H10.1","C.H10.5",353,179,174,1.63329159442625,"4F1N,4F3T,4KRE,5GUH,5VM9,6KR6,6OON,7KX7,7SWF,A0A163JTZ6,J9D5G4,Q389P5,C4LVV2,A0A2P6N8X7,A8BCK6,A2DPV7,A0A0G4H2S4,R1FDF0,D2VMG4,A0A074TLL7,A0A0D1ZAJ4,Q1K660,F4PH46,A0A3M7S814,A0A164ZA52,A0A383WDW5,Q54G64,S7WCF7,I0YVB2,R7QGN7,C1DZY0,A0A2C5Z0M1,A0CB11,R9ACY5,D3BMP8,A0A1Z5TVE5,W7XD45,A0A1U7LLR0,A0A4S2MWZ7,K1VVQ6,A0A158P1R9,G7DVX0,V6R0U9,G4N9J3,E3KLI3,B7Q5I1,A0A1E3QC61,D5GGK8,S8ANP9,A0A139AUH8,L2GMR6,U4LBG4,A0A177URI1,O74957,A0A3N4IGK1,A6N7Y9,A0A0E9NDK5,T1KZ60,A0A250WXN5,A0A2G8JLH3,Q5KAT1,L2GUF2,W2T741,A0A1W0E4B5,A0A2J7QB22,S4RYE2,A0A2K3CW87,A0A388KES6,A0A226EFL3,A0A3S3PD82,A0A0L0TEV1,A0A1S3J512,G0QTT2,A0A1J1HRI1,C4V9J2,Q9JMB7,A0A075AN09,Q5TW24,U5HIG6,A0A401PRI6,Q96J94,A0A2B4RHN2,G2QEV0,A0A397UU01,A0A2T7PFL8,K7ISV0,A0A024FT57,H3HCL6,A0A0G4IME3,E9FUN9,A0A1S3CYL5,D7FQK3,A0A1Y1YHC8,T1GSU4,F4S231,A0A1D8PMK0,A0A2G5B1D8,Q5BD61,A0A1C7M8P2,A0A4D8YSQ3,A0A158PJG6,J9JZ66,A0A0C2XG51,A0A158QZT6,A0A165QYQ9,T0SAU8,R7YY92,A0A3S1A0C3,A0A074YJ47,A0A2K1J482,A0A1Q3ENA6,O04379,A0A371I3C8,M8AEW7,A8P0D4,A0A2K3NY65,F4NYW7,A0A409Y6G2,A0A0L0HAB7,D8PZT7,A0A1D1W4K0,A7RQ46,W4YU94,A7BJS5,D8SNM6,A0A1J8PPA3,X1WG39,M5FQK2,Q69VD5,A0A2R6NSC2,A0A0D8XL16,A0A016WPN3,Q9QZ81,G5EES3,A0A0K0EFP6,Q8CJG0,A0A1D5NTU6,V2WTL2,A0A0V0YLH8,A0A139WDH0,A0A0R3W9Q7,H3DS31,A0A1Y1HWP2,G4T5G9,B7QCC4,A0A0B2UV00,M7BCJ9,E9GN30,Q7PZ41,A0A077Z361,R7U9I3,A0A1X7V1N5,A0A0K0JDP1,A0A0N4UKJ1,A0A498N3A3,A0A3M0IQP5,A0A0L8GBV4,Q32KD4,A0A1J1JBJ0,E0W4C3,A0A482XDA9,A0A3P7EJD6,J9K2Z4,A0A2J7Q8V4,T1IBM6,V3ZRX0,A0A210QKF7,A0A423TSS1,K1PT78,A0A267E8R7,A0A1D2N447,A0A226D7A9,F6YK55,T1KTE4,A0A2C9JGZ6,A0A1V9X9F0,K5X5Z7,A0A3Q0KUG5,T1FY40,1YVU,1Z26,5AWH,5G5T,5I4A,6QZK,7R8K,A0A1I7IXT4,A0A2W1JZ37,A0A2S7WBN3,A0A328VKE4,A0A420DFE6,A0A4V1VDY2,A0A368P5I0,C4L1M1,A0A4R1RMM2,A0A1Y2RDH8,Q11QW7,A0A1M5ZSR3,A0A0K8QX04,A0A0M2PXX3,K9TPA9,A0A1L3JHM3,A0A1W6MIP2,A0A1C0UUC4,A0A2U2J9E0,A0A2Z6E1D5,A0A0F4NXW8,A0A142XB92,L8D0R3,B1XJG0,A0A326U7G5,A0A3D8L290,H1KXR6,A0A1Q4R485,K9U8J6,A0A097QRL6,K9RC91,A0A0D8ZUC0,A0A139XGN8,A0A1T4Y3A2,Q5P0R2,B6YTQ5,A0A0B0H9B4,A0YYT3,A0A2T1EFY0,G6FTN0,R6KUL9,A0A433NB65,A0A1Z4L0A1,K9UQR0,A0A2T1G8M7,K9VUN0,B7GJX9,K9ZDE3,B0JXD6,A0A2T1LS63,A0A1Z4K1Y3,A0A2Z6E0R7,A0A1N6SSK9,A0A0P4UVI8,A0A0V7ZCG4,A0A1J0AGK2,K9PFF9,A0A2G9DT08,K9UEV4,Q9L1X1,A0A060HNJ0,A0A235B542,R5XQK4,A0A1H3LE92,A0A496APJ8,A0A062U2W9,H0HWQ5,A0A1V9G9U4,A0A1I2ZGP1,A0A317EJY3,A0A1I2BD20,F8ERC7,A0A1A5X8H4,A0A1I2T6Q1,A0A1R3T9N6,A0A0Q2M2Z1,H8KXJ0,D3S0S6,A0A2D1U4H7,I3TE64,A0A0B7I4Z6,A0LL61,Q8DKB1,A0A139WY18,A0A1J1EK56,A0A2T1E1K4,A0A1Q8ZD62,A0A4Q6XKV6,A0A1Z3HNN4,A0A239JE83,A0A2N4XBY2,Q53W94,R5JEI2,A0A0Q0ZC47,A0A2T0XH18,A0A1V4CHV0,A0A1K1RQP7,A0A2T1EKT1,A0A1N6LUI7,A0A0P0NGR6,A0A1X7IML5,A0A0A2LKJ7,K1L112,A0A0U3AL92,A0A1H3A054,E0UCX3,K9XZC6,A0A0C1VHB4,Q31N05,A0A0C5JKF3,R5NJJ8,A5D4D9,Q2JI93,A0A142Y7A9,A0A432MEQ5,A0A372DKU2,A0A3R7KLK4,C1F5Q7,A0A4R3EV39,A0A1P8WP90,A0A222F7P0,A0A1C9VH88,A0A2T2YMB1,A0A329TD61,A0A101R2A0,A0A1E3XF49,A0A1U9ND56,A0A4R7BQC4,A0A1H3DGN3,A0A1Q1FPH0,E0TGY3,A0A259TUP4,F6EYI8,A0A2S9Q9J0,A0A4Q2UIU6,A0A1H0LH25,A0A318LG42,L0JS08,A0A345E7N0,M0AF24,A0A1W2A082,A0A1H3X247,A0A0C1XUA0,M0D2X3,A0A2R5G167,A0A346PK63,R7RTW6,A0A1H2RBI2,A0A1C3ZXN2,B9LVP8,M5RSF0,W0JW77,B7K585,F8D8G0,A0A343TL88,L0AJX6,A0A2A5QS34,A0A343JEE2,A0A3P3RGE5,A0A329TBQ3,A0A285N2A8,A0A0W1S8B8,A0A1V4C8L7,L9VRQ2,E4NRV1,A0A1I6HGN0,A0A1I0NI68,,",366,37
"1065","C.H10.10","C.H10.6",337,179,158,3.01652994837706,"4F1N,4F3T,4KRE,5GUH,5VM9,6KR6,6OON,7KX7,7SWF,A0A163JTZ6,J9D5G4,Q389P5,C4LVV2,A0A2P6N8X7,A8BCK6,A2DPV7,A0A0G4H2S4,R1FDF0,D2VMG4,A0A074TLL7,A0A0D1ZAJ4,Q1K660,F4PH46,A0A3M7S814,A0A164ZA52,A0A383WDW5,Q54G64,S7WCF7,I0YVB2,R7QGN7,C1DZY0,A0A2C5Z0M1,A0CB11,R9ACY5,D3BMP8,A0A1Z5TVE5,W7XD45,A0A1U7LLR0,A0A4S2MWZ7,K1VVQ6,A0A158P1R9,G7DVX0,V6R0U9,G4N9J3,E3KLI3,B7Q5I1,A0A1E3QC61,D5GGK8,S8ANP9,A0A139AUH8,L2GMR6,U4LBG4,A0A177URI1,O74957,A0A3N4IGK1,A6N7Y9,A0A0E9NDK5,T1KZ60,A0A250WXN5,A0A2G8JLH3,Q5KAT1,L2GUF2,W2T741,A0A1W0E4B5,A0A2J7QB22,S4RYE2,A0A2K3CW87,A0A388KES6,A0A226EFL3,A0A3S3PD82,A0A0L0TEV1,A0A1S3J512,G0QTT2,A0A1J1HRI1,C4V9J2,Q9JMB7,A0A075AN09,Q5TW24,U5HIG6,A0A401PRI6,Q96J94,A0A2B4RHN2,G2QEV0,A0A397UU01,A0A2T7PFL8,K7ISV0,A0A024FT57,H3HCL6,A0A0G4IME3,E9FUN9,A0A1S3CYL5,D7FQK3,A0A1Y1YHC8,T1GSU4,F4S231,A0A1D8PMK0,A0A2G5B1D8,Q5BD61,A0A1C7M8P2,A0A4D8YSQ3,A0A158PJG6,J9JZ66,A0A0C2XG51,A0A158QZT6,A0A165QYQ9,T0SAU8,R7YY92,A0A3S1A0C3,A0A074YJ47,A0A2K1J482,A0A1Q3ENA6,O04379,A0A371I3C8,M8AEW7,A8P0D4,A0A2K3NY65,F4NYW7,A0A409Y6G2,A0A0L0HAB7,D8PZT7,A0A1D1W4K0,A7RQ46,W4YU94,A7BJS5,D8SNM6,A0A1J8PPA3,X1WG39,M5FQK2,Q69VD5,A0A2R6NSC2,A0A0D8XL16,A0A016WPN3,Q9QZ81,G5EES3,A0A0K0EFP6,Q8CJG0,A0A1D5NTU6,V2WTL2,A0A0V0YLH8,A0A139WDH0,A0A0R3W9Q7,H3DS31,A0A1Y1HWP2,G4T5G9,B7QCC4,A0A0B2UV00,M7BCJ9,E9GN30,Q7PZ41,A0A077Z361,R7U9I3,A0A1X7V1N5,A0A0K0JDP1,A0A0N4UKJ1,A0A498N3A3,A0A3M0IQP5,A0A0L8GBV4,Q32KD4,A0A1J1JBJ0,E0W4C3,A0A482XDA9,A0A3P7EJD6,J9K2Z4,A0A2J7Q8V4,T1IBM6,V3ZRX0,A0A210QKF7,A0A423TSS1,K1PT78,A0A267E8R7,A0A1D2N447,A0A226D7A9,F6YK55,T1KTE4,A0A2C9JGZ6,A0A1V9X9F0,K5X5Z7,A0A3Q0KUG5,T1FY40,1YVU,1Z26,5AWH,5G5T,5I4A,6QZK,7R8K,A0A1I7IXT4,A0A2W1JZ37,A0A2S7WBN3,A0A328VKE4,A0A420DFE6,E0ST67,A0A4V1VDY2,A0A368P5I0,C4L1M1,A0A4R1RMM2,A0A1Y2RDH8,Q11QW7,A0A1M5ZSR3,A0A0K8QX04,A0A0M2PXX3,K9TPA9,A0A1L3JHM3,A0A1W6MIP2,A0A1C0UUC4,A0A2U2J9E0,A0A2Z6E1D5,A0A142XB92,L8D0R3,B1XJG0,A0A326U7G5,A0A3D8L290,H1KXR6,A0A1Q4R485,K9U8J6,A0A097QRL6,K9RC91,A0A0D8ZUC0,A0A139XGN8,A0A1T4Y3A2,B6YTQ5,A0A0B0H9B4,A0YYT3,A0A2T1EFY0,G6FTN0,R6KUL9,A0A433NB65,K9UQR0,A0A2T1G8M7,K9VUN0,B7GJX9,K9ZDE3,B0JXD6,A0A2T1LS63,A0A1Z4K1Y3,A0A1N6SSK9,A0A0P4UVI8,A0A0V7ZCG4,A0A1J0AGK2,A0A2G9DT08,K9UEV4,Q9L1X1,A0A060HNJ0,A0A235B542,A0A1H3LE92,A0A496APJ8,A0A1V9G9U4,A0A1I2ZGP1,A0A317EJY3,A0A1I2BD20,F8ERC7,A0A1A5X8H4,A0A1I2T6Q1,A0A1R3T9N6,A0A0Q2M2Z1,H8KXJ0,D3S0S6,A0A2D1U4H7,I3TE64,A0A0B7I4Z6,A0LL61,Q8DKB1,A0A139WY18,A0A1J1EK56,A0A2T1E1K4,A0A1Q8ZD62,A0A4Q6XKV6,A0A1Z3HNN4,A0A239JE83,A0A2N4XBY2,Q53W94,R5JEI2,A0A0Q0ZC47,A0A2T0XH18,A0A1V4CHV0,A0A1K1RQP7,A0A1N6LUI7,A0A0P0NGR6,A0A1X7IML5,A0A0A2LKJ7,K1L112,A0A0U3AL92,A0A1H3A054,E0UCX3,K9XZC6,A0A0C1VHB4,Q31N05,A0A0C5JKF3,R5NJJ8,A5D4D9,Q2JI93,A0A142Y7A9,A0A432MEQ5,A0A372DKU2,C1F5Q7,A0A4R3EV39,A0A1P8WP90,A0A222F7P0,A0A1C9VH88,A0A2T2YMB1,A0A329TD61,A0A101R2A0,A0A1U9ND56,A0A4R7BQC4,A0A1Q1FPH0,E0TGY3,A0A259TUP4,F6EYI8,A0A2S9Q9J0,A0A4Q2UIU6,A0A1H0LH25,A0A318LG42,L0JS08,A0A345E7N0,M0AF24,A0A1H3X247,M0D2X3,A0A2R5G167,A0A346PK63,R7RTW6,B9LVP8,M5RSF0,W0JW77,B7K585,F8D8G0,A0A343TL88,L0AJX6,A0A2A5QS34,A0A343JEE2,A0A3P3RGE5,A0A329TBQ3,A0A285N2A8,A0A0W1S8B8,A0A1V4C8L7,L9VRQ2,E4NRV1,A0A1I6HGN0,,",366,37
"1066","C.H10.10","C.H10.8",331,179,152,1.94736842105263,"4F1N,4F3T,4KRE,5GUH,5VM9,6KR6,6OON,7KX7,7SWF,A0A163JTZ6,J9D5G4,Q389P5,C4LVV2,A0A2P6N8X7,A8BCK6,A2DPV7,A0A0G4H2S4,R1FDF0,D2VMG4,A0A074TLL7,A0A0D1ZAJ4,Q1K660,F4PH46,A0A3M7S814,A0A164ZA52,A0A383WDW5,Q54G64,S7WCF7,I0YVB2,R7QGN7,C1DZY0,A0A2C5Z0M1,A0CB11,R9ACY5,D3BMP8,A0A1Z5TVE5,W7XD45,A0A1U7LLR0,A0A4S2MWZ7,K1VVQ6,A0A158P1R9,G7DVX0,V6R0U9,G4N9J3,E3KLI3,B7Q5I1,A0A1E3QC61,D5GGK8,S8ANP9,A0A139AUH8,L2GMR6,U4LBG4,A0A177URI1,O74957,A0A3N4IGK1,A6N7Y9,A0A0E9NDK5,T1KZ60,A0A250WXN5,A0A2G8JLH3,Q5KAT1,L2GUF2,W2T741,A0A1W0E4B5,A0A2J7QB22,S4RYE2,A0A2K3CW87,A0A388KES6,A0A226EFL3,A0A3S3PD82,A0A0L0TEV1,A0A1S3J512,G0QTT2,A0A1J1HRI1,C4V9J2,Q9JMB7,A0A075AN09,Q5TW24,U5HIG6,A0A401PRI6,Q96J94,A0A2B4RHN2,G2QEV0,A0A397UU01,A0A2T7PFL8,K7ISV0,A0A024FT57,H3HCL6,A0A0G4IME3,E9FUN9,A0A1S3CYL5,D7FQK3,A0A1Y1YHC8,T1GSU4,F4S231,A0A1D8PMK0,A0A2G5B1D8,Q5BD61,A0A1C7M8P2,A0A4D8YSQ3,A0A158PJG6,J9JZ66,A0A0C2XG51,A0A158QZT6,A0A165QYQ9,T0SAU8,R7YY92,A0A3S1A0C3,A0A074YJ47,A0A2K1J482,A0A1Q3ENA6,O04379,A0A371I3C8,M8AEW7,A8P0D4,A0A2K3NY65,F4NYW7,A0A409Y6G2,A0A0L0HAB7,D8PZT7,A0A1D1W4K0,A7RQ46,W4YU94,A7BJS5,D8SNM6,A0A1J8PPA3,X1WG39,M5FQK2,Q69VD5,A0A2R6NSC2,A0A0D8XL16,A0A016WPN3,Q9QZ81,G5EES3,A0A0K0EFP6,Q8CJG0,A0A1D5NTU6,V2WTL2,A0A0V0YLH8,A0A139WDH0,A0A0R3W9Q7,H3DS31,A0A1Y1HWP2,G4T5G9,B7QCC4,A0A0B2UV00,M7BCJ9,E9GN30,Q7PZ41,A0A077Z361,R7U9I3,A0A1X7V1N5,A0A0K0JDP1,A0A0N4UKJ1,A0A498N3A3,A0A3M0IQP5,A0A0L8GBV4,Q32KD4,A0A1J1JBJ0,E0W4C3,A0A482XDA9,A0A3P7EJD6,J9K2Z4,A0A2J7Q8V4,T1IBM6,V3ZRX0,A0A210QKF7,A0A423TSS1,K1PT78,A0A267E8R7,A0A1D2N447,A0A226D7A9,F6YK55,T1KTE4,A0A2C9JGZ6,A0A1V9X9F0,K5X5Z7,A0A3Q0KUG5,T1FY40,1YVU,1Z26,5AWH,5G5T,5I4A,6QZK,7R8K,A0A1I7IXT4,A0A2W1JZ37,A0A2S7WBN3,A0A328VKE4,A0A420DFE6,E0ST67,A0A4V1VDY2,A0A368P5I0,C4L1M1,A0A4R1RMM2,A0A1Y2RDH8,Q11QW7,A0A1M5ZSR3,A0A0K8QX04,A0A0M2PXX3,A0A1L3JHM3,A0A1W6MIP2,A0A1C0UUC4,A0A2U2J9E0,A0A2Z6E1D5,A0A142XB92,L8D0R3,B1XJG0,A0A326U7G5,A0A3D8L290,H1KXR6,A0A1Q4R485,A0A097QRL6,K9RC91,A0A0D8ZUC0,A0A1T4Y3A2,B6YTQ5,A0A0B0H9B4,A0A2T1EFY0,G6FTN0,R6KUL9,A0A433NB65,K9UQR0,K9VUN0,B7GJX9,K9ZDE3,B0JXD6,A0A1Z4K1Y3,A0A1N6SSK9,A0A0P4UVI8,A0A0V7ZCG4,A0A1J0AGK2,A0A2G9DT08,K9UEV4,Q9L1X1,A0A060HNJ0,A0A235B542,A0A1H3LE92,A0A496APJ8,A0A1V9G9U4,A0A1I2ZGP1,A0A317EJY3,A0A1I2BD20,F8ERC7,A0A1A5X8H4,A0A1I2T6Q1,A0A1R3T9N6,A0A0Q2M2Z1,H8KXJ0,D3S0S6,A0A2D1U4H7,I3TE64,A0A0B7I4Z6,A0LL61,Q8DKB1,A0A139WY18,A0A1J1EK56,A0A2T1E1K4,A0A1Q8ZD62,A0A4Q6XKV6,A0A1Z3HNN4,A0A239JE83,A0A2N4XBY2,Q53W94,R5JEI2,A0A0Q0ZC47,A0A2T0XH18,A0A1V4CHV0,A0A1K1RQP7,A0A1N6LUI7,A0A0P0NGR6,A0A1X7IML5,A0A0A2LKJ7,K1L112,A0A0U3AL92,A0A1H3A054,E0UCX3,K9XZC6,A0A0C1VHB4,Q31N05,A0A0C5JKF3,R5NJJ8,A5D4D9,Q2JI93,A0A142Y7A9,A0A432MEQ5,A0A372DKU2,C1F5Q7,A0A4R3EV39,A0A1P8WP90,A0A222F7P0,A0A1C9VH88,A0A2T2YMB1,A0A329TD61,A0A101R2A0,A0A1U9ND56,A0A4R7BQC4,A0A1Q1FPH0,E0TGY3,A0A259TUP4,F6EYI8,A0A2S9Q9J0,A0A4Q2UIU6,A0A1H0LH25,A0A318LG42,L0JS08,A0A345E7N0,M0AF24,A0A1H3X247,M0D2X3,A0A2R5G167,A0A346PK63,R7RTW6,B9LVP8,M5RSF0,W0JW77,B7K585,F8D8G0,A0A343TL88,L0AJX6,A0A2A5QS34,A0A343JEE2,A0A3P3RGE5,A0A329TBQ3,A0A285N2A8,A0A0W1S8B8,A0A1V4C8L7,L9VRQ2,E4NRV1,A0A1I6HGN0,,",366,37
"1067","C.H10.11","C.H10.7",313,179,134,2.36071041440841,"4F1N,4F3T,4KRE,5GUH,5VM9,6KR6,6OON,7KX7,7SWF,A0A163JTZ6,J9D5G4,Q389P5,C4LVV2,A0A2P6N8X7,A8BCK6,A2DPV7,A0A0G4H2S4,R1FDF0,D2VMG4,A0A074TLL7,A0A0D1ZAJ4,Q1K660,F4PH46,A0A3M7S814,A0A164ZA52,A0A383WDW5,Q54G64,S7WCF7,I0YVB2,R7QGN7,C1DZY0,A0A2C5Z0M1,A0CB11,R9ACY5,D3BMP8,A0A1Z5TVE5,W7XD45,A0A1U7LLR0,A0A4S2MWZ7,K1VVQ6,A0A158P1R9,G7DVX0,V6R0U9,G4N9J3,E3KLI3,B7Q5I1,A0A1E3QC61,D5GGK8,S8ANP9,A0A139AUH8,L2GMR6,U4LBG4,A0A177URI1,O74957,A0A3N4IGK1,A6N7Y9,A0A0E9NDK5,T1KZ60,A0A250WXN5,A0A2G8JLH3,Q5KAT1,L2GUF2,W2T741,A0A1W0E4B5,A0A2J7QB22,S4RYE2,A0A2K3CW87,A0A388KES6,A0A226EFL3,A0A3S3PD82,A0A0L0TEV1,A0A1S3J512,G0QTT2,A0A1J1HRI1,C4V9J2,Q9JMB7,A0A075AN09,Q5TW24,U5HIG6,A0A401PRI6,Q96J94,A0A2B4RHN2,G2QEV0,A0A397UU01,A0A2T7PFL8,K7ISV0,A0A024FT57,H3HCL6,A0A0G4IME3,E9FUN9,A0A1S3CYL5,D7FQK3,A0A1Y1YHC8,T1GSU4,F4S231,A0A1D8PMK0,A0A2G5B1D8,Q5BD61,A0A1C7M8P2,A0A4D8YSQ3,A0A158PJG6,J9JZ66,A0A0C2XG51,A0A158QZT6,A0A165QYQ9,T0SAU8,R7YY92,A0A3S1A0C3,A0A074YJ47,A0A2K1J482,A0A1Q3ENA6,O04379,A0A371I3C8,M8AEW7,A8P0D4,A0A2K3NY65,F4NYW7,A0A409Y6G2,A0A0L0HAB7,D8PZT7,A0A1D1W4K0,A7RQ46,W4YU94,A7BJS5,D8SNM6,A0A1J8PPA3,X1WG39,M5FQK2,Q69VD5,A0A2R6NSC2,A0A0D8XL16,A0A016WPN3,Q9QZ81,G5EES3,A0A0K0EFP6,Q8CJG0,A0A1D5NTU6,V2WTL2,A0A0V0YLH8,A0A139WDH0,A0A0R3W9Q7,H3DS31,A0A1Y1HWP2,G4T5G9,B7QCC4,A0A0B2UV00,M7BCJ9,E9GN30,Q7PZ41,A0A077Z361,R7U9I3,A0A1X7V1N5,A0A0K0JDP1,A0A0N4UKJ1,A0A498N3A3,A0A3M0IQP5,A0A0L8GBV4,Q32KD4,A0A1J1JBJ0,E0W4C3,A0A482XDA9,A0A3P7EJD6,J9K2Z4,A0A2J7Q8V4,T1IBM6,V3ZRX0,A0A210QKF7,A0A423TSS1,K1PT78,A0A267E8R7,A0A1D2N447,A0A226D7A9,F6YK55,T1KTE4,A0A2C9JGZ6,A0A1V9X9F0,K5X5Z7,A0A3Q0KUG5,T1FY40,1YVU,1Z26,5AWH,5G5T,5I4A,6QZK,A0A1I7IXT4,A0A2W1JZ37,A0A2S7WBN3,A0A328VKE4,A0A420DFE6,E0ST67,A0A4V1VDY2,A0A368P5I0,C4L1M1,A0A4R1RMM2,A0A1Y2RDH8,Q11QW7,A0A1M5ZSR3,A0A0K8QX04,A0A0M2PXX3,A0A1L3JHM3,A0A1W6MIP2,A0A1C0UUC4,A0A2U2J9E0,L8D0R3,B1XJG0,A0A326U7G5,A0A3D8L290,H1KXR6,A0A1Q4R485,A0A097QRL6,K9RC91,A0A1T4Y3A2,B6YTQ5,A0A0B0H9B4,R6KUL9,A0A433NB65,K9UQR0,K9VUN0,B7GJX9,K9ZDE3,B0JXD6,A0A2T1LS63,A0A1Z4K1Y3,A0A1N6SSK9,A0A0P4UVI8,A0A1J0AGK2,A0A2G9DT08,K9UEV4,Q9L1X1,A0A060HNJ0,A0A235B542,A0A496APJ8,A0A1V9G9U4,A0A1I2ZGP1,A0A317EJY3,F8ERC7,A0A1A5X8H4,A0A1I2T6Q1,A0A0Q2M2Z1,H8KXJ0,A0A2D1U4H7,I3TE64,A0A0B7I4Z6,A0LL61,A0A139WY18,A0A1J1EK56,A0A2T1E1K4,A0A1Q8ZD62,A0A4Q6XKV6,A0A1Z3HNN4,A0A239JE83,A0A2N4XBY2,Q53W94,R5JEI2,A0A2T0XH18,A0A1V4CHV0,A0A1K1RQP7,A0A1N6LUI7,A0A0P0NGR6,A0A1X7IML5,A0A0A2LKJ7,K1L112,A0A0U3AL92,A0A1H3A054,E0UCX3,K9XZC6,A0A0C1VHB4,A0A0C5JKF3,R5NJJ8,A5D4D9,A0A142Y7A9,A0A432MEQ5,A0A372DKU2,C1F5Q7,A0A4R3EV39,A0A1P8WP90,A0A222F7P0,A0A1C9VH88,A0A2T2YMB1,A0A329TD61,A0A101R2A0,A0A1U9ND56,A0A4R7BQC4,A0A1Q1FPH0,E0TGY3,A0A259TUP4,F6EYI8,A0A2S9Q9J0,A0A4Q2UIU6,A0A1H0LH25,A0A318LG42,L0JS08,M0AF24,M0D2X3,A0A2R5G167,A0A346PK63,R7RTW6,B9LVP8,M5RSF0,W0JW77,B7K585,F8D8G0,A0A343TL88,L0AJX6,A0A3P3RGE5,A0A329TBQ3,A0A285N2A8,A0A0W1S8B8,A0A1V4C8L7,L9VRQ2,E4NRV1,A0A1I6HGN0,,",366,37
"1068","C.H10.11","C.H10.8",304,179,125,2.34096089385475,"4F1N,4F3T,4KRE,5GUH,5VM9,6KR6,6OON,7KX7,7SWF,A0A163JTZ6,J9D5G4,Q389P5,C4LVV2,A0A2P6N8X7,A8BCK6,A2DPV7,A0A0G4H2S4,R1FDF0,D2VMG4,A0A074TLL7,A0A0D1ZAJ4,Q1K660,F4PH46,A0A3M7S814,A0A164ZA52,A0A383WDW5,Q54G64,S7WCF7,I0YVB2,R7QGN7,C1DZY0,A0A2C5Z0M1,A0CB11,R9ACY5,D3BMP8,A0A1Z5TVE5,W7XD45,A0A1U7LLR0,A0A4S2MWZ7,K1VVQ6,A0A158P1R9,G7DVX0,V6R0U9,G4N9J3,E3KLI3,B7Q5I1,A0A1E3QC61,D5GGK8,S8ANP9,A0A139AUH8,L2GMR6,U4LBG4,A0A177URI1,O74957,A0A3N4IGK1,A6N7Y9,A0A0E9NDK5,T1KZ60,A0A250WXN5,A0A2G8JLH3,Q5KAT1,L2GUF2,W2T741,A0A1W0E4B5,A0A2J7QB22,S4RYE2,A0A2K3CW87,A0A388KES6,A0A226EFL3,A0A3S3PD82,A0A0L0TEV1,A0A1S3J512,G0QTT2,A0A1J1HRI1,C4V9J2,Q9JMB7,A0A075AN09,Q5TW24,U5HIG6,A0A401PRI6,Q96J94,A0A2B4RHN2,G2QEV0,A0A397UU01,A0A2T7PFL8,K7ISV0,A0A024FT57,H3HCL6,A0A0G4IME3,E9FUN9,A0A1S3CYL5,D7FQK3,A0A1Y1YHC8,T1GSU4,F4S231,A0A1D8PMK0,A0A2G5B1D8,Q5BD61,A0A1C7M8P2,A0A4D8YSQ3,A0A158PJG6,J9JZ66,A0A0C2XG51,A0A158QZT6,A0A165QYQ9,T0SAU8,R7YY92,A0A3S1A0C3,A0A074YJ47,A0A2K1J482,A0A1Q3ENA6,O04379,A0A371I3C8,M8AEW7,A8P0D4,A0A2K3NY65,F4NYW7,A0A409Y6G2,A0A0L0HAB7,D8PZT7,A0A1D1W4K0,A7RQ46,W4YU94,A7BJS5,D8SNM6,A0A1J8PPA3,X1WG39,M5FQK2,Q69VD5,A0A2R6NSC2,A0A0D8XL16,A0A016WPN3,Q9QZ81,G5EES3,A0A0K0EFP6,Q8CJG0,A0A1D5NTU6,V2WTL2,A0A0V0YLH8,A0A139WDH0,A0A0R3W9Q7,H3DS31,A0A1Y1HWP2,G4T5G9,B7QCC4,A0A0B2UV00,M7BCJ9,E9GN30,Q7PZ41,A0A077Z361,R7U9I3,A0A1X7V1N5,A0A0K0JDP1,A0A0N4UKJ1,A0A498N3A3,A0A3M0IQP5,A0A0L8GBV4,Q32KD4,A0A1J1JBJ0,E0W4C3,A0A482XDA9,A0A3P7EJD6,J9K2Z4,A0A2J7Q8V4,T1IBM6,V3ZRX0,A0A210QKF7,A0A423TSS1,K1PT78,A0A267E8R7,A0A1D2N447,A0A226D7A9,F6YK55,T1KTE4,A0A2C9JGZ6,A0A1V9X9F0,K5X5Z7,A0A3Q0KUG5,T1FY40,1YVU,1Z26,5AWH,5G5T,5I4A,6QZK,A0A1I7IXT4,A0A2S7WBN3,A0A328VKE4,A0A420DFE6,A0A4V1VDY2,C4L1M1,A0A4R1RMM2,A0A1Y2RDH8,Q11QW7,A0A1M5ZSR3,A0A0K8QX04,A0A0M2PXX3,A0A1L3JHM3,A0A1W6MIP2,A0A1C0UUC4,A0A2U2J9E0,L8D0R3,B1XJG0,A0A326U7G5,A0A3D8L290,A0A1Q4R485,K9RC91,A0A1T4Y3A2,A0A0B0H9B4,R6KUL9,A0A433NB65,K9UQR0,K9VUN0,B7GJX9,K9ZDE3,B0JXD6,A0A1Z4K1Y3,A0A1N6SSK9,A0A0P4UVI8,A0A1J0AGK2,A0A2G9DT08,K9UEV4,Q9L1X1,A0A235B542,A0A496APJ8,A0A1V9G9U4,A0A1I2ZGP1,A0A317EJY3,F8ERC7,A0A1A5X8H4,A0A1I2T6Q1,H8KXJ0,A0A2D1U4H7,I3TE64,A0A0B7I4Z6,A0LL61,A0A139WY18,A0A1J1EK56,A0A2T1E1K4,A0A1Q8ZD62,A0A4Q6XKV6,A0A1Z3HNN4,A0A239JE83,A0A2N4XBY2,Q53W94,R5JEI2,A0A2T0XH18,A0A1V4CHV0,A0A1K1RQP7,A0A1N6LUI7,A0A0P0NGR6,A0A1X7IML5,A0A0A2LKJ7,K1L112,A0A0U3AL92,A0A1H3A054,E0UCX3,K9XZC6,A0A0C1VHB4,A0A0C5JKF3,R5NJJ8,A5D4D9,A0A142Y7A9,A0A432MEQ5,A0A372DKU2,C1F5Q7,A0A4R3EV39,A0A1P8WP90,A0A222F7P0,A0A1C9VH88,A0A2T2YMB1,A0A329TD61,A0A101R2A0,A0A1U9ND56,A0A4R7BQC4,A0A1Q1FPH0,E0TGY3,A0A259TUP4,F6EYI8,A0A2S9Q9J0,A0A4Q2UIU6,A0A1H0LH25,A0A318LG42,L0JS08,M0AF24,M0D2X3,A0A2R5G167,A0A346PK63,R7RTW6,B9LVP8,M5RSF0,W0JW77,B7K585,F8D8G0,A0A343TL88,L0AJX6,A0A3P3RGE5,A0A329TBQ3,A0A285N2A8,A0A0W1S8B8,A0A1V4C8L7,L9VRQ2,E4NRV1,A0A1I6HGN0,,",366,37
"1069","C.H10.11","C.H10.9",313,179,134,1.82389727340949,"4F1N,4F3T,4KRE,5GUH,5VM9,6KR6,6OON,7KX7,7SWF,A0A163JTZ6,J9D5G4,Q389P5,C4LVV2,A0A2P6N8X7,A8BCK6,A2DPV7,A0A0G4H2S4,R1FDF0,D2VMG4,A0A074TLL7,A0A0D1ZAJ4,Q1K660,F4PH46,A0A3M7S814,A0A164ZA52,A0A383WDW5,Q54G64,S7WCF7,I0YVB2,R7QGN7,C1DZY0,A0A2C5Z0M1,A0CB11,R9ACY5,D3BMP8,A0A1Z5TVE5,W7XD45,A0A1U7LLR0,A0A4S2MWZ7,K1VVQ6,A0A158P1R9,G7DVX0,V6R0U9,G4N9J3,E3KLI3,B7Q5I1,A0A1E3QC61,D5GGK8,S8ANP9,A0A139AUH8,L2GMR6,U4LBG4,A0A177URI1,O74957,A0A3N4IGK1,A6N7Y9,A0A0E9NDK5,T1KZ60,A0A250WXN5,A0A2G8JLH3,Q5KAT1,L2GUF2,W2T741,A0A1W0E4B5,A0A2J7QB22,S4RYE2,A0A2K3CW87,A0A388KES6,A0A226EFL3,A0A3S3PD82,A0A0L0TEV1,A0A1S3J512,G0QTT2,A0A1J1HRI1,C4V9J2,Q9JMB7,A0A075AN09,Q5TW24,U5HIG6,A0A401PRI6,Q96J94,A0A2B4RHN2,G2QEV0,A0A397UU01,A0A2T7PFL8,K7ISV0,A0A024FT57,H3HCL6,A0A0G4IME3,E9FUN9,A0A1S3CYL5,D7FQK3,A0A1Y1YHC8,T1GSU4,F4S231,A0A1D8PMK0,A0A2G5B1D8,Q5BD61,A0A1C7M8P2,A0A4D8YSQ3,A0A158PJG6,J9JZ66,A0A0C2XG51,A0A158QZT6,A0A165QYQ9,T0SAU8,R7YY92,A0A3S1A0C3,A0A074YJ47,A0A2K1J482,A0A1Q3ENA6,O04379,A0A371I3C8,M8AEW7,A8P0D4,A0A2K3NY65,F4NYW7,A0A409Y6G2,A0A0L0HAB7,D8PZT7,A0A1D1W4K0,A7RQ46,W4YU94,A7BJS5,D8SNM6,A0A1J8PPA3,X1WG39,M5FQK2,Q69VD5,A0A2R6NSC2,A0A0D8XL16,A0A016WPN3,Q9QZ81,G5EES3,A0A0K0EFP6,Q8CJG0,A0A1D5NTU6,V2WTL2,A0A0V0YLH8,A0A139WDH0,A0A0R3W9Q7,H3DS31,A0A1Y1HWP2,G4T5G9,B7QCC4,A0A0B2UV00,M7BCJ9,E9GN30,Q7PZ41,A0A077Z361,R7U9I3,A0A1X7V1N5,A0A0K0JDP1,A0A0N4UKJ1,A0A498N3A3,A0A3M0IQP5,A0A0L8GBV4,Q32KD4,A0A1J1JBJ0,E0W4C3,A0A482XDA9,A0A3P7EJD6,J9K2Z4,A0A2J7Q8V4,T1IBM6,V3ZRX0,A0A210QKF7,A0A423TSS1,K1PT78,A0A267E8R7,A0A1D2N447,A0A226D7A9,F6YK55,T1KTE4,A0A2C9JGZ6,A0A1V9X9F0,K5X5Z7,A0A3Q0KUG5,T1FY40,1YVU,1Z26,5AWH,5G5T,5I4A,6QZK,A0A1I7IXT4,A0A2W1JZ37,A0A2S7WBN3,A0A328VKE4,A0A420DFE6,E0ST67,A0A4V1VDY2,A0A368P5I0,C4L1M1,A0A4R1RMM2,A0A1Y2RDH8,Q11QW7,A0A1M5ZSR3,A0A0K8QX04,A0A0M2PXX3,A0A1L3JHM3,A0A1W6MIP2,A0A1C0UUC4,A0A2U2J9E0,L8D0R3,B1XJG0,A0A326U7G5,A0A3D8L290,H1KXR6,A0A1Q4R485,A0A097QRL6,K9RC91,A0A1T4Y3A2,B6YTQ5,A0A0B0H9B4,R6KUL9,A0A433NB65,K9UQR0,K9VUN0,B7GJX9,K9ZDE3,B0JXD6,A0A2T1LS63,A0A1Z4K1Y3,A0A1N6SSK9,A0A0P4UVI8,A0A1J0AGK2,A0A2G9DT08,K9UEV4,Q9L1X1,A0A060HNJ0,A0A235B542,A0A496APJ8,A0A1V9G9U4,A0A1I2ZGP1,A0A317EJY3,F8ERC7,A0A1A5X8H4,A0A1I2T6Q1,A0A0Q2M2Z1,H8KXJ0,A0A2D1U4H7,I3TE64,A0A0B7I4Z6,A0LL61,A0A139WY18,A0A1J1EK56,A0A2T1E1K4,A0A1Q8ZD62,A0A4Q6XKV6,A0A1Z3HNN4,A0A239JE83,A0A2N4XBY2,Q53W94,R5JEI2,A0A2T0XH18,A0A1V4CHV0,A0A1K1RQP7,A0A1N6LUI7,A0A0P0NGR6,A0A1X7IML5,A0A0A2LKJ7,K1L112,A0A0U3AL92,A0A1H3A054,E0UCX3,K9XZC6,A0A0C1VHB4,A0A0C5JKF3,R5NJJ8,A5D4D9,A0A142Y7A9,A0A432MEQ5,A0A372DKU2,C1F5Q7,A0A4R3EV39,A0A1P8WP90,A0A222F7P0,A0A1C9VH88,A0A2T2YMB1,A0A329TD61,A0A101R2A0,A0A1U9ND56,A0A4R7BQC4,A0A1Q1FPH0,E0TGY3,A0A259TUP4,F6EYI8,A0A2S9Q9J0,A0A4Q2UIU6,A0A1H0LH25,A0A318LG42,L0JS08,M0AF24,M0D2X3,A0A2R5G167,A0A346PK63,R7RTW6,B9LVP8,M5RSF0,W0JW77,B7K585,F8D8G0,A0A343TL88,L0AJX6,A0A3P3RGE5,A0A329TBQ3,A0A285N2A8,A0A0W1S8B8,A0A1V4C8L7,L9VRQ2,E4NRV1,A0A1I6HGN0,,",366,37
"1073","C.H10.6","C.H10.8",341,179,162,2.02777777777778,"4F1N,4F3T,4KRE,5GUH,5VM9,6KR6,6OON,7KX7,7SWF,A0A163JTZ6,J9D5G4,Q389P5,C4LVV2,A0A2P6N8X7,A8BCK6,A2DPV7,A0A0G4H2S4,R1FDF0,D2VMG4,A0A074TLL7,A0A0D1ZAJ4,Q1K660,F4PH46,A0A3M7S814,A0A164ZA52,A0A383WDW5,Q54G64,S7WCF7,I0YVB2,R7QGN7,C1DZY0,A0A2C5Z0M1,A0CB11,R9ACY5,D3BMP8,A0A1Z5TVE5,W7XD45,A0A1U7LLR0,A0A4S2MWZ7,K1VVQ6,A0A158P1R9,G7DVX0,V6R0U9,G4N9J3,E3KLI3,B7Q5I1,A0A1E3QC61,D5GGK8,S8ANP9,A0A139AUH8,L2GMR6,U4LBG4,A0A177URI1,O74957,A0A3N4IGK1,A6N7Y9,A0A0E9NDK5,T1KZ60,A0A250WXN5,A0A2G8JLH3,Q5KAT1,L2GUF2,W2T741,A0A1W0E4B5,A0A2J7QB22,S4RYE2,A0A2K3CW87,A0A388KES6,A0A226EFL3,A0A3S3PD82,A0A0L0TEV1,A0A1S3J512,G0QTT2,A0A1J1HRI1,C4V9J2,Q9JMB7,A0A075AN09,Q5TW24,U5HIG6,A0A401PRI6,Q96J94,A0A2B4RHN2,G2QEV0,A0A397UU01,A0A2T7PFL8,K7ISV0,A0A024FT57,H3HCL6,A0A0G4IME3,E9FUN9,A0A1S3CYL5,D7FQK3,A0A1Y1YHC8,T1GSU4,F4S231,A0A1D8PMK0,A0A2G5B1D8,Q5BD61,A0A1C7M8P2,A0A4D8YSQ3,A0A158PJG6,J9JZ66,A0A0C2XG51,A0A158QZT6,A0A165QYQ9,T0SAU8,R7YY92,A0A3S1A0C3,A0A074YJ47,A0A2K1J482,A0A1Q3ENA6,O04379,A0A371I3C8,M8AEW7,A8P0D4,A0A2K3NY65,F4NYW7,A0A409Y6G2,A0A0L0HAB7,D8PZT7,A0A1D1W4K0,A7RQ46,W4YU94,A7BJS5,D8SNM6,A0A1J8PPA3,X1WG39,M5FQK2,Q69VD5,A0A2R6NSC2,A0A0D8XL16,A0A016WPN3,Q9QZ81,G5EES3,A0A0K0EFP6,Q8CJG0,A0A1D5NTU6,V2WTL2,A0A0V0YLH8,A0A139WDH0,A0A0R3W9Q7,H3DS31,A0A1Y1HWP2,G4T5G9,B7QCC4,A0A0B2UV00,M7BCJ9,E9GN30,Q7PZ41,A0A077Z361,R7U9I3,A0A1X7V1N5,A0A0K0JDP1,A0A0N4UKJ1,A0A498N3A3,A0A3M0IQP5,A0A0L8GBV4,Q32KD4,A0A1J1JBJ0,E0W4C3,A0A482XDA9,A0A3P7EJD6,J9K2Z4,A0A2J7Q8V4,T1IBM6,V3ZRX0,A0A210QKF7,A0A423TSS1,K1PT78,A0A267E8R7,A0A1D2N447,A0A226D7A9,F6YK55,T1KTE4,A0A2C9JGZ6,A0A1V9X9F0,K5X5Z7,A0A3Q0KUG5,T1FY40,1YVU,1Z26,5AWH,5G5T,5I4A,6QZK,7R8K,A0A1I7IXT4,A0A2W1JZ37,A0A2S7WBN3,A0A328VKE4,A0A420DFE6,E0ST67,A0A4V1VDY2,A0A368P5I0,C4L1M1,A0A4R1RMM2,A0A1Y2RDH8,Q11QW7,A0A1M5ZSR3,A0A0K8QX04,A0A0M2PXX3,A0A1L3JHM3,A0A1W6MIP2,A0A1C0UUC4,A0A2U2J9E0,A0A2Z6E1D5,A0A0F4NXW8,A0A142XB92,L8D0R3,B1XJG0,A0A326U7G5,A0A3D8L290,H1KXR6,A0A1Q4R485,A0A097QRL6,K9RC91,A0A0D8ZUC0,A0A1T4Y3A2,B6YTQ5,A0A0B0H9B4,A0A2T1EFY0,G6FTN0,R6KUL9,A0A433NB65,K9UQR0,K9VUN0,B7GJX9,K9ZDE3,B0JXD6,A0A1Z4K1Y3,A0A2Z6E0R7,A0A1N6SSK9,A0A0P4UVI8,A0A0V7ZCG4,A0A1J0AGK2,A0A2G9DT08,K9UEV4,Q9L1X1,A0A060HNJ0,A0A235B542,A0A1H3LE92,A0A496APJ8,A0A062U2W9,H0HWQ5,A0A1V9G9U4,A0A1I2ZGP1,A0A317EJY3,A0A1I2BD20,F8ERC7,A0A1A5X8H4,A0A1I2T6Q1,A0A1R3T9N6,A0A0Q2M2Z1,H8KXJ0,D3S0S6,A0A2D1U4H7,I3TE64,A0A0B7I4Z6,A0LL61,Q8DKB1,A0A139WY18,A0A1J1EK56,A0A2T1E1K4,A0A1Q8ZD62,A0A4Q6XKV6,A0A1Z3HNN4,A0A239JE83,A0A2N4XBY2,Q53W94,R5JEI2,A0A0Q0ZC47,A0A2T0XH18,A0A1V4CHV0,A0A1K1RQP7,A0A2T1EKT1,A0A1N6LUI7,A0A0P0NGR6,A0A1X7IML5,A0A0A2LKJ7,K1L112,A0A0U3AL92,A0A1H3A054,E0UCX3,K9XZC6,A0A0C1VHB4,Q31N05,A0A0C5JKF3,R5NJJ8,A5D4D9,Q2JI93,A0A142Y7A9,A0A432MEQ5,A0A372DKU2,A0A3R7KLK4,C1F5Q7,A0A4R3EV39,A0A1P8WP90,A0A222F7P0,A0A1C9VH88,A0A2T2YMB1,A0A329TD61,A0A101R2A0,A0A1E3XF49,A0A1U9ND56,A0A4R7BQC4,A0A1Q1FPH0,E0TGY3,A0A259TUP4,F6EYI8,A0A2S9Q9J0,A0A4Q2UIU6,A0A1H0LH25,A0A318LG42,L0JS08,A0A345E7N0,M0AF24,A0A1W2A082,A0A1H3X247,M0D2X3,A0A2R5G167,A0A346PK63,R7RTW6,A0A1H2RBI2,B9LVP8,M5RSF0,W0JW77,B7K585,F8D8G0,A0A343TL88,L0AJX6,A0A2A5QS34,A0A343JEE2,A0A3P3RGE5,A0A329TBQ3,A0A285N2A8,A0A0W1S8B8,A0A1V4C8L7,L9VRQ2,E4NRV1,A0A1I6HGN0,A0A1I0NI68,,",366,37
"1074","C.H10.6","C.H10.9",340,179,161,3.74929733856137,"4F1N,4F3T,4KRE,5GUH,5VM9,6KR6,6OON,7KX7,7SWF,A0A163JTZ6,J9D5G4,Q389P5,C4LVV2,A0A2P6N8X7,A8BCK6,A2DPV7,A0A0G4H2S4,R1FDF0,D2VMG4,A0A074TLL7,A0A0D1ZAJ4,Q1K660,F4PH46,A0A3M7S814,A0A164ZA52,A0A383WDW5,Q54G64,S7WCF7,I0YVB2,R7QGN7,C1DZY0,A0A2C5Z0M1,A0CB11,R9ACY5,D3BMP8,A0A1Z5TVE5,W7XD45,A0A1U7LLR0,A0A4S2MWZ7,K1VVQ6,A0A158P1R9,G7DVX0,V6R0U9,G4N9J3,E3KLI3,B7Q5I1,A0A1E3QC61,D5GGK8,S8ANP9,A0A139AUH8,L2GMR6,U4LBG4,A0A177URI1,O74957,A0A3N4IGK1,A6N7Y9,A0A0E9NDK5,T1KZ60,A0A250WXN5,A0A2G8JLH3,Q5KAT1,L2GUF2,W2T741,A0A1W0E4B5,A0A2J7QB22,S4RYE2,A0A2K3CW87,A0A388KES6,A0A226EFL3,A0A3S3PD82,A0A0L0TEV1,A0A1S3J512,G0QTT2,A0A1J1HRI1,C4V9J2,Q9JMB7,A0A075AN09,Q5TW24,U5HIG6,A0A401PRI6,Q96J94,A0A2B4RHN2,G2QEV0,A0A397UU01,A0A2T7PFL8,K7ISV0,A0A024FT57,H3HCL6,A0A0G4IME3,E9FUN9,A0A1S3CYL5,D7FQK3,A0A1Y1YHC8,T1GSU4,F4S231,A0A1D8PMK0,A0A2G5B1D8,Q5BD61,A0A1C7M8P2,A0A4D8YSQ3,A0A158PJG6,J9JZ66,A0A0C2XG51,A0A158QZT6,A0A165QYQ9,T0SAU8,R7YY92,A0A3S1A0C3,A0A074YJ47,A0A2K1J482,A0A1Q3ENA6,O04379,A0A371I3C8,M8AEW7,A8P0D4,A0A2K3NY65,F4NYW7,A0A409Y6G2,A0A0L0HAB7,D8PZT7,A0A1D1W4K0,A7RQ46,W4YU94,A7BJS5,D8SNM6,A0A1J8PPA3,X1WG39,M5FQK2,Q69VD5,A0A2R6NSC2,A0A0D8XL16,A0A016WPN3,Q9QZ81,G5EES3,A0A0K0EFP6,Q8CJG0,A0A1D5NTU6,V2WTL2,A0A0V0YLH8,A0A139WDH0,A0A0R3W9Q7,H3DS31,A0A1Y1HWP2,G4T5G9,B7QCC4,A0A0B2UV00,M7BCJ9,E9GN30,Q7PZ41,A0A077Z361,R7U9I3,A0A1X7V1N5,A0A0K0JDP1,A0A0N4UKJ1,A0A498N3A3,A0A3M0IQP5,A0A0L8GBV4,Q32KD4,A0A1J1JBJ0,E0W4C3,A0A482XDA9,A0A3P7EJD6,J9K2Z4,A0A2J7Q8V4,T1IBM6,V3ZRX0,A0A210QKF7,A0A423TSS1,K1PT78,A0A267E8R7,A0A1D2N447,A0A226D7A9,F6YK55,T1KTE4,A0A2C9JGZ6,A0A1V9X9F0,K5X5Z7,A0A3Q0KUG5,T1FY40,1YVU,1Z26,5AWH,5G5T,5I4A,6QZK,A0A1I7IXT4,A0A2W1JZ37,A0A2S7WBN3,A0A328VKE4,A0A420DFE6,E0ST67,A0A4V1VDY2,A0A368P5I0,C4L1M1,A0A4R1RMM2,A0A1Y2RDH8,Q11QW7,A0A1M5ZSR3,A0A0K8QX04,A0A0M2PXX3,K9TPA9,A0A1L3JHM3,A0A1W6MIP2,A0A1C0UUC4,A0A2U2J9E0,A0A2Z6E1D5,A0A0F4NXW8,A0A142XB92,L8D0R3,B1XJG0,A0A326U7G5,A0A3D8L290,H1KXR6,A0A1Q4R485,K9U8J6,A0A097QRL6,K9RC91,A0A0D8ZUC0,A0A139XGN8,A0A1T4Y3A2,B6YTQ5,A0A0B0H9B4,A0YYT3,A0A2T1EFY0,G6FTN0,R6KUL9,A0A433NB65,K9UQR0,A0A2T1G8M7,K9VUN0,B7GJX9,K9ZDE3,B0JXD6,A0A2T1LS63,A0A1Z4K1Y3,A0A2Z6E0R7,A0A1N6SSK9,A0A0P4UVI8,A0A0V7ZCG4,A0A1J0AGK2,A0A2G9DT08,K9UEV4,Q9L1X1,A0A060HNJ0,A0A235B542,A0A1H3LE92,A0A496APJ8,A0A1V9G9U4,A0A1I2ZGP1,A0A317EJY3,A0A1I2BD20,F8ERC7,A0A1A5X8H4,A0A1I2T6Q1,A0A1R3T9N6,A0A0Q2M2Z1,H8KXJ0,D3S0S6,A0A2D1U4H7,I3TE64,A0A0B7I4Z6,A0LL61,Q8DKB1,A0A139WY18,A0A1J1EK56,A0A2T1E1K4,A0A1Q8ZD62,A0A4Q6XKV6,A0A1Z3HNN4,A0A239JE83,A0A2N4XBY2,Q53W94,R5JEI2,A0A0Q0ZC47,A0A2T0XH18,A0A1V4CHV0,A0A1K1RQP7,A0A2T1EKT1,A0A1N6LUI7,A0A0P0NGR6,A0A1X7IML5,A0A0A2LKJ7,K1L112,A0A0U3AL92,A0A1H3A054,E0UCX3,K9XZC6,A0A0C1VHB4,Q31N05,A0A0C5JKF3,R5NJJ8,A5D4D9,Q2JI93,A0A142Y7A9,A0A432MEQ5,A0A372DKU2,C1F5Q7,A0A4R3EV39,A0A1P8WP90,A0A222F7P0,A0A1C9VH88,A0A2T2YMB1,A0A329TD61,A0A101R2A0,A0A1U9ND56,A0A4R7BQC4,A0A1Q1FPH0,E0TGY3,A0A259TUP4,F6EYI8,A0A2S9Q9J0,A0A4Q2UIU6,A0A1H0LH25,A0A318LG42,L0JS08,A0A345E7N0,M0AF24,A0A1H3X247,M0D2X3,A0A2R5G167,A0A346PK63,R7RTW6,B9LVP8,M5RSF0,W0JW77,B7K585,F8D8G0,A0A343TL88,L0AJX6,A0A2A5QS34,A0A343JEE2,A0A3P3RGE5,A0A329TBQ3,A0A285N2A8,A0A0W1S8B8,A0A1V4C8L7,L9VRQ2,E4NRV1,A0A1I6HGN0,A0A1I0NI68,,",366,37
"1075","C.H10.7","C.H10.9",340,179,161,1.85159096429439,"4F1N,4F3T,4KRE,5GUH,5VM9,6KR6,6OON,7KX7,7SWF,A0A163JTZ6,J9D5G4,Q389P5,C4LVV2,A0A2P6N8X7,A8BCK6,A2DPV7,A0A0G4H2S4,R1FDF0,D2VMG4,A0A074TLL7,A0A0D1ZAJ4,Q1K660,F4PH46,A0A3M7S814,A0A164ZA52,A0A383WDW5,Q54G64,S7WCF7,I0YVB2,R7QGN7,C1DZY0,A0A2C5Z0M1,A0CB11,R9ACY5,D3BMP8,A0A1Z5TVE5,W7XD45,A0A1U7LLR0,A0A4S2MWZ7,K1VVQ6,A0A158P1R9,G7DVX0,V6R0U9,G4N9J3,E3KLI3,B7Q5I1,A0A1E3QC61,D5GGK8,S8ANP9,A0A139AUH8,L2GMR6,U4LBG4,A0A177URI1,O74957,A0A3N4IGK1,A6N7Y9,A0A0E9NDK5,T1KZ60,A0A250WXN5,A0A2G8JLH3,Q5KAT1,L2GUF2,W2T741,A0A1W0E4B5,A0A2J7QB22,S4RYE2,A0A2K3CW87,A0A388KES6,A0A226EFL3,A0A3S3PD82,A0A0L0TEV1,A0A1S3J512,G0QTT2,A0A1J1HRI1,C4V9J2,Q9JMB7,A0A075AN09,Q5TW24,U5HIG6,A0A401PRI6,Q96J94,A0A2B4RHN2,G2QEV0,A0A397UU01,A0A2T7PFL8,K7ISV0,A0A024FT57,H3HCL6,A0A0G4IME3,E9FUN9,A0A1S3CYL5,D7FQK3,A0A1Y1YHC8,T1GSU4,F4S231,A0A1D8PMK0,A0A2G5B1D8,Q5BD61,A0A1C7M8P2,A0A4D8YSQ3,A0A158PJG6,J9JZ66,A0A0C2XG51,A0A158QZT6,A0A165QYQ9,T0SAU8,R7YY92,A0A3S1A0C3,A0A074YJ47,A0A2K1J482,A0A1Q3ENA6,O04379,A0A371I3C8,M8AEW7,A8P0D4,A0A2K3NY65,F4NYW7,A0A409Y6G2,A0A0L0HAB7,D8PZT7,A0A1D1W4K0,A7RQ46,W4YU94,A7BJS5,D8SNM6,A0A1J8PPA3,X1WG39,M5FQK2,Q69VD5,A0A2R6NSC2,A0A0D8XL16,A0A016WPN3,Q9QZ81,G5EES3,A0A0K0EFP6,Q8CJG0,A0A1D5NTU6,V2WTL2,A0A0V0YLH8,A0A139WDH0,A0A0R3W9Q7,H3DS31,A0A1Y1HWP2,G4T5G9,B7QCC4,A0A0B2UV00,M7BCJ9,E9GN30,Q7PZ41,A0A077Z361,R7U9I3,A0A1X7V1N5,A0A0K0JDP1,A0A0N4UKJ1,A0A498N3A3,A0A3M0IQP5,A0A0L8GBV4,Q32KD4,A0A1J1JBJ0,E0W4C3,A0A482XDA9,A0A3P7EJD6,J9K2Z4,A0A2J7Q8V4,T1IBM6,V3ZRX0,A0A210QKF7,A0A423TSS1,K1PT78,A0A267E8R7,A0A1D2N447,A0A226D7A9,F6YK55,T1KTE4,A0A2C9JGZ6,A0A1V9X9F0,K5X5Z7,A0A3Q0KUG5,T1FY40,1YVU,1Z26,5AWH,5G5T,5I4A,6QZK,A0A1I7IXT4,A0A2W1JZ37,A0A2S7WBN3,A0A328VKE4,A0A420DFE6,E0ST67,A0A4V1VDY2,A0A368P5I0,C4L1M1,A0A4R1RMM2,A0A1Y2RDH8,Q11QW7,A0A1M5ZSR3,A0A0K8QX04,A0A0M2PXX3,K9TPA9,A0A1L3JHM3,A0A1W6MIP2,A0A1C0UUC4,A0A2U2J9E0,A0A2Z6E1D5,A0A0F4NXW8,A0A142XB92,L8D0R3,B1XJG0,A0A326U7G5,A0A3D8L290,H1KXR6,A0A1Q4R485,K9U8J6,A0A097QRL6,K9RC91,A0A0D8ZUC0,A0A139XGN8,A0A1T4Y3A2,B6YTQ5,A0A0B0H9B4,A0YYT3,A0A2T1EFY0,G6FTN0,R6KUL9,A0A433NB65,K9UQR0,A0A2T1G8M7,K9VUN0,B7GJX9,K9ZDE3,B0JXD6,A0A2T1LS63,A0A1Z4K1Y3,A0A2Z6E0R7,A0A1N6SSK9,A0A0P4UVI8,A0A0V7ZCG4,A0A1J0AGK2,A0A2G9DT08,K9UEV4,Q9L1X1,A0A060HNJ0,A0A235B542,A0A1H3LE92,A0A496APJ8,A0A1V9G9U4,A0A1I2ZGP1,A0A317EJY3,A0A1I2BD20,F8ERC7,A0A1A5X8H4,A0A1I2T6Q1,A0A1R3T9N6,A0A0Q2M2Z1,H8KXJ0,D3S0S6,A0A2D1U4H7,I3TE64,A0A0B7I4Z6,A0LL61,Q8DKB1,A0A139WY18,A0A1J1EK56,A0A2T1E1K4,A0A1Q8ZD62,A0A4Q6XKV6,A0A1Z3HNN4,A0A239JE83,A0A2N4XBY2,Q53W94,R5JEI2,A0A0Q0ZC47,A0A2T0XH18,A0A1V4CHV0,A0A1K1RQP7,A0A2T1EKT1,A0A1N6LUI7,A0A0P0NGR6,A0A1X7IML5,A0A0A2LKJ7,K1L112,A0A0U3AL92,A0A1H3A054,E0UCX3,K9XZC6,A0A0C1VHB4,Q31N05,A0A0C5JKF3,R5NJJ8,A5D4D9,Q2JI93,A0A142Y7A9,A0A432MEQ5,A0A372DKU2,C1F5Q7,A0A4R3EV39,A0A1P8WP90,A0A222F7P0,A0A1C9VH88,A0A2T2YMB1,A0A329TD61,A0A101R2A0,A0A1U9ND56,A0A4R7BQC4,A0A1Q1FPH0,E0TGY3,A0A259TUP4,F6EYI8,A0A2S9Q9J0,A0A4Q2UIU6,A0A1H0LH25,A0A318LG42,L0JS08,A0A345E7N0,M0AF24,A0A1H3X247,M0D2X3,A0A2R5G167,A0A346PK63,R7RTW6,B9LVP8,M5RSF0,W0JW77,B7K585,F8D8G0,A0A343TL88,L0AJX6,A0A2A5QS34,A0A343JEE2,A0A3P3RGE5,A0A329TBQ3,A0A285N2A8,A0A0W1S8B8,A0A1V4C8L7,L9VRQ2,E4NRV1,A0A1I6HGN0,A0A1I0NI68,,",366,37
"1078","C.H5.10","C.H5.7",340,179,161,2.46006107082133,"4F1N,4F3T,4KRE,5GUH,5VM9,6KR6,6OON,A0A163JTZ6,A0A196SDB4,J9D5G4,Q389P5,C4LVV2,A0A2P6N8X7,A8BCK6,A2DPV7,A0A0G4H2S4,T1H8B3,R1FDF0,S4RWI0,D2VMG4,A0A074TLL7,A0A0D1ZAJ4,Q1K660,F4PH46,A0A3M7S814,A0A164ZA52,A0A383WDW5,Q54G64,S7WCF7,I0YVB2,R7QGN7,C1DZY0,A0A2C5Z0M1,A0CB11,R9ACY5,D3BMP8,A0A1Z5TVE5,W7XD45,A0A1U7LLR0,A0A4S2MWZ7,K1VVQ6,A0A158P1R9,G7DVX0,V6R0U9,G4N9J3,E3KLI3,B7Q5I1,A0A1E3QC61,D5GGK8,S8ANP9,A0A139AUH8,L2GMR6,U4LBG4,A0A177URI1,O74957,A0A3N4IGK1,A6N7Y9,A0A0E9NDK5,T1KZ60,A0A250WXN5,A0A2G8JLH3,Q5KAT1,L2GUF2,W2T741,A0A1W0E4B5,A0A2J7QB22,S4RYE2,A0A2K3CW87,A0A388KES6,A0A226EFL3,A0A3S3PD82,A0A0L0TEV1,A0A1S3J512,G0QTT2,A0A1J1HRI1,C4V9J2,Q9JMB7,A0A075AN09,Q5TW24,U5HIG6,A0A401PRI6,Q96J94,A0A2B4RHN2,G2QEV0,A0A397UU01,A0A2T7PFL8,K7ISV0,A0A024FT57,H3HCL6,A0A0G4IME3,E9FUN9,A0A1S3CYL5,D7FQK3,A0A1Y1YHC8,T1GSU4,F4S231,A0A1D8PMK0,A0A2G5B1D8,Q5BD61,A0A1C7M8P2,A0A4D8YSQ3,A0A158PJG6,J9JZ66,A0A0C2XG51,A0A158QZT6,T0SAU8,R7YY92,A0A3S1A0C3,A0A074YJ47,A0A2K1J482,A0A1Q3ENA6,O04379,A0A371I3C8,M8AEW7,A8P0D4,A0A2K3NY65,F4NYW7,A0A409Y6G2,A0A0L0HAB7,D8PZT7,A0A1D1W4K0,A7RQ46,W4YU94,A7BJS5,D8SNM6,A0A1J8PPA3,X1WG39,M5FQK2,Q69VD5,A0A2R6NSC2,A0A0D8XL16,A0A016WPN3,Q9QZ81,G5EES3,A0A0K0EFP6,Q8CJG0,A0A1D5NTU6,V2WTL2,A0A0V0YLH8,A0A139WDH0,A0A0R3W9Q7,H3DS31,A0A1Y1HWP2,G4T5G9,B7QCC4,A0A0B2UV00,M7BCJ9,E9GN30,Q7PZ41,A0A077Z361,R7U9I3,A0A1X7V1N5,A0A0K0JDP1,A0A0N4UKJ1,A0A498N3A3,A0A3M0IQP5,A0A0L8GBV4,Q32KD4,A0A1J1JBJ0,E0W4C3,A0A482XDA9,A0A3P7EJD6,J9K2Z4,A0A2J7Q8V4,T1IBM6,V3ZRX0,A0A210QKF7,A0A423TSS1,K1PT78,A0A267E8R7,A0A1D2N447,A0A226D7A9,F6YK55,T1KTE4,A0A2C9JGZ6,A0A1V9X9F0,K5X5Z7,A0A3Q0KUG5,T1FY40,1Z26,3DLB,5AWH,5I4A,6QZK,7R8K,E8N0K8,A0A1I7IXT4,A0A2W1JZ37,A0A2S7WBN3,A0A328VKE4,A0A420DFE6,E0ST67,A0A4V1VDY2,A0A368P5I0,C4L1M1,A0A4R1RMM2,A0A1Y2RDH8,Q11QW7,A0A1M5ZSR3,A0A0K8QX04,A0A1I3LMA1,A0A1L3JHM3,A0A1W6MIP2,A0A2U2J9E0,A0A2Z6E1D5,A0A0F4NXW8,L8D0R3,B1XJG0,A0A326U7G5,A0A3D8L290,A0A1Q4R485,K9RC91,A0A0D8ZUC0,A0A139XGN8,A0A1T4Y3A2,Q5P0R2,A0A0B0H9B4,A0A2T1EFY0,G6FTN0,A0A1Z4L0A1,K9VUN0,B7GJX9,K9ZDE3,B0JXD6,A0A1Z4K1Y3,A0A2Z6E0R7,A0A1N6SSK9,A0A0P4UVI8,A0A1J0AGK2,K9PFF9,A0A2G9DT08,K9UEV4,Q9L1X1,A0A060HNJ0,A0A235B542,R5XQK4,A0A1H3LE92,A0A496APJ8,A0A062U2W9,H0HWQ5,A0A1V9G9U4,A0A1I2ZGP1,A0A317EJY3,A0A1I2BD20,F8ERC7,S7VLM7,A0A1A5X8H4,A0A1I2T6Q1,A0A1R3T9N6,A0A0Q2M2Z1,H8KXJ0,D3S0S6,A0A2D1U4H7,A0A0B7I4Z6,A0LL61,Q8DKB1,A0A139WY18,A0A1J1EK56,A0A2T1E1K4,A0A1Q8ZD62,A0A4Q6XKV6,A0A1Z3HNN4,A0A239JE83,A0A2N4XBY2,Q53W94,R5JEI2,A0A0Q0ZC47,A0A2T0XH18,A0A1V4CHV0,A0A1K1RQP7,A0A2T1EKT1,A0A1N6LUI7,A0A0P0NGR6,A0A1X7IML5,A0A0A2LKJ7,K1L112,A0A0U3AL92,A0A1H3A054,E0UCX3,K9XZC6,A0A0C1VHB4,Q31N05,A0A0C5JKF3,R5NJJ8,A5D4D9,Q2JI93,A0A142Y7A9,A0A432MEQ5,A0A372DKU2,A0A3R7KLK4,C1F5Q7,A0A4R3EV39,A0A1P8WP90,A0A222F7P0,A0A1C9VH88,A0A2T2YMB1,A0A329TD61,A0A101R2A0,A0A1E3XF49,A0A1U9ND56,A0A4R7BQC4,A0A1H3DGN3,A0A1Q1FPH0,E0TGY3,A0A259TUP4,F6EYI8,A0A2S9Q9J0,A0A4Q2UIU6,A0A1H0LH25,A0A318LG42,H1YCU5,L0JS08,A0A1Q5ZS75,A0A345E7N0,M0AF24,A0A1H3X247,A0A0C1XUA0,M0D2X3,A0A2R5G167,A0A346PK63,R7RTW6,A0A1H2RBI2,A0A1C3ZXN2,B9LVP8,M5RSF0,W0JW77,B7K585,F8D8G0,A0A343TL88,L0AJX6,A0A2A5QS34,A0A343JEE2,A0A3P3RGE5,A0A329TBQ3,A0A285N2A8,A0A0W1S8B8,L9VRQ2,E4NRV1,A0A1I6HGN0,A0A1I0NI68,,",366,37
"1079","C.H5.12","C.H5.16",350,179,171,3.68267503021987,"4F1N,4F3T,4KRE,5GUH,5VM9,6KR6,6OON,7KX7,7SWF,A0A163JTZ6,A0A196SDB4,J9D5G4,C4LVV2,A8BCK6,A2DPV7,A0A0G4H2S4,T1H8B3,R1FDF0,S4RWI0,D2VMG4,A0A074TLL7,A0A0D1ZAJ4,Q1K660,F4PH46,A0A3M7S814,A0A164ZA52,A0A383WDW5,Q54G64,S7WCF7,I0YVB2,R7QGN7,C1DZY0,A0A2C5Z0M1,A0CB11,R9ACY5,D3BMP8,A0A1Z5TVE5,W7XD45,A0A1U7LLR0,A0A4S2MWZ7,K1VVQ6,A0A158P1R9,G7DVX0,V6R0U9,G4N9J3,E3KLI3,B7Q5I1,A0A1E3QC61,D5GGK8,S8ANP9,A0A139AUH8,L2GMR6,U4LBG4,A0A177URI1,O74957,A0A3N4IGK1,A6N7Y9,A0A0E9NDK5,T1KZ60,A0A250WXN5,A0A2G8JLH3,Q5KAT1,L2GUF2,W2T741,A0A1W0E4B5,A0A2J7QB22,S4RYE2,A0A2K3CW87,A0A388KES6,A0A226EFL3,A0A3S3PD82,A0A0L0TEV1,A0A1S3J512,G0QTT2,A0A1J1HRI1,C4V9J2,Q9JMB7,A0A075AN09,Q5TW24,U5HIG6,A0A401PRI6,Q96J94,A0A2B4RHN2,G2QEV0,A0A397UU01,A0A2T7PFL8,K7ISV0,A0A024FT57,H3HCL6,A0A0G4IME3,E9FUN9,A0A1S3CYL5,D7FQK3,A0A1Y1YHC8,T1GSU4,F4S231,A0A1D8PMK0,A0A2G5B1D8,Q5BD61,A0A1C7M8P2,A0A4D8YSQ3,A0A158PJG6,J9JZ66,A0A0C2XG51,A0A158QZT6,T0SAU8,R7YY92,A0A3S1A0C3,A0A074YJ47,A0A2K1J482,A0A1Q3ENA6,O04379,A0A371I3C8,M8AEW7,A8P0D4,A0A2K3NY65,F4NYW7,A0A409Y6G2,A0A0L0HAB7,D8PZT7,A0A1D1W4K0,A7RQ46,W4YU94,A7BJS5,D8SNM6,A0A1J8PPA3,X1WG39,M5FQK2,Q69VD5,A0A2R6NSC2,A0A0D8XL16,A0A016WPN3,Q9QZ81,G5EES3,A0A0K0EFP6,Q8CJG0,A0A1D5NTU6,V2WTL2,A0A0V0YLH8,A0A139WDH0,A0A0R3W9Q7,H3DS31,A0A1Y1HWP2,G4T5G9,B7QCC4,A0A0B2UV00,M7BCJ9,E9GN30,Q7PZ41,A0A077Z361,R7U9I3,A0A1X7V1N5,A0A0K0JDP1,A0A0N4UKJ1,A0A498N3A3,A0A3M0IQP5,A0A0L8GBV4,Q32KD4,A0A1J1JBJ0,E0W4C3,A0A482XDA9,A0A3P7EJD6,J9K2Z4,A0A2J7Q8V4,T1IBM6,V3ZRX0,A0A210QKF7,A0A423TSS1,K1PT78,A0A267E8R7,A0A1D2N447,A0A226D7A9,F6YK55,T1KTE4,A0A2C9JGZ6,A0A1V9X9F0,K5X5Z7,A0A3Q0KUG5,T1FY40,1YVU,1Z26,3DLB,5AWH,5G5T,5I4A,6QZK,E8N0K8,A0A1I7IXT4,A0A2W1JZ37,A0A2S7WBN3,A0A328VKE4,A0A420DFE6,E0ST67,A0A4V1VDY2,A0A368P5I0,C4L1M1,A0A4R1RMM2,A0A1Y2RDH8,Q11QW7,A0A1M5ZSR3,A0A0K8QX04,A0A0M2PXX3,A0A1I3LMA1,K9TPA9,A0A1L3JHM3,A0A1W6MIP2,A0A1C0UUC4,A0A2U2J9E0,A0A2Z6E1D5,A0A0F4NXW8,B1XJG0,A0A326U7G5,A0A3D8L290,H1KXR6,A0A1Q4R485,K9U8J6,A0A097QRL6,K9RC91,A0A0D8ZUC0,A0A139XGN8,A0A1T4Y3A2,Q5P0R2,B6YTQ5,A0A0B0H9B4,A0YYT3,A0A2T1EFY0,G6FTN0,R6KUL9,A0A433NB65,A0A1Z4L0A1,K9UQR0,A0A2T1G8M7,K9VUN0,B7GJX9,A0A0P6X5X2,K9ZDE3,B0JXD6,A0A2T1LS63,A0A1Z4K1Y3,A0A2Z6E0R7,A0A1N6SSK9,A0A0P4UVI8,A0A0V7ZCG4,A0A1J0AGK2,K9PFF9,A0A2G9DT08,K9UEV4,Q9L1X1,A0A060HNJ0,A0A235B542,R5XQK4,A0A1H3LE92,A0A496APJ8,A0A1V9G9U4,S7VLM7,A0A1A5X8H4,A0A1I2T6Q1,A0A1R3T9N6,A0A0Q2M2Z1,H8KXJ0,D3S0S6,A0A2D1U4H7,I3TE64,A0A0B7I4Z6,A0LL61,Q8DKB1,A0A139WY18,A0A1J1EK56,A0A2T1E1K4,A0A1Q8ZD62,A0A4Q6XKV6,A0A1Z3HNN4,A0A239JE83,A0A2N4XBY2,Q53W94,R5JEI2,A0A0Q0ZC47,A0A2T0XH18,A0A1V4CHV0,A0A1K1RQP7,A0A2T1EKT1,A0A1N6LUI7,A0A0P0NGR6,A0A1X7IML5,A0A0A2LKJ7,K1L112,A0A0U3AL92,A0A1H3A054,E0UCX3,K9XZC6,A0A0C1VHB4,Q31N05,A0A0C5JKF3,R5NJJ8,A5D4D9,Q2JI93,A0A142Y7A9,A0A432MEQ5,A0A372DKU2,C1F5Q7,A0A4R3EV39,A0A1P8WP90,A0A222F7P0,A0A1C9VH88,A0A2T2YMB1,A0A329TD61,A0A101R2A0,A0A1E3XF49,A0A1U9ND56,A0A4R7BQC4,A0A1Q1FPH0,E0TGY3,A0A259TUP4,F6EYI8,A0A2S9Q9J0,A0A4Q2UIU6,A0A1H0LH25,A0A318LG42,H1YCU5,L0JS08,A0A1Q5ZS75,A0A345E7N0,M0AF24,A0A1W2A082,A0A1H3X247,A0A0C1XUA0,M0D2X3,A0A2R5G167,A0A346PK63,R7RTW6,A0A1H2RBI2,A0A1C3ZXN2,B9LVP8,M5RSF0,W0JW77,B7K585,F8D8G0,A0A343TL88,L0AJX6,A0A2A5QS34,A0A343JEE2,A0A3P3RGE5,A0A329TBQ3,A0A285N2A8,A0A0W1S8B8,A0A1V4C8L7,L9VRQ2,E4NRV1,A0A1I6HGN0,A0A1I0NI68,,",366,37
"1080","C.H5.15","C.S6.3",332,179,153,3.39810859166758,"4F1N,4F3T,4KRE,5GUH,5VM9,6KR6,6OON,7KX7,7SWF,A0A163JTZ6,A0A196SDB4,J9D5G4,Q389P5,C4LVV2,A8BCK6,A2DPV7,A0A0G4H2S4,T1H8B3,S4RWI0,D2VMG4,A0A074TLL7,A0A0D1ZAJ4,Q1K660,F4PH46,A0A3M7S814,A0A164ZA52,A0A383WDW5,Q54G64,S7WCF7,I0YVB2,R7QGN7,C1DZY0,A0A2C5Z0M1,A0CB11,R9ACY5,D3BMP8,A0A1Z5TVE5,W7XD45,A0A1U7LLR0,A0A4S2MWZ7,K1VVQ6,A0A158P1R9,G7DVX0,V6R0U9,G4N9J3,E3KLI3,B7Q5I1,A0A1E3QC61,D5GGK8,S8ANP9,A0A139AUH8,L2GMR6,U4LBG4,A0A177URI1,O74957,A0A3N4IGK1,A6N7Y9,A0A0E9NDK5,T1KZ60,A0A250WXN5,A0A2G8JLH3,Q5KAT1,L2GUF2,W2T741,A0A1W0E4B5,A0A2J7QB22,S4RYE2,A0A2K3CW87,A0A388KES6,A0A226EFL3,A0A3S3PD82,A0A0L0TEV1,A0A1S3J512,G0QTT2,A0A1J1HRI1,C4V9J2,Q9JMB7,A0A075AN09,Q5TW24,U5HIG6,A0A401PRI6,Q96J94,A0A2B4RHN2,G2QEV0,A0A397UU01,A0A2T7PFL8,K7ISV0,A0A024FT57,H3HCL6,A0A0G4IME3,E9FUN9,A0A1S3CYL5,D7FQK3,A0A1Y1YHC8,T1GSU4,F4S231,A0A1D8PMK0,A0A2G5B1D8,Q5BD61,A0A1C7M8P2,A0A4D8YSQ3,A0A158PJG6,J9JZ66,A0A0C2XG51,A0A158QZT6,A0A165QYQ9,T0SAU8,R7YY92,A0A3S1A0C3,A0A074YJ47,A0A2K1J482,A0A1Q3ENA6,O04379,A0A371I3C8,M8AEW7,A8P0D4,A0A2K3NY65,F4NYW7,A0A409Y6G2,A0A0L0HAB7,D8PZT7,A0A1D1W4K0,A7RQ46,W4YU94,A7BJS5,D8SNM6,A0A1J8PPA3,X1WG39,M5FQK2,Q69VD5,A0A0D8XL16,A0A016WPN3,Q9QZ81,G5EES3,A0A0K0EFP6,Q8CJG0,A0A1D5NTU6,V2WTL2,A0A0V0YLH8,A0A139WDH0,A0A0R3W9Q7,H3DS31,A0A1Y1HWP2,G4T5G9,B7QCC4,A0A0B2UV00,M7BCJ9,E9GN30,Q7PZ41,A0A077Z361,R7U9I3,A0A1X7V1N5,A0A0K0JDP1,A0A0N4UKJ1,A0A498N3A3,A0A3M0IQP5,A0A0L8GBV4,Q32KD4,A0A1J1JBJ0,E0W4C3,A0A482XDA9,A0A3P7EJD6,J9K2Z4,A0A2J7Q8V4,T1IBM6,V3ZRX0,A0A210QKF7,A0A423TSS1,K1PT78,A0A267E8R7,A0A1D2N447,A0A226D7A9,F6YK55,T1KTE4,A0A2C9JGZ6,A0A1V9X9F0,K5X5Z7,A0A3Q0KUG5,T1FY40,1YVU,1Z26,3DLB,5AWH,5G5T,5I4A,6QZK,E8N0K8,A0A1I7IXT4,A0A2W1JZ37,A0A2S7WBN3,A0A420DFE6,A0A4V1VDY2,A0A368P5I0,C4L1M1,A0A4R1RMM2,A0A1Y2RDH8,Q11QW7,A0A1M5ZSR3,A0A0K8QX04,A0A0M2PXX3,A0A1I3LMA1,K9TPA9,A0A1L3JHM3,A0A1W6MIP2,A0A1C0UUC4,A0A2U2J9E0,A0A2Z6E1D5,A0A0F4NXW8,A0A142XB92,B1XJG0,A0A326U7G5,A0A3D8L290,H1KXR6,A0A1Q4R485,K9U8J6,A0A097QRL6,K9RC91,A0A0D8ZUC0,A0A139XGN8,A0A1T4Y3A2,Q5P0R2,B6YTQ5,A0A0B0H9B4,A0YYT3,A0A2T1EFY0,G6FTN0,R6KUL9,A0A433NB65,A0A1Z4L0A1,A0A2T1G8M7,K9VUN0,B7GJX9,K9ZDE3,B0JXD6,A0A2T1LS63,A0A1Z4K1Y3,A0A2Z6E0R7,A0A1N6SSK9,A0A0P4UVI8,A0A0V7ZCG4,A0A1J0AGK2,K9PFF9,A0A2G9DT08,K9UEV4,Q9L1X1,A0A060HNJ0,A0A235B542,R5XQK4,A0A496APJ8,A0A1V9G9U4,S7VLM7,A0A1A5X8H4,A0A1I2T6Q1,A0A1R3T9N6,A0A0Q2M2Z1,H8KXJ0,D3S0S6,A0A2D1U4H7,I3TE64,A0A0B7I4Z6,A0LL61,Q8DKB1,A0A139WY18,A0A1J1EK56,A0A2T1E1K4,A0A1Q8ZD62,A0A4Q6XKV6,A0A1Z3HNN4,A0A239JE83,A0A2N4XBY2,Q53W94,R5JEI2,A0A0Q0ZC47,A0A2T0XH18,A0A1V4CHV0,A0A1K1RQP7,A0A2T1EKT1,A0A1N6LUI7,A0A0P0NGR6,A0A1X7IML5,A0A0A2LKJ7,K1L112,A0A0U3AL92,A0A1H3A054,E0UCX3,K9XZC6,A0A0C1VHB4,Q31N05,A0A0C5JKF3,R5NJJ8,A5D4D9,Q2JI93,A0A142Y7A9,A0A432MEQ5,A0A372DKU2,C1F5Q7,A0A4R3EV39,A0A1P8WP90,A0A222F7P0,A0A1C9VH88,A0A2T2YMB1,A0A329TD61,A0A101R2A0,A0A1U9ND56,A0A4R7BQC4,A0A1Q1FPH0,E0TGY3,A0A259TUP4,F6EYI8,A0A2S9Q9J0,A0A4Q2UIU6,A0A1H0LH25,A0A318LG42,A0A345E7N0,A0A1H3X247,A0A2R5G167,A0A346PK63,R7RTW6,B9LVP8,M5RSF0,B7K585,F8D8G0,A0A343TL88,A0A343JEE2,A0A3P3RGE5,A0A329TBQ3,A0A0W1S8B8,A0A1V4C8L7,L9VRQ2,E4NRV1,A0A1I6HGN0,A0A1I0NI68,,",366,37
"1081","C.H5.16","C.L11.2",341,179,162,1.34686874956894,"4F1N,4F3T,4KRE,5GUH,5VM9,6KR6,6OON,7KX7,7SWF,A0A163JTZ6,A0A196SDB4,J9D5G4,Q389P5,C4LVV2,A0A2P6N8X7,A0A0G4H2S4,T1H8B3,R1FDF0,S4RWI0,D2VMG4,A0A074TLL7,A0A0D1ZAJ4,Q1K660,F4PH46,A0A3M7S814,A0A164ZA52,A0A383WDW5,Q54G64,S7WCF7,I0YVB2,R7QGN7,C1DZY0,A0A2C5Z0M1,A0CB11,R9ACY5,D3BMP8,A0A1Z5TVE5,W7XD45,A0A1U7LLR0,A0A4S2MWZ7,K1VVQ6,A0A158P1R9,G7DVX0,V6R0U9,G4N9J3,E3KLI3,B7Q5I1,A0A1E3QC61,D5GGK8,S8ANP9,A0A139AUH8,L2GMR6,U4LBG4,A0A177URI1,O74957,A0A3N4IGK1,A6N7Y9,A0A0E9NDK5,T1KZ60,A0A250WXN5,A0A2G8JLH3,Q5KAT1,L2GUF2,W2T741,A0A1W0E4B5,A0A2J7QB22,S4RYE2,A0A2K3CW87,A0A388KES6,A0A226EFL3,A0A3S3PD82,A0A1S3J512,G0QTT2,A0A1J1HRI1,C4V9J2,Q9JMB7,A0A075AN09,Q5TW24,U5HIG6,A0A401PRI6,Q96J94,A0A2B4RHN2,G2QEV0,A0A397UU01,A0A2T7PFL8,K7ISV0,A0A024FT57,H3HCL6,A0A0G4IME3,E9FUN9,A0A1S3CYL5,D7FQK3,A0A1Y1YHC8,T1GSU4,F4S231,A0A1D8PMK0,A0A2G5B1D8,Q5BD61,A0A1C7M8P2,A0A4D8YSQ3,A0A158PJG6,J9JZ66,A0A0C2XG51,A0A158QZT6,A0A165QYQ9,T0SAU8,R7YY92,A0A3S1A0C3,A0A074YJ47,A0A2K1J482,A0A1Q3ENA6,O04379,A0A371I3C8,M8AEW7,A8P0D4,A0A2K3NY65,F4NYW7,A0A409Y6G2,A0A0L0HAB7,D8PZT7,A0A1D1W4K0,A7RQ46,W4YU94,A7BJS5,D8SNM6,A0A1J8PPA3,X1WG39,M5FQK2,Q69VD5,A0A2R6NSC2,A0A0D8XL16,A0A016WPN3,Q9QZ81,G5EES3,A0A0K0EFP6,Q8CJG0,A0A1D5NTU6,V2WTL2,A0A0V0YLH8,A0A139WDH0,A0A0R3W9Q7,H3DS31,A0A1Y1HWP2,G4T5G9,B7QCC4,A0A0B2UV00,M7BCJ9,E9GN30,Q7PZ41,A0A077Z361,R7U9I3,A0A1X7V1N5,A0A0K0JDP1,A0A0N4UKJ1,A0A498N3A3,A0A3M0IQP5,A0A0L8GBV4,Q32KD4,A0A1J1JBJ0,E0W4C3,A0A482XDA9,A0A3P7EJD6,J9K2Z4,A0A2J7Q8V4,T1IBM6,V3ZRX0,A0A210QKF7,A0A423TSS1,K1PT78,A0A267E8R7,A0A1D2N447,A0A226D7A9,F6YK55,T1KTE4,A0A2C9JGZ6,A0A1V9X9F0,K5X5Z7,A0A3Q0KUG5,T1FY40,1YVU,1Z26,3DLB,5AWH,5G5T,5I4A,6QZK,E8N0K8,A0A1I7IXT4,A0A2W1JZ37,A0A2S7WBN3,A0A328VKE4,A0A420DFE6,A0A4V1VDY2,A0A368P5I0,A0A4R1RMM2,A0A1Y2RDH8,Q11QW7,A0A1M5ZSR3,A0A0K8QX04,A0A0M2PXX3,K9TPA9,A0A1L3JHM3,A0A1W6MIP2,A0A1C0UUC4,A0A2U2J9E0,A0A2Z6E1D5,A0A0F4NXW8,B1XJG0,A0A326U7G5,A0A3D8L290,A0A1Q4R485,K9U8J6,A0A097QRL6,K9RC91,A0A0D8ZUC0,A0A139XGN8,A0A1T4Y3A2,Q5P0R2,B6YTQ5,A0YYT3,A0A2T1EFY0,G6FTN0,A0A433NB65,A0A1Z4L0A1,K9UQR0,A0A2T1G8M7,K9VUN0,K9ZDE3,B0JXD6,A0A2T1LS63,A0A1Z4K1Y3,A0A2Z6E0R7,A0A0P4UVI8,A0A0V7ZCG4,A0A1J0AGK2,K9PFF9,A0A2G9DT08,K9UEV4,Q9L1X1,A0A235B542,A0A1H3LE92,A0A496APJ8,A0A1V9G9U4,S7VLM7,A0A1A5X8H4,A0A1I2T6Q1,A0A1R3T9N6,A0A0Q2M2Z1,H8KXJ0,D3S0S6,A0A2D1U4H7,I3TE64,A0A0B7I4Z6,A0LL61,Q8DKB1,A0A139WY18,A0A1J1EK56,A0A2T1E1K4,A0A1Q8ZD62,A0A4Q6XKV6,A0A1Z3HNN4,A0A239JE83,A0A2N4XBY2,Q53W94,R5JEI2,A0A0Q0ZC47,A0A2T0XH18,A0A1V4CHV0,A0A1K1RQP7,A0A2T1EKT1,A0A1N6LUI7,A0A0P0NGR6,A0A1X7IML5,A0A0A2LKJ7,K1L112,A0A0U3AL92,A0A1H3A054,E0UCX3,K9XZC6,B9LVW4,A0A0C1VHB4,Q31N05,A0A0C5JKF3,R5NJJ8,A5D4D9,Q2JI93,A0A142Y7A9,A0A432MEQ5,A0A372DKU2,C1F5Q7,A0A4R3EV39,A0A1P8WP90,A0A222F7P0,A0A1C9VH88,A0A2T2YMB1,A0A329TD61,A0A101R2A0,A0A1E3XF49,A0A1U9ND56,A0A4R7BQC4,A0A1H3DGN3,A0A1Q1FPH0,E0TGY3,A0A259TUP4,F6EYI8,A0A2S9Q9J0,A0A4Q2UIU6,A0A1H0LH25,A0A318LG42,H1YCU5,L0JS08,A0A1Q5ZS75,A0A345E7N0,M0AF24,A0A1W2A082,A0A1H3X247,A0A0C1XUA0,M0D2X3,A0A2R5G167,A0A346PK63,R7RTW6,A0A1H2RBI2,A0A1C3ZXN2,B9LVP8,M5RSF0,W0JW77,B7K585,F8D8G0,A0A343TL88,L0AJX6,A0A2A5QS34,A0A343JEE2,A0A3P3RGE5,A0A329TBQ3,A0A285N2A8,A0A0W1S8B8,A0A1V4C8L7,L9VRQ2,E4NRV1,A0A1I6HGN0,A0A1I0NI68,,",366,37
"1084","C.H7.10","C.H7.6",301,179,122,3.66398021796868,"4F1N,4F3T,4KRE,5GUH,5VM9,6KR6,6OON,7KX7,7SWF,A0A163JTZ6,A0A196SDB4,J9D5G4,Q389P5,C4LVV2,A0A2P6N8X7,A2DPV7,A0A0G4H2S4,T1H8B3,R1FDF0,S4RWI0,D2VMG4,A0A074TLL7,A0A0D1ZAJ4,Q1K660,F4PH46,A0A3M7S814,A0A164ZA52,A0A383WDW5,Q54G64,S7WCF7,I0YVB2,R7QGN7,C1DZY0,A0A2C5Z0M1,A0CB11,R9ACY5,D3BMP8,A0A1Z5TVE5,W7XD45,A0A1U7LLR0,A0A4S2MWZ7,K1VVQ6,A0A158P1R9,G7DVX0,V6R0U9,G4N9J3,E3KLI3,B7Q5I1,A0A1E3QC61,D5GGK8,S8ANP9,A0A139AUH8,L2GMR6,U4LBG4,A0A177URI1,O74957,A0A3N4IGK1,A6N7Y9,A0A0E9NDK5,T1KZ60,A0A250WXN5,A0A2G8JLH3,Q5KAT1,L2GUF2,W2T741,A0A1W0E4B5,A0A2J7QB22,A0A2K3CW87,A0A226EFL3,A0A3S3PD82,A0A0L0TEV1,A0A1S3J512,G0QTT2,A0A1J1HRI1,C4V9J2,Q9JMB7,A0A075AN09,Q5TW24,U5HIG6,A0A401PRI6,Q96J94,A0A2B4RHN2,G2QEV0,A0A397UU01,A0A2T7PFL8,K7ISV0,A0A024FT57,H3HCL6,A0A0G4IME3,E9FUN9,A0A1S3CYL5,D7FQK3,A0A1Y1YHC8,T1GSU4,F4S231,A0A1D8PMK0,A0A2G5B1D8,Q5BD61,A0A1C7M8P2,A0A4D8YSQ3,A0A158PJG6,J9JZ66,A0A0C2XG51,A0A158QZT6,A0A165QYQ9,T0SAU8,R7YY92,A0A3S1A0C3,A0A074YJ47,A0A2K1J482,A0A1Q3ENA6,O04379,A0A371I3C8,M8AEW7,A8P0D4,A0A2K3NY65,F4NYW7,A0A409Y6G2,A0A0L0HAB7,D8PZT7,A0A1D1W4K0,A7RQ46,W4YU94,A7BJS5,D8SNM6,A0A1J8PPA3,X1WG39,M5FQK2,Q69VD5,A0A2R6NSC2,A0A0D8XL16,A0A016WPN3,Q9QZ81,G5EES3,A0A0K0EFP6,Q8CJG0,A0A1D5NTU6,V2WTL2,A0A0V0YLH8,A0A139WDH0,A0A0R3W9Q7,H3DS31,A0A1Y1HWP2,G4T5G9,B7QCC4,A0A0B2UV00,M7BCJ9,E9GN30,Q7PZ41,A0A077Z361,R7U9I3,A0A1X7V1N5,A0A0K0JDP1,A0A0N4UKJ1,A0A498N3A3,A0A3M0IQP5,A0A0L8GBV4,Q32KD4,A0A1J1JBJ0,E0W4C3,A0A482XDA9,A0A3P7EJD6,J9K2Z4,A0A2J7Q8V4,T1IBM6,V3ZRX0,A0A210QKF7,A0A423TSS1,K1PT78,A0A267E8R7,A0A1D2N447,A0A226D7A9,F6YK55,T1KTE4,A0A2C9JGZ6,A0A1V9X9F0,K5X5Z7,A0A3Q0KUG5,T1FY40,1YVU,1Z26,3DLB,5AWH,5G5T,5I4A,6QZK,7R8K,A0A1I7IXT4,A0A2W1JZ37,A0A2S7WBN3,A0A420DFE6,E0ST67,A0A4V1VDY2,A0A368P5I0,C4L1M1,A0A4R1RMM2,A0A1Y2RDH8,A0A1M5ZSR3,A0A0K8QX04,A0A0M2PXX3,A0A1I3LMA1,A0A1W6MIP2,A0A1C0UUC4,A0A2U2J9E0,A0A2Z6E1D5,A0A0F4NXW8,L8D0R3,B1XJG0,A0A097QRL6,A0A1T4Y3A2,Q5P0R2,B6YTQ5,A0A0B0H9B4,R6KUL9,B7GJX9,A0A0P6X5X2,A0A2Z6E0R7,A0A1N6SSK9,A0A2G9DT08,A0A060HNJ0,A0A235B542,R5XQK4,A0A1H3LE92,A0A496APJ8,A0A062U2W9,H0HWQ5,A0A1V9G9U4,A0A1I2ZGP1,A0A317EJY3,A0A1I2BD20,F8ERC7,A0A1A5X8H4,A0A1I2T6Q1,A0A0Q2M2Z1,H8KXJ0,D3S0S6,A0A2D1U4H7,A0A0B7I4Z6,A0LL61,Q8DKB1,A0A139WY18,A0A1J1EK56,A0A2T1E1K4,A0A1Q8ZD62,A0A4Q6XKV6,A0A1Z3HNN4,A0A2N4XBY2,Q53W94,R5JEI2,A0A0Q0ZC47,A0A2T0XH18,A0A1K1RQP7,A0A2T1EKT1,A0A1N6LUI7,A0A0P0NGR6,A0A1X7IML5,A0A0A2LKJ7,K1L112,E0UCX3,K9XZC6,A0A0C1VHB4,Q31N05,R5NJJ8,A5D4D9,Q2JI93,A0A3R7KLK4,C1F5Q7,A0A4R3EV39,A0A222F7P0,A0A2T2YMB1,A0A329TD61,A0A1E3XF49,A0A1H3DGN3,A0A1Q1FPH0,E0TGY3,F6EYI8,A0A2S9Q9J0,H1YCU5,A0A1Q5ZS75,A0A345E7N0,A0A1W2A082,A0A1H3X247,A0A0C1XUA0,A0A346PK63,R7RTW6,A0A1H2RBI2,A0A1C3ZXN2,B9LVP8,M5RSF0,W0JW77,A0A343TL88,L0AJX6,A0A2A5QS34,A0A343JEE2,A0A3P3RGE5,A0A329TBQ3,A0A285N2A8,A0A0W1S8B8,L9VRQ2,E4NRV1,A0A1I6HGN0,,",366,37
"1086","C.H7.6","C.H7.9",287,179,108,3.43130560728326,"4F1N,4F3T,4KRE,5GUH,5VM9,6KR6,6OON,7KX7,7SWF,A0A163JTZ6,A0A196SDB4,J9D5G4,Q389P5,C4LVV2,A0A2P6N8X7,A2DPV7,A0A0G4H2S4,T1H8B3,R1FDF0,S4RWI0,D2VMG4,A0A074TLL7,A0A0D1ZAJ4,Q1K660,F4PH46,A0A3M7S814,A0A164ZA52,A0A383WDW5,Q54G64,S7WCF7,I0YVB2,R7QGN7,C1DZY0,A0A2C5Z0M1,A0CB11,R9ACY5,D3BMP8,A0A1Z5TVE5,W7XD45,A0A1U7LLR0,A0A4S2MWZ7,K1VVQ6,A0A158P1R9,G7DVX0,V6R0U9,G4N9J3,E3KLI3,B7Q5I1,A0A1E3QC61,D5GGK8,S8ANP9,A0A139AUH8,L2GMR6,U4LBG4,A0A177URI1,O74957,A0A3N4IGK1,A6N7Y9,A0A0E9NDK5,T1KZ60,A0A250WXN5,A0A2G8JLH3,Q5KAT1,L2GUF2,W2T741,A0A1W0E4B5,A0A2J7QB22,A0A2K3CW87,A0A226EFL3,A0A3S3PD82,A0A0L0TEV1,A0A1S3J512,G0QTT2,A0A1J1HRI1,C4V9J2,Q9JMB7,A0A075AN09,Q5TW24,U5HIG6,A0A401PRI6,Q96J94,A0A2B4RHN2,G2QEV0,A0A397UU01,A0A2T7PFL8,K7ISV0,A0A024FT57,H3HCL6,A0A0G4IME3,E9FUN9,A0A1S3CYL5,D7FQK3,A0A1Y1YHC8,T1GSU4,F4S231,A0A1D8PMK0,A0A2G5B1D8,Q5BD61,A0A1C7M8P2,A0A4D8YSQ3,A0A158PJG6,J9JZ66,A0A0C2XG51,A0A158QZT6,A0A165QYQ9,T0SAU8,R7YY92,A0A3S1A0C3,A0A074YJ47,A0A2K1J482,A0A1Q3ENA6,O04379,A0A371I3C8,M8AEW7,A8P0D4,A0A2K3NY65,F4NYW7,A0A409Y6G2,A0A0L0HAB7,D8PZT7,A0A1D1W4K0,A7RQ46,W4YU94,A7BJS5,D8SNM6,A0A1J8PPA3,X1WG39,M5FQK2,Q69VD5,A0A2R6NSC2,A0A0D8XL16,A0A016WPN3,Q9QZ81,G5EES3,A0A0K0EFP6,Q8CJG0,A0A1D5NTU6,V2WTL2,A0A0V0YLH8,A0A139WDH0,A0A0R3W9Q7,H3DS31,A0A1Y1HWP2,G4T5G9,B7QCC4,A0A0B2UV00,M7BCJ9,E9GN30,Q7PZ41,A0A077Z361,R7U9I3,A0A1X7V1N5,A0A0K0JDP1,A0A0N4UKJ1,A0A498N3A3,A0A3M0IQP5,A0A0L8GBV4,Q32KD4,A0A1J1JBJ0,E0W4C3,A0A482XDA9,A0A3P7EJD6,J9K2Z4,A0A2J7Q8V4,T1IBM6,V3ZRX0,A0A210QKF7,A0A423TSS1,K1PT78,A0A267E8R7,A0A1D2N447,A0A226D7A9,F6YK55,T1KTE4,A0A2C9JGZ6,A0A1V9X9F0,K5X5Z7,A0A3Q0KUG5,T1FY40,1YVU,1Z26,3DLB,5AWH,5G5T,5I4A,6QZK,A0A2W1JZ37,A0A2S7WBN3,A0A420DFE6,E0ST67,C4L1M1,A0A4R1RMM2,A0A1Y2RDH8,A0A1M5ZSR3,A0A0K8QX04,A0A0M2PXX3,A0A1I3LMA1,A0A1W6MIP2,A0A2U2J9E0,A0A2Z6E1D5,A0A0F4NXW8,A0A142XB92,L8D0R3,B1XJG0,A0A3D8L290,A0A097QRL6,A0A1T4Y3A2,Q5P0R2,B6YTQ5,A0A0B0H9B4,R6KUL9,B7GJX9,A0A0P6X5X2,A0A2Z6E0R7,A0A1N6SSK9,A0A2G9DT08,A0A060HNJ0,A0A235B542,R5XQK4,A0A1H3LE92,A0A496APJ8,A0A062U2W9,H0HWQ5,A0A1V9G9U4,A0A1I2ZGP1,A0A317EJY3,A0A1I2BD20,F8ERC7,A0A1A5X8H4,A0A1I2T6Q1,A0A0Q2M2Z1,H8KXJ0,D3S0S6,A0A2D1U4H7,I3TE64,A0LL61,Q8DKB1,A0A139WY18,A0A1J1EK56,A0A2T1E1K4,A0A1Q8ZD62,A0A1Z3HNN4,A0A2N4XBY2,Q53W94,R5JEI2,A0A1K1RQP7,A0A2T1EKT1,A0A1N6LUI7,A0A0A2LKJ7,K1L112,E0UCX3,K9XZC6,A0A0C1VHB4,Q31N05,R5NJJ8,A5D4D9,Q2JI93,C1F5Q7,A0A4R3EV39,A0A2T2YMB1,A0A329TD61,A0A1E3XF49,A0A1H3DGN3,A0A1Q1FPH0,E0TGY3,F6EYI8,A0A2S9Q9J0,A0A345E7N0,A0A1W2A082,A0A0C1XUA0,A0A346PK63,R7RTW6,A0A1H2RBI2,A0A1C3ZXN2,M5RSF0,W0JW77,A0A343TL88,L0AJX6,A0A2A5QS34,A0A343JEE2,A0A3P3RGE5,A0A329TBQ3,A0A285N2A8,A0A0W1S8B8,L9VRQ2,E4NRV1,A0A1I6HGN0,,",366,37
"1089","C.H9.10","C.H9.6",358,179,179,2.14525139664804,"4F1N,4F3T,4KRE,5GUH,5VM9,6KR6,6OON,7KX7,7SWF,A0A163JTZ6,J9D5G4,Q389P5,C4LVV2,A0A2P6N8X7,A8BCK6,A2DPV7,A0A0G4H2S4,R1FDF0,D2VMG4,A0A074TLL7,A0A0D1ZAJ4,Q1K660,F4PH46,A0A3M7S814,A0A164ZA52,A0A383WDW5,Q54G64,S7WCF7,I0YVB2,R7QGN7,C1DZY0,A0A2C5Z0M1,A0CB11,R9ACY5,D3BMP8,A0A1Z5TVE5,W7XD45,A0A1U7LLR0,A0A4S2MWZ7,K1VVQ6,A0A158P1R9,G7DVX0,V6R0U9,G4N9J3,E3KLI3,B7Q5I1,A0A1E3QC61,D5GGK8,S8ANP9,A0A139AUH8,L2GMR6,U4LBG4,A0A177URI1,O74957,A0A3N4IGK1,A6N7Y9,A0A0E9NDK5,T1KZ60,A0A250WXN5,A0A2G8JLH3,Q5KAT1,L2GUF2,W2T741,A0A1W0E4B5,A0A2J7QB22,S4RYE2,A0A2K3CW87,A0A388KES6,A0A226EFL3,A0A3S3PD82,A0A0L0TEV1,A0A1S3J512,G0QTT2,A0A1J1HRI1,C4V9J2,Q9JMB7,A0A075AN09,Q5TW24,U5HIG6,A0A401PRI6,Q96J94,A0A2B4RHN2,G2QEV0,A0A397UU01,A0A2T7PFL8,K7ISV0,A0A024FT57,H3HCL6,A0A0G4IME3,E9FUN9,A0A1S3CYL5,D7FQK3,A0A1Y1YHC8,T1GSU4,F4S231,A0A1D8PMK0,A0A2G5B1D8,Q5BD61,A0A1C7M8P2,A0A4D8YSQ3,A0A158PJG6,J9JZ66,A0A0C2XG51,A0A158QZT6,A0A165QYQ9,T0SAU8,R7YY92,A0A3S1A0C3,A0A074YJ47,A0A2K1J482,A0A1Q3ENA6,O04379,A0A371I3C8,M8AEW7,A8P0D4,A0A2K3NY65,F4NYW7,A0A409Y6G2,A0A0L0HAB7,D8PZT7,A0A1D1W4K0,A7RQ46,W4YU94,A7BJS5,D8SNM6,A0A1J8PPA3,X1WG39,M5FQK2,Q69VD5,A0A2R6NSC2,A0A0D8XL16,A0A016WPN3,Q9QZ81,G5EES3,A0A0K0EFP6,Q8CJG0,A0A1D5NTU6,V2WTL2,A0A0V0YLH8,A0A139WDH0,A0A0R3W9Q7,H3DS31,A0A1Y1HWP2,G4T5G9,B7QCC4,A0A0B2UV00,M7BCJ9,E9GN30,Q7PZ41,A0A077Z361,R7U9I3,A0A1X7V1N5,A0A0K0JDP1,A0A0N4UKJ1,A0A498N3A3,A0A3M0IQP5,A0A0L8GBV4,Q32KD4,A0A1J1JBJ0,E0W4C3,A0A482XDA9,A0A3P7EJD6,J9K2Z4,A0A2J7Q8V4,T1IBM6,V3ZRX0,A0A210QKF7,A0A423TSS1,K1PT78,A0A267E8R7,A0A1D2N447,A0A226D7A9,F6YK55,T1KTE4,A0A2C9JGZ6,A0A1V9X9F0,K5X5Z7,A0A3Q0KUG5,T1FY40,1YVU,1Z26,3DLB,5AWH,5G5T,5I4A,6QZK,7R8K,A0A1I7IXT4,A0A2W1JZ37,A0A2S7WBN3,A0A328VKE4,A0A420DFE6,E0ST67,A0A4V1VDY2,A0A368P5I0,C4L1M1,A0A4R1RMM2,A0A1Y2RDH8,Q11QW7,A0A1M5ZSR3,A0A0K8QX04,A0A0M2PXX3,K9TPA9,A0A1L3JHM3,A0A1W6MIP2,A0A1C0UUC4,A0A2U2J9E0,A0A2Z6E1D5,A0A0F4NXW8,L8D0R3,B1XJG0,A0A326U7G5,A0A3D8L290,A0A1Q4R485,K9U8J6,A0A097QRL6,K9RC91,A0A0D8ZUC0,A0A139XGN8,A0A1T4Y3A2,Q5P0R2,B6YTQ5,A0A0B0H9B4,A0YYT3,A0A2T1EFY0,G6FTN0,R6KUL9,A0A433NB65,A0A1Z4L0A1,K9UQR0,A0A2T1G8M7,K9VUN0,B7GJX9,A0A0P6X5X2,K9ZDE3,B0JXD6,A0A2T1LS63,A0A1Z4K1Y3,A0A2Z6E0R7,A0A1N6SSK9,A0A0P4UVI8,A0A0V7ZCG4,A0A1J0AGK2,K9PFF9,A0A2G9DT08,K9UEV4,Q9L1X1,A0A060HNJ0,A0A235B542,R5XQK4,A0A1H3LE92,A0A496APJ8,A0A062U2W9,H0HWQ5,A0A1V9G9U4,A0A1I2ZGP1,A0A317EJY3,A0A1I2BD20,F8ERC7,S7VLM7,A0A1A5X8H4,A0A1I2T6Q1,A0A1R3T9N6,A0A0Q2M2Z1,H8KXJ0,D3S0S6,A0A2D1U4H7,I3TE64,A0A0B7I4Z6,A0LL61,Q8DKB1,A0A139WY18,A0A1J1EK56,A0A2T1E1K4,A0A1Q8ZD62,A0A4Q6XKV6,A0A1Z3HNN4,A0A239JE83,A0A2N4XBY2,Q53W94,R5JEI2,A0A0Q0ZC47,A0A2T0XH18,A0A1V4CHV0,A0A1K1RQP7,A0A2T1EKT1,A0A1N6LUI7,A0A0P0NGR6,A0A1X7IML5,A0A0A2LKJ7,K1L112,A0A0U3AL92,A0A1H3A054,E0UCX3,K9XZC6,B9LVW4,A0A0C1VHB4,Q31N05,A0A0C5JKF3,R5NJJ8,A5D4D9,Q2JI93,A0A142Y7A9,A0A432MEQ5,A0A372DKU2,A0A3R7KLK4,C1F5Q7,A0A4R3EV39,A0A1P8WP90,A0A222F7P0,A0A1C9VH88,A0A2T2YMB1,A0A329TD61,A0A101R2A0,A0A1E3XF49,A0A1U9ND56,A0A4R7BQC4,A0A1H3DGN3,A0A1Q1FPH0,E0TGY3,A0A259TUP4,F6EYI8,A0A2S9Q9J0,A0A4Q2UIU6,A0A1H0LH25,A0A318LG42,H1YCU5,L0JS08,A0A1Q5ZS75,A0A345E7N0,M0AF24,A0A1W2A082,A0A1H3X247,A0A0C1XUA0,M0D2X3,A0A2R5G167,A0A346PK63,R7RTW6,A0A1H2RBI2,A0A1C3ZXN2,B9LVP8,M5RSF0,W0JW77,B7K585,F8D8G0,A0A343TL88,L0AJX6,A0A2A5QS34,A0A343JEE2,A0A3P3RGE5,A0A329TBQ3,A0A285N2A8,A0A0W1S8B8,A0A1V4C8L7,L9VRQ2,E4NRV1,A0A1I6HGN0,A0A1I0NI68,,",366,37
"1091","C.H9.5","C.H9.9",358,179,179,3.34078212290503,"4F1N,4F3T,4KRE,5GUH,5VM9,6KR6,6OON,7KX7,7SWF,A0A163JTZ6,J9D5G4,Q389P5,C4LVV2,A0A2P6N8X7,A8BCK6,A2DPV7,A0A0G4H2S4,R1FDF0,D2VMG4,A0A074TLL7,A0A0D1ZAJ4,Q1K660,F4PH46,A0A3M7S814,A0A164ZA52,A0A383WDW5,Q54G64,S7WCF7,I0YVB2,R7QGN7,C1DZY0,A0A2C5Z0M1,A0CB11,R9ACY5,D3BMP8,A0A1Z5TVE5,W7XD45,A0A1U7LLR0,A0A4S2MWZ7,K1VVQ6,A0A158P1R9,G7DVX0,V6R0U9,G4N9J3,E3KLI3,B7Q5I1,A0A1E3QC61,D5GGK8,S8ANP9,A0A139AUH8,L2GMR6,U4LBG4,A0A177URI1,O74957,A0A3N4IGK1,A6N7Y9,A0A0E9NDK5,T1KZ60,A0A250WXN5,A0A2G8JLH3,Q5KAT1,L2GUF2,W2T741,A0A1W0E4B5,A0A2J7QB22,S4RYE2,A0A2K3CW87,A0A388KES6,A0A226EFL3,A0A3S3PD82,A0A0L0TEV1,A0A1S3J512,G0QTT2,A0A1J1HRI1,C4V9J2,Q9JMB7,A0A075AN09,Q5TW24,U5HIG6,A0A401PRI6,Q96J94,A0A2B4RHN2,G2QEV0,A0A397UU01,A0A2T7PFL8,K7ISV0,A0A024FT57,H3HCL6,A0A0G4IME3,E9FUN9,A0A1S3CYL5,D7FQK3,A0A1Y1YHC8,T1GSU4,F4S231,A0A1D8PMK0,A0A2G5B1D8,Q5BD61,A0A1C7M8P2,A0A4D8YSQ3,A0A158PJG6,J9JZ66,A0A0C2XG51,A0A158QZT6,A0A165QYQ9,T0SAU8,R7YY92,A0A3S1A0C3,A0A074YJ47,A0A2K1J482,A0A1Q3ENA6,O04379,A0A371I3C8,M8AEW7,A8P0D4,A0A2K3NY65,F4NYW7,A0A409Y6G2,A0A0L0HAB7,D8PZT7,A0A1D1W4K0,A7RQ46,W4YU94,A7BJS5,D8SNM6,A0A1J8PPA3,X1WG39,M5FQK2,Q69VD5,A0A2R6NSC2,A0A0D8XL16,A0A016WPN3,Q9QZ81,G5EES3,A0A0K0EFP6,Q8CJG0,A0A1D5NTU6,V2WTL2,A0A0V0YLH8,A0A139WDH0,A0A0R3W9Q7,H3DS31,A0A1Y1HWP2,G4T5G9,B7QCC4,A0A0B2UV00,M7BCJ9,E9GN30,Q7PZ41,A0A077Z361,R7U9I3,A0A1X7V1N5,A0A0K0JDP1,A0A0N4UKJ1,A0A498N3A3,A0A3M0IQP5,A0A0L8GBV4,Q32KD4,A0A1J1JBJ0,E0W4C3,A0A482XDA9,A0A3P7EJD6,J9K2Z4,A0A2J7Q8V4,T1IBM6,V3ZRX0,A0A210QKF7,A0A423TSS1,K1PT78,A0A267E8R7,A0A1D2N447,A0A226D7A9,F6YK55,T1KTE4,A0A2C9JGZ6,A0A1V9X9F0,K5X5Z7,A0A3Q0KUG5,T1FY40,1YVU,1Z26,3DLB,5AWH,5G5T,5I4A,6QZK,7R8K,A0A1I7IXT4,A0A2W1JZ37,A0A2S7WBN3,A0A328VKE4,A0A420DFE6,E0ST67,A0A4V1VDY2,A0A368P5I0,C4L1M1,A0A4R1RMM2,A0A1Y2RDH8,Q11QW7,A0A1M5ZSR3,A0A0K8QX04,A0A0M2PXX3,K9TPA9,A0A1L3JHM3,A0A1W6MIP2,A0A1C0UUC4,A0A2U2J9E0,A0A2Z6E1D5,A0A0F4NXW8,L8D0R3,B1XJG0,A0A326U7G5,A0A3D8L290,A0A1Q4R485,K9U8J6,A0A097QRL6,K9RC91,A0A0D8ZUC0,A0A139XGN8,A0A1T4Y3A2,Q5P0R2,B6YTQ5,A0A0B0H9B4,A0YYT3,A0A2T1EFY0,G6FTN0,R6KUL9,A0A433NB65,A0A1Z4L0A1,K9UQR0,A0A2T1G8M7,K9VUN0,B7GJX9,A0A0P6X5X2,K9ZDE3,B0JXD6,A0A2T1LS63,A0A1Z4K1Y3,A0A2Z6E0R7,A0A1N6SSK9,A0A0P4UVI8,A0A0V7ZCG4,A0A1J0AGK2,K9PFF9,A0A2G9DT08,K9UEV4,Q9L1X1,A0A060HNJ0,A0A235B542,R5XQK4,A0A1H3LE92,A0A496APJ8,A0A062U2W9,H0HWQ5,A0A1V9G9U4,A0A1I2ZGP1,A0A317EJY3,A0A1I2BD20,F8ERC7,S7VLM7,A0A1A5X8H4,A0A1I2T6Q1,A0A1R3T9N6,A0A0Q2M2Z1,H8KXJ0,D3S0S6,A0A2D1U4H7,I3TE64,A0A0B7I4Z6,A0LL61,Q8DKB1,A0A139WY18,A0A1J1EK56,A0A2T1E1K4,A0A1Q8ZD62,A0A4Q6XKV6,A0A1Z3HNN4,A0A239JE83,A0A2N4XBY2,Q53W94,R5JEI2,A0A0Q0ZC47,A0A2T0XH18,A0A1V4CHV0,A0A1K1RQP7,A0A2T1EKT1,A0A1N6LUI7,A0A0P0NGR6,A0A1X7IML5,A0A0A2LKJ7,K1L112,A0A0U3AL92,A0A1H3A054,E0UCX3,K9XZC6,B9LVW4,A0A0C1VHB4,Q31N05,A0A0C5JKF3,R5NJJ8,A5D4D9,Q2JI93,A0A142Y7A9,A0A432MEQ5,A0A372DKU2,A0A3R7KLK4,C1F5Q7,A0A4R3EV39,A0A1P8WP90,A0A222F7P0,A0A1C9VH88,A0A2T2YMB1,A0A329TD61,A0A101R2A0,A0A1E3XF49,A0A1U9ND56,A0A4R7BQC4,A0A1H3DGN3,A0A1Q1FPH0,E0TGY3,A0A259TUP4,F6EYI8,A0A2S9Q9J0,A0A4Q2UIU6,A0A1H0LH25,A0A318LG42,H1YCU5,L0JS08,A0A1Q5ZS75,A0A345E7N0,M0AF24,A0A1W2A082,A0A1H3X247,A0A0C1XUA0,M0D2X3,A0A2R5G167,A0A346PK63,R7RTW6,A0A1H2RBI2,A0A1C3ZXN2,B9LVP8,M5RSF0,W0JW77,B7K585,F8D8G0,A0A343TL88,L0AJX6,A0A2A5QS34,A0A343JEE2,A0A3P3RGE5,A0A329TBQ3,A0A285N2A8,A0A0W1S8B8,A0A1V4C8L7,L9VRQ2,E4NRV1,A0A1I6HGN0,A0A1I0NI68,,",366,37
"1094","C.L1.1","C.L21.16",288,179,109,3.18438316846907,"4F1N,4F3T,4KRE,5GUH,5VM9,6KR6,6OON,7KX7,7SWF,A0A163JTZ6,A0A0N4X8S8,A0A196SDB4,J9D5G4,Q389P5,A2DPV7,A0A0G4H2S4,T1H8B3,R1FDF0,D2VMG4,A0A074TLL7,A0A0D1ZAJ4,Q1K660,F4PH46,A0A3M7S814,A0A164ZA52,A0A383WDW5,Q54G64,S7WCF7,I0YVB2,R7QGN7,C1DZY0,A0A2C5Z0M1,A0CB11,R9ACY5,D3BMP8,A0A1Z5TVE5,W7XD45,A0A1U7LLR0,A0A4S2MWZ7,K1VVQ6,A0A158P1R9,G7DVX0,V6R0U9,G4N9J3,E3KLI3,B7Q5I1,A0A1E3QC61,D5GGK8,S8ANP9,A0A139AUH8,L2GMR6,U4LBG4,A0A177URI1,O74957,A0A3N4IGK1,A6N7Y9,A0A0E9NDK5,T1KZ60,A0A250WXN5,A0A2G8JLH3,Q5KAT1,L2GUF2,W2T741,A0A1W0E4B5,A0A2J7QB22,S4RYE2,A0A2K3CW87,A0A388KES6,A0A226EFL3,A0A3S3PD82,A0A0L0TEV1,A0A1S3J512,G0QTT2,A0A1J1HRI1,C4V9J2,Q9JMB7,A0A075AN09,Q5TW24,U5HIG6,A0A401PRI6,Q96J94,A0A2B4RHN2,G2QEV0,A0A397UU01,A0A2T7PFL8,K7ISV0,A0A024FT57,H3HCL6,A0A0G4IME3,E9FUN9,A0A1S3CYL5,D7FQK3,A0A1Y1YHC8,T1GSU4,F4S231,A0A1D8PMK0,A0A2G5B1D8,Q5BD61,A0A1C7M8P2,A0A4D8YSQ3,A0A158PJG6,J9JZ66,A0A0C2XG51,A0A158QZT6,A0A165QYQ9,T0SAU8,R7YY92,A0A3S1A0C3,A0A074YJ47,A0A2K1J482,A0A1Q3ENA6,O04379,A0A371I3C8,M8AEW7,A8P0D4,A0A2K3NY65,F4NYW7,A0A409Y6G2,A0A0L0HAB7,D8PZT7,A0A1D1W4K0,A7RQ46,W4YU94,A7BJS5,D8SNM6,A0A1J8PPA3,X1WG39,M5FQK2,Q69VD5,A0A2R6NSC2,A0A0D8XL16,A0A016WPN3,Q9QZ81,G5EES3,A0A0K0EFP6,Q8CJG0,A0A1D5NTU6,V2WTL2,A0A0V0YLH8,A0A139WDH0,A0A0R3W9Q7,H3DS31,A0A1Y1HWP2,G4T5G9,B7QCC4,A0A0B2UV00,M7BCJ9,E9GN30,Q7PZ41,A0A077Z361,R7U9I3,A0A1X7V1N5,A0A0K0JDP1,A0A0N4UKJ1,A0A498N3A3,A0A3M0IQP5,A0A0L8GBV4,Q32KD4,A0A1J1JBJ0,E0W4C3,A0A482XDA9,A0A3P7EJD6,J9K2Z4,A0A2J7Q8V4,T1IBM6,V3ZRX0,A0A210QKF7,A0A423TSS1,K1PT78,A0A267E8R7,A0A1D2N447,A0A226D7A9,F6YK55,T1KTE4,A0A2C9JGZ6,A0A1V9X9F0,K5X5Z7,A0A3Q0KUG5,T1FY40,1YVU,1Z26,3DLB,5AWH,5G5T,5I4A,6QZK,7R8K,A0A2Z6E1D5,B1XJG0,A0A1T4Y3A2,A0A2G9DT08,Q9L1X1,A0A496APJ8,A0A062U2W9,H0HWQ5,A0A1V9G9U4,A0A1I2ZGP1,A0A317EJY3,A0A1I2BD20,F8ERC7,S7VLM7,A0A1A5X8H4,A0A1I2T6Q1,A0A1R3T9N6,A0A0Q2M2Z1,H8KXJ0,A0A2D1U4H7,A0A0B7I4Z6,A0LL61,A0A139WY18,A0A1J1EK56,A0A2T1E1K4,A0A1Q8ZD62,A0A4Q6XKV6,A0A1Z3HNN4,A0A239JE83,A0A2N4XBY2,Q53W94,R5JEI2,A0A0Q0ZC47,A0A2T0XH18,A0A1V4CHV0,A0A1K1RQP7,A0A2T1EKT1,A0A1N6LUI7,A0A0P0NGR6,A0A1X7IML5,A0A0A2LKJ7,K1L112,A0A0U3AL92,A0A1H3A054,E0UCX3,K9XZC6,Q31N05,A0A0C5JKF3,R5NJJ8,A5D4D9,A0A142Y7A9,A0A432MEQ5,A0A372DKU2,A0A3R7KLK4,C1F5Q7,A0A4R3EV39,A0A1P8WP90,A0A222F7P0,A0A1C9VH88,A0A2T2YMB1,A0A329TD61,A0A101R2A0,A0A1E3XF49,A0A1U9ND56,A0A4R7BQC4,A0A1H3DGN3,E0TGY3,A0A259TUP4,F6EYI8,A0A2S9Q9J0,A0A4Q2UIU6,A0A1H0LH25,A0A318LG42,H1YCU5,L0JS08,A0A1Q5ZS75,A0A345E7N0,M0AF24,A0A1W2A082,A0A1H3X247,A0A0C1XUA0,M0D2X3,A0A2R5G167,A0A346PK63,R7RTW6,A0A1H2RBI2,A0A1C3ZXN2,B9LVP8,M5RSF0,B7K585,F8D8G0,A0A343TL88,A0A343JEE2,A0A3P3RGE5,A0A329TBQ3,A0A0W1S8B8,A0A1V4C8L7,L9VRQ2,E4NRV1,A0A1I6HGN0,A0A1I0NI68,,",366,37
"1097","C.S11.2","C.S12.2",360,179,181,2.8120775332572,"4F1N,4F3T,4KRE,5GUH,5VM9,6KR6,6OON,7KX7,7SWF,A0A163JTZ6,A0A0N4X8S8,A0A196SDB4,J9D5G4,C4LVV2,A0A2P6N8X7,A8BCK6,A2DPV7,A0A0G4H2S4,T1H8B3,R1FDF0,S4RWI0,D2VMG4,A0A074TLL7,A0A0D1ZAJ4,Q1K660,F4PH46,A0A3M7S814,A0A164ZA52,A0A383WDW5,Q54G64,S7WCF7,I0YVB2,R7QGN7,C1DZY0,A0A2C5Z0M1,A0CB11,R9ACY5,D3BMP8,A0A1Z5TVE5,W7XD45,A0A1U7LLR0,A0A4S2MWZ7,K1VVQ6,A0A158P1R9,G7DVX0,V6R0U9,G4N9J3,E3KLI3,B7Q5I1,A0A1E3QC61,D5GGK8,S8ANP9,A0A139AUH8,L2GMR6,U4LBG4,A0A177URI1,O74957,A0A3N4IGK1,A6N7Y9,A0A0E9NDK5,A0A250WXN5,A0A2G8JLH3,Q5KAT1,L2GUF2,W2T741,A0A1W0E4B5,A0A2J7QB22,A0A2K3CW87,A0A226EFL3,A0A3S3PD82,A0A0L0TEV1,A0A1S3J512,G0QTT2,A0A1J1HRI1,C4V9J2,Q9JMB7,A0A075AN09,Q5TW24,U5HIG6,A0A401PRI6,Q96J94,A0A2B4RHN2,G2QEV0,A0A397UU01,A0A2T7PFL8,K7ISV0,A0A024FT57,H3HCL6,A0A0G4IME3,E9FUN9,A0A1S3CYL5,D7FQK3,A0A1Y1YHC8,T1GSU4,F4S231,A0A1D8PMK0,A0A2G5B1D8,Q5BD61,A0A1C7M8P2,A0A4D8YSQ3,A0A158PJG6,J9JZ66,A0A0C2XG51,A0A158QZT6,A0A165QYQ9,T0SAU8,R7YY92,A0A3S1A0C3,A0A074YJ47,A0A2K1J482,A0A1Q3ENA6,O04379,A0A371I3C8,M8AEW7,A8P0D4,A0A2K3NY65,F4NYW7,A0A409Y6G2,A0A0L0HAB7,D8PZT7,A0A1D1W4K0,A7RQ46,W4YU94,A7BJS5,D8SNM6,A0A1J8PPA3,X1WG39,M5FQK2,Q69VD5,A0A2R6NSC2,A0A0D8XL16,A0A016WPN3,Q9QZ81,G5EES3,A0A0K0EFP6,Q8CJG0,A0A1D5NTU6,V2WTL2,A0A0V0YLH8,A0A139WDH0,A0A0R3W9Q7,H3DS31,A0A1Y1HWP2,G4T5G9,B7QCC4,A0A0B2UV00,M7BCJ9,E9GN30,Q7PZ41,A0A077Z361,R7U9I3,A0A1X7V1N5,A0A0K0JDP1,A0A0N4UKJ1,A0A498N3A3,A0A3M0IQP5,A0A0L8GBV4,Q32KD4,A0A1J1JBJ0,E0W4C3,A0A482XDA9,A0A3P7EJD6,J9K2Z4,A0A2J7Q8V4,T1IBM6,V3ZRX0,A0A210QKF7,A0A423TSS1,K1PT78,A0A267E8R7,A0A1D2N447,A0A226D7A9,F6YK55,T1KTE4,A0A2C9JGZ6,A0A1V9X9F0,K5X5Z7,A0A3Q0KUG5,T1FY40,1YVU,3DLB,5AWH,5G5T,5I4A,6QZK,7R8K,E8N0K8,A0A1I7IXT4,A0A2W1JZ37,A0A2S7WBN3,A0A328VKE4,A0A420DFE6,E0ST67,A0A4V1VDY2,A0A368P5I0,C4L1M1,A0A4R1RMM2,A0A1Y2RDH8,Q11QW7,A0A1M5ZSR3,A0A0K8QX04,A0A0M2PXX3,A0A1I3LMA1,K9TPA9,A0A1L3JHM3,A0A1W6MIP2,A0A1C0UUC4,A0A2U2J9E0,A0A2Z6E1D5,A0A0F4NXW8,A0A142XB92,L8D0R3,B1XJG0,A0A326U7G5,A0A3D8L290,H1KXR6,A0A1Q4R485,K9U8J6,A0A097QRL6,K9RC91,A0A0D8ZUC0,A0A139XGN8,A0A1T4Y3A2,Q5P0R2,B6YTQ5,A0A0B0H9B4,A0YYT3,A0A2T1EFY0,G6FTN0,R6KUL9,A0A433NB65,A0A1Z4L0A1,K9UQR0,A0A2T1G8M7,K9VUN0,B7GJX9,A0A0P6X5X2,K9ZDE3,B0JXD6,A0A2T1LS63,A0A1Z4K1Y3,A0A2Z6E0R7,A0A1N6SSK9,A0A0P4UVI8,A0A0V7ZCG4,A0A1J0AGK2,K9PFF9,A0A2G9DT08,K9UEV4,Q9L1X1,A0A235B542,R5XQK4,A0A1H3LE92,A0A496APJ8,A0A062U2W9,H0HWQ5,A0A1V9G9U4,A0A1I2ZGP1,A0A317EJY3,A0A1I2BD20,F8ERC7,S7VLM7,A0A1A5X8H4,A0A1I2T6Q1,A0A1R3T9N6,A0A0Q2M2Z1,H8KXJ0,D3S0S6,A0A2D1U4H7,I3TE64,A0A0B7I4Z6,A0LL61,Q8DKB1,A0A139WY18,A0A1J1EK56,A0A2T1E1K4,A0A1Q8ZD62,A0A4Q6XKV6,A0A1Z3HNN4,A0A239JE83,A0A2N4XBY2,Q53W94,R5JEI2,A0A0Q0ZC47,A0A2T0XH18,A0A1V4CHV0,A0A1K1RQP7,A0A2T1EKT1,A0A1N6LUI7,A0A0P0NGR6,A0A1X7IML5,A0A0A2LKJ7,K1L112,A0A0U3AL92,A0A1H3A054,E0UCX3,K9XZC6,B9LVW4,A0A0C1VHB4,Q31N05,A0A0C5JKF3,R5NJJ8,A5D4D9,Q2JI93,A0A142Y7A9,A0A432MEQ5,A0A372DKU2,A0A3R7KLK4,C1F5Q7,A0A4R3EV39,A0A1P8WP90,A0A222F7P0,A0A1C9VH88,A0A2T2YMB1,A0A329TD61,A0A101R2A0,A0A1E3XF49,A0A1U9ND56,A0A4R7BQC4,A0A1H3DGN3,A0A1Q1FPH0,E0TGY3,A0A259TUP4,F6EYI8,A0A2S9Q9J0,A0A4Q2UIU6,A0A1H0LH25,A0A318LG42,H1YCU5,L0JS08,A0A1Q5ZS75,A0A345E7N0,M0AF24,A0A1W2A082,A0A1H3X247,A0A0C1XUA0,M0D2X3,A0A2R5G167,A0A346PK63,R7RTW6,A0A1H2RBI2,A0A1C3ZXN2,B9LVP8,M5RSF0,W0JW77,B7K585,F8D8G0,A0A343TL88,L0AJX6,A0A2A5QS34,A0A343JEE2,A0A3P3RGE5,A0A329TBQ3,A0A285N2A8,A0A0W1S8B8,A0A1V4C8L7,L9VRQ2,E4NRV1,A0A1I6HGN0,A0A1I0NI68,,",366,37
"1098","C.S11.2","C.S12.3",361,179,182,1.21003437902879,"4F1N,4F3T,4KRE,5GUH,5VM9,6KR6,6OON,7KX7,7SWF,A0A163JTZ6,A0A0N4X8S8,A0A196SDB4,J9D5G4,C4LVV2,A0A2P6N8X7,A8BCK6,A2DPV7,A0A0G4H2S4,T1H8B3,R1FDF0,S4RWI0,D2VMG4,A0A074TLL7,A0A0D1ZAJ4,Q1K660,F4PH46,A0A3M7S814,A0A164ZA52,A0A383WDW5,Q54G64,S7WCF7,I0YVB2,R7QGN7,C1DZY0,A0A2C5Z0M1,A0CB11,R9ACY5,D3BMP8,A0A1Z5TVE5,W7XD45,A0A1U7LLR0,A0A4S2MWZ7,K1VVQ6,A0A158P1R9,G7DVX0,V6R0U9,G4N9J3,E3KLI3,B7Q5I1,A0A1E3QC61,D5GGK8,S8ANP9,A0A139AUH8,L2GMR6,U4LBG4,A0A177URI1,O74957,A0A3N4IGK1,A6N7Y9,A0A0E9NDK5,A0A250WXN5,A0A2G8JLH3,Q5KAT1,L2GUF2,W2T741,A0A1W0E4B5,A0A2J7QB22,A0A2K3CW87,A0A226EFL3,A0A3S3PD82,A0A0L0TEV1,A0A1S3J512,G0QTT2,A0A1J1HRI1,C4V9J2,Q9JMB7,A0A075AN09,Q5TW24,U5HIG6,A0A401PRI6,Q96J94,A0A2B4RHN2,G2QEV0,A0A397UU01,A0A2T7PFL8,K7ISV0,A0A024FT57,H3HCL6,A0A0G4IME3,E9FUN9,A0A1S3CYL5,D7FQK3,A0A1Y1YHC8,T1GSU4,F4S231,A0A1D8PMK0,A0A2G5B1D8,Q5BD61,A0A1C7M8P2,A0A4D8YSQ3,A0A158PJG6,J9JZ66,A0A0C2XG51,A0A158QZT6,A0A165QYQ9,T0SAU8,R7YY92,A0A3S1A0C3,A0A074YJ47,A0A2K1J482,A0A1Q3ENA6,O04379,A0A371I3C8,M8AEW7,A8P0D4,A0A2K3NY65,F4NYW7,A0A409Y6G2,A0A0L0HAB7,D8PZT7,A0A1D1W4K0,A7RQ46,W4YU94,A7BJS5,D8SNM6,A0A1J8PPA3,X1WG39,M5FQK2,Q69VD5,A0A2R6NSC2,A0A0D8XL16,A0A016WPN3,Q9QZ81,G5EES3,A0A0K0EFP6,Q8CJG0,A0A1D5NTU6,V2WTL2,A0A0V0YLH8,A0A139WDH0,A0A0R3W9Q7,H3DS31,A0A1Y1HWP2,G4T5G9,B7QCC4,A0A0B2UV00,M7BCJ9,E9GN30,Q7PZ41,A0A077Z361,R7U9I3,A0A1X7V1N5,A0A0K0JDP1,A0A0N4UKJ1,A0A498N3A3,A0A3M0IQP5,A0A0L8GBV4,Q32KD4,A0A1J1JBJ0,E0W4C3,A0A482XDA9,A0A3P7EJD6,J9K2Z4,A0A2J7Q8V4,T1IBM6,V3ZRX0,A0A210QKF7,A0A423TSS1,K1PT78,A0A267E8R7,A0A1D2N447,A0A226D7A9,F6YK55,T1KTE4,A0A2C9JGZ6,A0A1V9X9F0,K5X5Z7,A0A3Q0KUG5,T1FY40,1YVU,1Z26,3DLB,5AWH,5G5T,5I4A,6QZK,7R8K,E8N0K8,A0A1I7IXT4,A0A2W1JZ37,A0A2S7WBN3,A0A328VKE4,A0A420DFE6,E0ST67,A0A4V1VDY2,A0A368P5I0,C4L1M1,A0A4R1RMM2,A0A1Y2RDH8,Q11QW7,A0A1M5ZSR3,A0A0K8QX04,A0A0M2PXX3,A0A1I3LMA1,K9TPA9,A0A1L3JHM3,A0A1W6MIP2,A0A1C0UUC4,A0A2U2J9E0,A0A2Z6E1D5,A0A0F4NXW8,A0A142XB92,L8D0R3,B1XJG0,A0A326U7G5,A0A3D8L290,H1KXR6,A0A1Q4R485,K9U8J6,A0A097QRL6,K9RC91,A0A0D8ZUC0,A0A139XGN8,A0A1T4Y3A2,Q5P0R2,B6YTQ5,A0A0B0H9B4,A0YYT3,A0A2T1EFY0,G6FTN0,R6KUL9,A0A433NB65,A0A1Z4L0A1,K9UQR0,A0A2T1G8M7,K9VUN0,B7GJX9,A0A0P6X5X2,K9ZDE3,B0JXD6,A0A2T1LS63,A0A1Z4K1Y3,A0A2Z6E0R7,A0A1N6SSK9,A0A0P4UVI8,A0A0V7ZCG4,A0A1J0AGK2,K9PFF9,A0A2G9DT08,K9UEV4,Q9L1X1,A0A235B542,R5XQK4,A0A1H3LE92,A0A496APJ8,A0A062U2W9,H0HWQ5,A0A1V9G9U4,A0A1I2ZGP1,A0A317EJY3,A0A1I2BD20,F8ERC7,S7VLM7,A0A1A5X8H4,A0A1I2T6Q1,A0A1R3T9N6,A0A0Q2M2Z1,H8KXJ0,D3S0S6,A0A2D1U4H7,I3TE64,A0A0B7I4Z6,A0LL61,Q8DKB1,A0A139WY18,A0A1J1EK56,A0A2T1E1K4,A0A1Q8ZD62,A0A4Q6XKV6,A0A1Z3HNN4,A0A239JE83,A0A2N4XBY2,Q53W94,R5JEI2,A0A0Q0ZC47,A0A2T0XH18,A0A1V4CHV0,A0A1K1RQP7,A0A2T1EKT1,A0A1N6LUI7,A0A0P0NGR6,A0A1X7IML5,A0A0A2LKJ7,K1L112,A0A0U3AL92,A0A1H3A054,E0UCX3,K9XZC6,B9LVW4,A0A0C1VHB4,Q31N05,A0A0C5JKF3,R5NJJ8,A5D4D9,Q2JI93,A0A142Y7A9,A0A432MEQ5,A0A372DKU2,A0A3R7KLK4,C1F5Q7,A0A4R3EV39,A0A1P8WP90,A0A222F7P0,A0A1C9VH88,A0A2T2YMB1,A0A329TD61,A0A101R2A0,A0A1E3XF49,A0A1U9ND56,A0A4R7BQC4,A0A1H3DGN3,A0A1Q1FPH0,E0TGY3,A0A259TUP4,F6EYI8,A0A2S9Q9J0,A0A4Q2UIU6,A0A1H0LH25,A0A318LG42,H1YCU5,L0JS08,A0A1Q5ZS75,A0A345E7N0,M0AF24,A0A1W2A082,A0A1H3X247,A0A0C1XUA0,M0D2X3,A0A2R5G167,A0A346PK63,R7RTW6,A0A1H2RBI2,A0A1C3ZXN2,B9LVP8,M5RSF0,W0JW77,B7K585,F8D8G0,A0A343TL88,L0AJX6,A0A2A5QS34,A0A343JEE2,A0A3P3RGE5,A0A329TBQ3,A0A285N2A8,A0A0W1S8B8,A0A1V4C8L7,L9VRQ2,E4NRV1,A0A1I6HGN0,A0A1I0NI68,,",366,37
"1099","C.S11.2","C.S8.2",357,179,178,2.24067855125228,"4F1N,4F3T,4KRE,5GUH,5VM9,6KR6,6OON,7KX7,A0A163JTZ6,A0A0N4X8S8,A0A196SDB4,J9D5G4,Q389P5,C4LVV2,A0A2P6N8X7,A8BCK6,A2DPV7,A0A0G4H2S4,T1H8B3,R1FDF0,S4RWI0,D2VMG4,A0A074TLL7,A0A0D1ZAJ4,Q1K660,F4PH46,A0A3M7S814,A0A164ZA52,A0A383WDW5,Q54G64,S7WCF7,I0YVB2,R7QGN7,C1DZY0,A0A2C5Z0M1,A0CB11,R9ACY5,D3BMP8,A0A1Z5TVE5,W7XD45,A0A4S2MWZ7,K1VVQ6,A0A158P1R9,G7DVX0,V6R0U9,G4N9J3,E3KLI3,B7Q5I1,A0A1E3QC61,D5GGK8,S8ANP9,A0A139AUH8,L2GMR6,U4LBG4,A0A177URI1,O74957,A0A3N4IGK1,A6N7Y9,A0A0E9NDK5,T1KZ60,A0A250WXN5,A0A2G8JLH3,Q5KAT1,L2GUF2,W2T741,A0A1W0E4B5,A0A2J7QB22,A0A2K3CW87,A0A226EFL3,A0A3S3PD82,A0A0L0TEV1,A0A1S3J512,G0QTT2,A0A1J1HRI1,C4V9J2,Q9JMB7,A0A075AN09,Q5TW24,U5HIG6,A0A401PRI6,Q96J94,A0A2B4RHN2,G2QEV0,A0A397UU01,A0A2T7PFL8,K7ISV0,A0A024FT57,H3HCL6,A0A0G4IME3,E9FUN9,A0A1S3CYL5,D7FQK3,A0A1Y1YHC8,T1GSU4,F4S231,A0A1D8PMK0,A0A2G5B1D8,Q5BD61,A0A1C7M8P2,A0A4D8YSQ3,A0A158PJG6,J9JZ66,A0A0C2XG51,A0A158QZT6,A0A165QYQ9,T0SAU8,R7YY92,A0A3S1A0C3,A0A074YJ47,A0A2K1J482,A0A1Q3ENA6,O04379,A0A371I3C8,M8AEW7,A8P0D4,A0A2K3NY65,F4NYW7,A0A409Y6G2,A0A0L0HAB7,D8PZT7,A0A1D1W4K0,A7RQ46,W4YU94,A7BJS5,D8SNM6,A0A1J8PPA3,X1WG39,M5FQK2,Q69VD5,A0A2R6NSC2,A0A0D8XL16,A0A016WPN3,Q9QZ81,G5EES3,A0A0K0EFP6,Q8CJG0,A0A1D5NTU6,V2WTL2,A0A0V0YLH8,A0A139WDH0,A0A0R3W9Q7,H3DS31,A0A1Y1HWP2,G4T5G9,B7QCC4,A0A0B2UV00,M7BCJ9,E9GN30,Q7PZ41,A0A077Z361,R7U9I3,A0A1X7V1N5,A0A0K0JDP1,A0A0N4UKJ1,A0A498N3A3,A0A3M0IQP5,A0A0L8GBV4,Q32KD4,A0A1J1JBJ0,E0W4C3,A0A482XDA9,A0A3P7EJD6,J9K2Z4,A0A2J7Q8V4,T1IBM6,V3ZRX0,A0A210QKF7,A0A423TSS1,K1PT78,A0A267E8R7,A0A1D2N447,A0A226D7A9,F6YK55,T1KTE4,A0A2C9JGZ6,A0A1V9X9F0,K5X5Z7,A0A3Q0KUG5,T1FY40,1YVU,1Z26,3DLB,5AWH,5G5T,5I4A,6QZK,7R8K,E8N0K8,A0A1I7IXT4,A0A2W1JZ37,A0A2S7WBN3,A0A328VKE4,A0A420DFE6,E0ST67,A0A4V1VDY2,A0A368P5I0,C4L1M1,Q11QW7,A0A1M5ZSR3,A0A0K8QX04,A0A0M2PXX3,A0A1I3LMA1,K9TPA9,A0A1W6MIP2,A0A1C0UUC4,A0A2U2J9E0,A0A2Z6E1D5,A0A0F4NXW8,A0A142XB92,L8D0R3,B1XJG0,A0A326U7G5,A0A3D8L290,H1KXR6,A0A1Q4R485,K9U8J6,A0A097QRL6,K9RC91,A0A0D8ZUC0,A0A139XGN8,A0A1T4Y3A2,Q5P0R2,B6YTQ5,A0A0B0H9B4,A0YYT3,A0A2T1EFY0,G6FTN0,R6KUL9,A0A433NB65,A0A1Z4L0A1,K9UQR0,A0A2T1G8M7,K9VUN0,B7GJX9,A0A0P6X5X2,K9ZDE3,B0JXD6,A0A2T1LS63,A0A1Z4K1Y3,A0A2Z6E0R7,A0A1N6SSK9,A0A0P4UVI8,A0A0V7ZCG4,A0A1J0AGK2,K9PFF9,A0A2G9DT08,K9UEV4,Q9L1X1,A0A060HNJ0,A0A235B542,R5XQK4,A0A1H3LE92,A0A062U2W9,H0HWQ5,A0A1V9G9U4,A0A1I2ZGP1,A0A317EJY3,A0A1I2BD20,F8ERC7,S7VLM7,A0A1A5X8H4,A0A1I2T6Q1,A0A1R3T9N6,A0A0Q2M2Z1,H8KXJ0,D3S0S6,A0A2D1U4H7,I3TE64,A0A0B7I4Z6,A0LL61,Q8DKB1,A0A139WY18,A0A1J1EK56,A0A2T1E1K4,A0A1Q8ZD62,A0A4Q6XKV6,A0A239JE83,A0A2N4XBY2,Q53W94,R5JEI2,A0A0Q0ZC47,A0A2T0XH18,A0A1V4CHV0,A0A1K1RQP7,A0A2T1EKT1,A0A1N6LUI7,A0A0P0NGR6,A0A1X7IML5,A0A0A2LKJ7,K1L112,A0A0U3AL92,A0A1H3A054,E0UCX3,K9XZC6,B9LVW4,A0A0C1VHB4,Q31N05,A0A0C5JKF3,R5NJJ8,A5D4D9,Q2JI93,A0A142Y7A9,A0A432MEQ5,A0A372DKU2,A0A3R7KLK4,C1F5Q7,A0A4R3EV39,A0A1P8WP90,A0A222F7P0,A0A1C9VH88,A0A2T2YMB1,A0A329TD61,A0A101R2A0,A0A1E3XF49,A0A1U9ND56,A0A4R7BQC4,A0A1H3DGN3,A0A1Q1FPH0,E0TGY3,A0A259TUP4,F6EYI8,A0A2S9Q9J0,A0A4Q2UIU6,A0A1H0LH25,A0A318LG42,H1YCU5,L0JS08,A0A1Q5ZS75,A0A345E7N0,M0AF24,A0A1W2A082,A0A1H3X247,A0A0C1XUA0,M0D2X3,A0A2R5G167,A0A346PK63,R7RTW6,A0A1H2RBI2,A0A1C3ZXN2,B9LVP8,M5RSF0,W0JW77,B7K585,F8D8G0,A0A343TL88,L0AJX6,A0A2A5QS34,A0A343JEE2,A0A3P3RGE5,A0A329TBQ3,A0A285N2A8,A0A0W1S8B8,A0A1V4C8L7,L9VRQ2,E4NRV1,A0A1I6HGN0,A0A1I0NI68,,",366,37
"1100","C.S11.4","C.S12.5",360,179,181,3.22517670298466,"4F1N,4F3T,4KRE,5GUH,5VM9,6KR6,6OON,7KX7,7SWF,A0A163JTZ6,A0A0N4X8S8,A0A196SDB4,J9D5G4,C4LVV2,A0A2P6N8X7,A8BCK6,A2DPV7,A0A0G4H2S4,T1H8B3,R1FDF0,S4RWI0,D2VMG4,A0A074TLL7,A0A0D1ZAJ4,Q1K660,F4PH46,A0A3M7S814,A0A164ZA52,A0A383WDW5,Q54G64,S7WCF7,I0YVB2,R7QGN7,C1DZY0,A0A2C5Z0M1,A0CB11,R9ACY5,D3BMP8,A0A1Z5TVE5,W7XD45,A0A1U7LLR0,A0A4S2MWZ7,K1VVQ6,A0A158P1R9,G7DVX0,V6R0U9,G4N9J3,E3KLI3,B7Q5I1,A0A1E3QC61,D5GGK8,S8ANP9,A0A139AUH8,L2GMR6,U4LBG4,A0A177URI1,O74957,A0A3N4IGK1,A6N7Y9,A0A0E9NDK5,A0A250WXN5,A0A2G8JLH3,Q5KAT1,L2GUF2,W2T741,A0A1W0E4B5,A0A2J7QB22,A0A2K3CW87,A0A226EFL3,A0A3S3PD82,A0A0L0TEV1,A0A1S3J512,G0QTT2,A0A1J1HRI1,C4V9J2,Q9JMB7,A0A075AN09,Q5TW24,U5HIG6,A0A401PRI6,Q96J94,A0A2B4RHN2,G2QEV0,A0A397UU01,A0A2T7PFL8,K7ISV0,A0A024FT57,H3HCL6,A0A0G4IME3,E9FUN9,A0A1S3CYL5,D7FQK3,A0A1Y1YHC8,T1GSU4,F4S231,A0A1D8PMK0,A0A2G5B1D8,Q5BD61,A0A1C7M8P2,A0A4D8YSQ3,A0A158PJG6,J9JZ66,A0A0C2XG51,A0A158QZT6,A0A165QYQ9,T0SAU8,R7YY92,A0A3S1A0C3,A0A074YJ47,A0A2K1J482,A0A1Q3ENA6,O04379,A0A371I3C8,M8AEW7,A8P0D4,A0A2K3NY65,F4NYW7,A0A409Y6G2,A0A0L0HAB7,D8PZT7,A0A1D1W4K0,A7RQ46,W4YU94,A7BJS5,D8SNM6,A0A1J8PPA3,X1WG39,M5FQK2,Q69VD5,A0A2R6NSC2,A0A0D8XL16,A0A016WPN3,Q9QZ81,G5EES3,A0A0K0EFP6,Q8CJG0,A0A1D5NTU6,V2WTL2,A0A0V0YLH8,A0A139WDH0,A0A0R3W9Q7,H3DS31,A0A1Y1HWP2,G4T5G9,B7QCC4,A0A0B2UV00,M7BCJ9,E9GN30,Q7PZ41,A0A077Z361,R7U9I3,A0A1X7V1N5,A0A0K0JDP1,A0A0N4UKJ1,A0A498N3A3,A0A3M0IQP5,A0A0L8GBV4,Q32KD4,A0A1J1JBJ0,E0W4C3,A0A482XDA9,A0A3P7EJD6,J9K2Z4,A0A2J7Q8V4,T1IBM6,V3ZRX0,A0A210QKF7,A0A423TSS1,K1PT78,A0A267E8R7,A0A1D2N447,A0A226D7A9,F6YK55,T1KTE4,A0A2C9JGZ6,A0A1V9X9F0,K5X5Z7,A0A3Q0KUG5,T1FY40,1YVU,3DLB,5AWH,5G5T,5I4A,6QZK,7R8K,E8N0K8,A0A1I7IXT4,A0A2W1JZ37,A0A2S7WBN3,A0A328VKE4,A0A420DFE6,E0ST67,A0A4V1VDY2,A0A368P5I0,C4L1M1,A0A4R1RMM2,A0A1Y2RDH8,Q11QW7,A0A1M5ZSR3,A0A0K8QX04,A0A0M2PXX3,A0A1I3LMA1,K9TPA9,A0A1L3JHM3,A0A1W6MIP2,A0A1C0UUC4,A0A2U2J9E0,A0A2Z6E1D5,A0A0F4NXW8,A0A142XB92,L8D0R3,B1XJG0,A0A326U7G5,A0A3D8L290,H1KXR6,A0A1Q4R485,K9U8J6,A0A097QRL6,K9RC91,A0A0D8ZUC0,A0A139XGN8,A0A1T4Y3A2,Q5P0R2,B6YTQ5,A0A0B0H9B4,A0YYT3,A0A2T1EFY0,G6FTN0,R6KUL9,A0A433NB65,A0A1Z4L0A1,K9UQR0,A0A2T1G8M7,K9VUN0,B7GJX9,A0A0P6X5X2,K9ZDE3,B0JXD6,A0A2T1LS63,A0A1Z4K1Y3,A0A2Z6E0R7,A0A1N6SSK9,A0A0P4UVI8,A0A0V7ZCG4,A0A1J0AGK2,K9PFF9,A0A2G9DT08,K9UEV4,Q9L1X1,A0A060HNJ0,A0A235B542,R5XQK4,A0A1H3LE92,A0A496APJ8,A0A062U2W9,H0HWQ5,A0A1V9G9U4,A0A1I2ZGP1,A0A317EJY3,A0A1I2BD20,F8ERC7,S7VLM7,A0A1A5X8H4,A0A1I2T6Q1,A0A1R3T9N6,H8KXJ0,D3S0S6,A0A2D1U4H7,I3TE64,A0A0B7I4Z6,A0LL61,Q8DKB1,A0A139WY18,A0A1J1EK56,A0A2T1E1K4,A0A1Q8ZD62,A0A4Q6XKV6,A0A1Z3HNN4,A0A239JE83,A0A2N4XBY2,Q53W94,R5JEI2,A0A0Q0ZC47,A0A2T0XH18,A0A1V4CHV0,A0A1K1RQP7,A0A2T1EKT1,A0A1N6LUI7,A0A0P0NGR6,A0A1X7IML5,A0A0A2LKJ7,K1L112,A0A0U3AL92,A0A1H3A054,E0UCX3,K9XZC6,B9LVW4,A0A0C1VHB4,Q31N05,A0A0C5JKF3,R5NJJ8,A5D4D9,Q2JI93,A0A142Y7A9,A0A432MEQ5,A0A372DKU2,A0A3R7KLK4,C1F5Q7,A0A4R3EV39,A0A1P8WP90,A0A222F7P0,A0A1C9VH88,A0A2T2YMB1,A0A329TD61,A0A101R2A0,A0A1E3XF49,A0A1U9ND56,A0A4R7BQC4,A0A1H3DGN3,A0A1Q1FPH0,E0TGY3,A0A259TUP4,F6EYI8,A0A2S9Q9J0,A0A4Q2UIU6,A0A1H0LH25,A0A318LG42,H1YCU5,L0JS08,A0A1Q5ZS75,A0A345E7N0,M0AF24,A0A1W2A082,A0A1H3X247,A0A0C1XUA0,M0D2X3,A0A2R5G167,A0A346PK63,R7RTW6,A0A1H2RBI2,A0A1C3ZXN2,B9LVP8,M5RSF0,W0JW77,B7K585,F8D8G0,A0A343TL88,L0AJX6,A0A2A5QS34,A0A343JEE2,A0A3P3RGE5,A0A329TBQ3,A0A285N2A8,A0A0W1S8B8,A0A1V4C8L7,L9VRQ2,E4NRV1,A0A1I6HGN0,A0A1I0NI68,,",366,37
"1101","C.S11.4","C.S8.4",361,179,182,2.9442875560194,"4F3T,4KRE,5GUH,5VM9,6KR6,6OON,7KX7,7SWF,A0A163JTZ6,A0A0N4X8S8,A0A196SDB4,J9D5G4,C4LVV2,A0A2P6N8X7,A8BCK6,A2DPV7,A0A0G4H2S4,T1H8B3,R1FDF0,S4RWI0,D2VMG4,A0A074TLL7,A0A0D1ZAJ4,Q1K660,F4PH46,A0A3M7S814,A0A164ZA52,A0A383WDW5,Q54G64,S7WCF7,I0YVB2,R7QGN7,C1DZY0,A0A2C5Z0M1,A0CB11,R9ACY5,D3BMP8,A0A1Z5TVE5,W7XD45,A0A1U7LLR0,A0A4S2MWZ7,K1VVQ6,A0A158P1R9,G7DVX0,V6R0U9,G4N9J3,E3KLI3,B7Q5I1,A0A1E3QC61,D5GGK8,S8ANP9,A0A139AUH8,L2GMR6,U4LBG4,A0A177URI1,O74957,A0A3N4IGK1,A6N7Y9,A0A0E9NDK5,T1KZ60,A0A250WXN5,A0A2G8JLH3,Q5KAT1,L2GUF2,W2T741,A0A1W0E4B5,A0A2J7QB22,A0A2K3CW87,A0A226EFL3,A0A3S3PD82,A0A0L0TEV1,A0A1S3J512,G0QTT2,A0A1J1HRI1,C4V9J2,Q9JMB7,A0A075AN09,Q5TW24,U5HIG6,A0A401PRI6,Q96J94,A0A2B4RHN2,G2QEV0,A0A397UU01,A0A2T7PFL8,K7ISV0,A0A024FT57,H3HCL6,A0A0G4IME3,E9FUN9,A0A1S3CYL5,D7FQK3,A0A1Y1YHC8,T1GSU4,F4S231,A0A1D8PMK0,A0A2G5B1D8,Q5BD61,A0A1C7M8P2,A0A4D8YSQ3,A0A158PJG6,J9JZ66,A0A0C2XG51,A0A158QZT6,A0A165QYQ9,T0SAU8,R7YY92,A0A3S1A0C3,A0A074YJ47,A0A2K1J482,A0A1Q3ENA6,O04379,A0A371I3C8,M8AEW7,A8P0D4,A0A2K3NY65,F4NYW7,A0A409Y6G2,A0A0L0HAB7,D8PZT7,A0A1D1W4K0,A7RQ46,W4YU94,A7BJS5,D8SNM6,A0A1J8PPA3,X1WG39,M5FQK2,Q69VD5,A0A2R6NSC2,A0A0D8XL16,A0A016WPN3,Q9QZ81,G5EES3,A0A0K0EFP6,Q8CJG0,A0A1D5NTU6,V2WTL2,A0A0V0YLH8,A0A139WDH0,A0A0R3W9Q7,H3DS31,A0A1Y1HWP2,G4T5G9,B7QCC4,A0A0B2UV00,M7BCJ9,E9GN30,Q7PZ41,A0A077Z361,R7U9I3,A0A1X7V1N5,A0A0K0JDP1,A0A0N4UKJ1,A0A498N3A3,A0A3M0IQP5,A0A0L8GBV4,Q32KD4,A0A1J1JBJ0,E0W4C3,A0A482XDA9,A0A3P7EJD6,J9K2Z4,A0A2J7Q8V4,T1IBM6,V3ZRX0,A0A210QKF7,A0A423TSS1,K1PT78,A0A267E8R7,A0A1D2N447,A0A226D7A9,F6YK55,T1KTE4,A0A2C9JGZ6,A0A1V9X9F0,K5X5Z7,A0A3Q0KUG5,T1FY40,1YVU,1Z26,3DLB,5AWH,5G5T,5I4A,6QZK,7R8K,E8N0K8,A0A1I7IXT4,A0A2W1JZ37,A0A2S7WBN3,A0A328VKE4,A0A420DFE6,E0ST67,A0A4V1VDY2,A0A368P5I0,C4L1M1,A0A4R1RMM2,A0A1Y2RDH8,Q11QW7,A0A1M5ZSR3,A0A0K8QX04,A0A0M2PXX3,A0A1I3LMA1,K9TPA9,A0A1L3JHM3,A0A1W6MIP2,A0A1C0UUC4,A0A2U2J9E0,A0A2Z6E1D5,A0A0F4NXW8,A0A142XB92,L8D0R3,B1XJG0,A0A326U7G5,A0A3D8L290,H1KXR6,A0A1Q4R485,K9U8J6,A0A097QRL6,K9RC91,A0A0D8ZUC0,A0A139XGN8,A0A1T4Y3A2,Q5P0R2,B6YTQ5,A0A0B0H9B4,A0YYT3,A0A2T1EFY0,G6FTN0,R6KUL9,A0A433NB65,A0A1Z4L0A1,K9UQR0,A0A2T1G8M7,K9VUN0,B7GJX9,A0A0P6X5X2,K9ZDE3,B0JXD6,A0A2T1LS63,A0A1Z4K1Y3,A0A2Z6E0R7,A0A1N6SSK9,A0A0P4UVI8,A0A0V7ZCG4,A0A1J0AGK2,K9PFF9,A0A2G9DT08,K9UEV4,Q9L1X1,A0A060HNJ0,A0A235B542,R5XQK4,A0A1H3LE92,A0A496APJ8,A0A062U2W9,H0HWQ5,A0A1V9G9U4,A0A1I2ZGP1,A0A317EJY3,A0A1I2BD20,F8ERC7,S7VLM7,A0A1A5X8H4,A0A1I2T6Q1,A0A1R3T9N6,A0A0Q2M2Z1,H8KXJ0,D3S0S6,A0A2D1U4H7,I3TE64,A0A0B7I4Z6,A0LL61,Q8DKB1,A0A139WY18,A0A1J1EK56,A0A2T1E1K4,A0A1Q8ZD62,A0A4Q6XKV6,A0A1Z3HNN4,A0A239JE83,A0A2N4XBY2,Q53W94,R5JEI2,A0A0Q0ZC47,A0A2T0XH18,A0A1V4CHV0,A0A1K1RQP7,A0A2T1EKT1,A0A1N6LUI7,A0A0P0NGR6,A0A1X7IML5,A0A0A2LKJ7,K1L112,A0A0U3AL92,A0A1H3A054,E0UCX3,K9XZC6,A0A0C1VHB4,Q31N05,A0A0C5JKF3,R5NJJ8,A5D4D9,Q2JI93,A0A142Y7A9,A0A432MEQ5,A0A372DKU2,A0A3R7KLK4,C1F5Q7,A0A4R3EV39,A0A1P8WP90,A0A222F7P0,A0A1C9VH88,A0A2T2YMB1,A0A329TD61,A0A101R2A0,A0A1E3XF49,A0A1U9ND56,A0A4R7BQC4,A0A1H3DGN3,A0A1Q1FPH0,E0TGY3,A0A259TUP4,F6EYI8,A0A2S9Q9J0,A0A4Q2UIU6,A0A1H0LH25,A0A318LG42,H1YCU5,L0JS08,A0A1Q5ZS75,A0A345E7N0,M0AF24,A0A1W2A082,A0A1H3X247,A0A0C1XUA0,M0D2X3,A0A2R5G167,A0A346PK63,R7RTW6,A0A1H2RBI2,A0A1C3ZXN2,B9LVP8,M5RSF0,W0JW77,B7K585,F8D8G0,A0A343TL88,L0AJX6,A0A2A5QS34,A0A343JEE2,A0A3P3RGE5,A0A329TBQ3,A0A285N2A8,A0A0W1S8B8,A0A1V4C8L7,L9VRQ2,E4NRV1,A0A1I6HGN0,A0A1I0NI68,,",366,37
"1102","C.S11.5","C.S12.5",357,179,178,2.8115623626891,"4F1N,4F3T,4KRE,5GUH,5VM9,6KR6,6OON,7KX7,7SWF,A0A163JTZ6,A0A0N4X8S8,A0A196SDB4,J9D5G4,C4LVV2,A0A2P6N8X7,A8BCK6,A2DPV7,A0A0G4H2S4,T1H8B3,R1FDF0,S4RWI0,D2VMG4,A0A074TLL7,A0A0D1ZAJ4,Q1K660,F4PH46,A0A3M7S814,A0A164ZA52,A0A383WDW5,Q54G64,S7WCF7,I0YVB2,R7QGN7,C1DZY0,A0A2C5Z0M1,A0CB11,R9ACY5,D3BMP8,A0A1Z5TVE5,W7XD45,A0A1U7LLR0,A0A4S2MWZ7,K1VVQ6,A0A158P1R9,G7DVX0,V6R0U9,G4N9J3,E3KLI3,B7Q5I1,A0A1E3QC61,D5GGK8,S8ANP9,A0A139AUH8,L2GMR6,U4LBG4,A0A177URI1,O74957,A0A3N4IGK1,A6N7Y9,A0A0E9NDK5,A0A250WXN5,A0A2G8JLH3,Q5KAT1,L2GUF2,W2T741,A0A1W0E4B5,A0A2J7QB22,A0A2K3CW87,A0A226EFL3,A0A3S3PD82,A0A0L0TEV1,A0A1S3J512,G0QTT2,A0A1J1HRI1,C4V9J2,Q9JMB7,A0A075AN09,Q5TW24,U5HIG6,A0A401PRI6,Q96J94,A0A2B4RHN2,G2QEV0,A0A397UU01,A0A2T7PFL8,K7ISV0,A0A024FT57,H3HCL6,A0A0G4IME3,E9FUN9,A0A1S3CYL5,D7FQK3,A0A1Y1YHC8,T1GSU4,F4S231,A0A1D8PMK0,A0A2G5B1D8,Q5BD61,A0A1C7M8P2,A0A4D8YSQ3,A0A158PJG6,J9JZ66,A0A0C2XG51,A0A158QZT6,A0A165QYQ9,T0SAU8,R7YY92,A0A3S1A0C3,A0A074YJ47,A0A2K1J482,A0A1Q3ENA6,O04379,A0A371I3C8,M8AEW7,A8P0D4,A0A2K3NY65,F4NYW7,A0A409Y6G2,A0A0L0HAB7,D8PZT7,A0A1D1W4K0,A7RQ46,W4YU94,A7BJS5,D8SNM6,A0A1J8PPA3,X1WG39,M5FQK2,Q69VD5,A0A2R6NSC2,A0A0D8XL16,A0A016WPN3,Q9QZ81,G5EES3,A0A0K0EFP6,Q8CJG0,A0A1D5NTU6,V2WTL2,A0A0V0YLH8,A0A139WDH0,A0A0R3W9Q7,H3DS31,A0A1Y1HWP2,G4T5G9,B7QCC4,A0A0B2UV00,M7BCJ9,E9GN30,Q7PZ41,A0A077Z361,R7U9I3,A0A1X7V1N5,A0A0K0JDP1,A0A0N4UKJ1,A0A498N3A3,A0A3M0IQP5,A0A0L8GBV4,Q32KD4,A0A1J1JBJ0,E0W4C3,A0A482XDA9,A0A3P7EJD6,J9K2Z4,A0A2J7Q8V4,T1IBM6,V3ZRX0,A0A210QKF7,A0A423TSS1,K1PT78,A0A267E8R7,A0A1D2N447,A0A226D7A9,F6YK55,T1KTE4,A0A2C9JGZ6,A0A1V9X9F0,K5X5Z7,A0A3Q0KUG5,T1FY40,1YVU,3DLB,5AWH,5G5T,5I4A,6QZK,7R8K,E8N0K8,A0A1I7IXT4,A0A2W1JZ37,A0A2S7WBN3,A0A328VKE4,A0A420DFE6,E0ST67,A0A4V1VDY2,A0A368P5I0,C4L1M1,A0A4R1RMM2,A0A1Y2RDH8,A0A1M5ZSR3,A0A0K8QX04,A0A0M2PXX3,A0A1I3LMA1,K9TPA9,A0A1L3JHM3,A0A1W6MIP2,A0A1C0UUC4,A0A2U2J9E0,A0A2Z6E1D5,A0A0F4NXW8,A0A142XB92,L8D0R3,B1XJG0,A0A326U7G5,A0A3D8L290,H1KXR6,A0A1Q4R485,K9U8J6,A0A097QRL6,K9RC91,A0A0D8ZUC0,A0A139XGN8,Q5P0R2,B6YTQ5,A0A0B0H9B4,A0YYT3,A0A2T1EFY0,G6FTN0,R6KUL9,A0A433NB65,A0A1Z4L0A1,K9UQR0,A0A2T1G8M7,K9VUN0,B7GJX9,A0A0P6X5X2,K9ZDE3,B0JXD6,A0A2T1LS63,A0A1Z4K1Y3,A0A2Z6E0R7,A0A1N6SSK9,A0A0P4UVI8,A0A0V7ZCG4,A0A1J0AGK2,K9PFF9,A0A2G9DT08,K9UEV4,Q9L1X1,A0A060HNJ0,A0A235B542,R5XQK4,A0A1H3LE92,A0A496APJ8,A0A062U2W9,H0HWQ5,A0A1V9G9U4,A0A1I2ZGP1,A0A317EJY3,A0A1I2BD20,F8ERC7,S7VLM7,A0A1A5X8H4,A0A1I2T6Q1,A0A1R3T9N6,H8KXJ0,D3S0S6,A0A2D1U4H7,I3TE64,A0A0B7I4Z6,A0LL61,Q8DKB1,A0A139WY18,A0A1J1EK56,A0A2T1E1K4,A0A1Q8ZD62,A0A4Q6XKV6,A0A1Z3HNN4,A0A239JE83,A0A2N4XBY2,Q53W94,R5JEI2,A0A0Q0ZC47,A0A2T0XH18,A0A1V4CHV0,A0A1K1RQP7,A0A2T1EKT1,A0A1N6LUI7,A0A0P0NGR6,A0A1X7IML5,A0A0A2LKJ7,K1L112,A0A0U3AL92,A0A1H3A054,E0UCX3,K9XZC6,B9LVW4,A0A0C1VHB4,Q31N05,A0A0C5JKF3,R5NJJ8,A5D4D9,Q2JI93,A0A142Y7A9,A0A432MEQ5,A0A372DKU2,A0A3R7KLK4,C1F5Q7,A0A4R3EV39,A0A1P8WP90,A0A222F7P0,A0A1C9VH88,A0A2T2YMB1,A0A329TD61,A0A101R2A0,A0A1E3XF49,A0A1U9ND56,A0A4R7BQC4,A0A1H3DGN3,A0A1Q1FPH0,E0TGY3,F6EYI8,A0A2S9Q9J0,A0A4Q2UIU6,A0A1H0LH25,A0A318LG42,H1YCU5,L0JS08,A0A1Q5ZS75,A0A345E7N0,M0AF24,A0A1W2A082,A0A1H3X247,A0A0C1XUA0,M0D2X3,A0A2R5G167,A0A346PK63,R7RTW6,A0A1H2RBI2,A0A1C3ZXN2,B9LVP8,M5RSF0,W0JW77,B7K585,F8D8G0,A0A343TL88,L0AJX6,A0A2A5QS34,A0A343JEE2,A0A3P3RGE5,A0A329TBQ3,A0A285N2A8,A0A0W1S8B8,A0A1V4C8L7,L9VRQ2,E4NRV1,A0A1I6HGN0,A0A1I0NI68,,",366,37
"1104","C.S11.6","C.S8.6",303,179,124,3.38829068300595,"4F1N,4F3T,4KRE,5GUH,5VM9,6KR6,6OON,7KX7,7SWF,A0A163JTZ6,A0A0N4X8S8,A0A196SDB4,J9D5G4,Q389P5,C4LVV2,A0A2P6N8X7,A8BCK6,A2DPV7,A0A0G4H2S4,T1H8B3,R1FDF0,S4RWI0,D2VMG4,A0A074TLL7,A0A0D1ZAJ4,Q1K660,F4PH46,A0A3M7S814,A0A164ZA52,A0A383WDW5,Q54G64,S7WCF7,I0YVB2,R7QGN7,C1DZY0,A0A2C5Z0M1,A0CB11,R9ACY5,D3BMP8,A0A1Z5TVE5,W7XD45,A0A1U7LLR0,A0A4S2MWZ7,K1VVQ6,A0A158P1R9,G7DVX0,V6R0U9,G4N9J3,E3KLI3,B7Q5I1,A0A1E3QC61,D5GGK8,S8ANP9,A0A139AUH8,L2GMR6,U4LBG4,A0A177URI1,O74957,A0A3N4IGK1,A6N7Y9,A0A0E9NDK5,T1KZ60,A0A250WXN5,A0A2G8JLH3,Q5KAT1,L2GUF2,W2T741,A0A1W0E4B5,A0A2J7QB22,A0A2K3CW87,A0A226EFL3,A0A3S3PD82,A0A0L0TEV1,A0A1S3J512,G0QTT2,A0A1J1HRI1,C4V9J2,Q9JMB7,A0A075AN09,Q5TW24,U5HIG6,A0A401PRI6,Q96J94,A0A2B4RHN2,G2QEV0,A0A397UU01,A0A2T7PFL8,K7ISV0,A0A024FT57,H3HCL6,A0A0G4IME3,E9FUN9,A0A1S3CYL5,D7FQK3,A0A1Y1YHC8,T1GSU4,F4S231,A0A1D8PMK0,A0A2G5B1D8,Q5BD61,A0A1C7M8P2,A0A4D8YSQ3,A0A158PJG6,J9JZ66,A0A0C2XG51,A0A158QZT6,A0A165QYQ9,T0SAU8,R7YY92,A0A3S1A0C3,A0A074YJ47,A0A2K1J482,A0A1Q3ENA6,O04379,A0A371I3C8,A8P0D4,A0A2K3NY65,F4NYW7,A0A0L0HAB7,D8PZT7,A0A1D1W4K0,A7RQ46,W4YU94,A7BJS5,D8SNM6,A0A1J8PPA3,X1WG39,M5FQK2,Q69VD5,A0A2R6NSC2,A0A0D8XL16,A0A016WPN3,Q9QZ81,G5EES3,A0A0K0EFP6,Q8CJG0,A0A1D5NTU6,V2WTL2,A0A0V0YLH8,A0A139WDH0,A0A0R3W9Q7,H3DS31,A0A1Y1HWP2,G4T5G9,B7QCC4,A0A0B2UV00,M7BCJ9,E9GN30,Q7PZ41,A0A077Z361,R7U9I3,A0A1X7V1N5,A0A0K0JDP1,A0A0N4UKJ1,A0A498N3A3,A0A3M0IQP5,A0A0L8GBV4,Q32KD4,A0A1J1JBJ0,E0W4C3,A0A482XDA9,A0A3P7EJD6,J9K2Z4,A0A2J7Q8V4,T1IBM6,V3ZRX0,A0A210QKF7,A0A423TSS1,K1PT78,A0A267E8R7,A0A1D2N447,A0A226D7A9,F6YK55,T1KTE4,A0A2C9JGZ6,A0A1V9X9F0,K5X5Z7,A0A3Q0KUG5,T1FY40,1YVU,1Z26,5G5T,6QZK,7R8K,E8N0K8,A0A328VKE4,E0ST67,C4L1M1,A0A0M2PXX3,A0A1I3LMA1,K9TPA9,A0A0F4NXW8,A0A142XB92,L8D0R3,B1XJG0,A0A326U7G5,H1KXR6,A0A1Q4R485,K9U8J6,A0A097QRL6,K9RC91,A0A0D8ZUC0,A0A139XGN8,A0A1T4Y3A2,Q5P0R2,B6YTQ5,A0A0B0H9B4,A0YYT3,A0A2T1EFY0,G6FTN0,A0A433NB65,A0A1Z4L0A1,K9UQR0,A0A2T1G8M7,K9VUN0,A0A0P6X5X2,K9ZDE3,A0A2T1LS63,A0A1Z4K1Y3,A0A2Z6E0R7,A0A0P4UVI8,A0A0V7ZCG4,A0A1J0AGK2,K9PFF9,A0A2G9DT08,K9UEV4,Q9L1X1,A0A060HNJ0,R5XQK4,A0A1H3LE92,A0A496APJ8,A0A062U2W9,H0HWQ5,A0A1V9G9U4,A0A1I2ZGP1,A0A317EJY3,A0A1I2BD20,F8ERC7,A0A1A5X8H4,A0A0Q2M2Z1,H8KXJ0,D3S0S6,I3TE64,A0A0B7I4Z6,Q8DKB1,A0A139WY18,A0A1J1EK56,A0A2T1E1K4,A0A1Q8ZD62,A0A4Q6XKV6,Q53W94,A0A0Q0ZC47,A0A2T0XH18,A0A1V4CHV0,A0A1K1RQP7,A0A2T1EKT1,A0A0P0NGR6,A0A1X7IML5,A0A0A2LKJ7,K1L112,K9XZC6,A0A0C1VHB4,Q31N05,R5NJJ8,A5D4D9,Q2JI93,A0A3R7KLK4,A0A222F7P0,A0A329TD61,A0A101R2A0,A0A1E3XF49,A0A1H3DGN3,A0A1Q1FPH0,A0A259TUP4,F6EYI8,A0A2S9Q9J0,A0A1H0LH25,A0A318LG42,H1YCU5,A0A1Q5ZS75,A0A345E7N0,M0AF24,A0A1W2A082,A0A1H3X247,A0A0C1XUA0,M0D2X3,A0A346PK63,R7RTW6,A0A1H2RBI2,A0A1C3ZXN2,B9LVP8,W0JW77,A0A343TL88,L0AJX6,A0A343JEE2,A0A3P3RGE5,A0A329TBQ3,A0A0W1S8B8,A0A1V4C8L7,L9VRQ2,E4NRV1,A0A1I6HGN0,A0A1I0NI68,,",366,37
"1105","C.S12.5","C.S16.4",352,179,173,2.25536861820648,"4F1N,4F3T,4KRE,5GUH,5VM9,6KR6,6OON,7KX7,A0A163JTZ6,A0A0N4X8S8,A0A196SDB4,J9D5G4,Q389P5,C4LVV2,A0A2P6N8X7,A8BCK6,A2DPV7,A0A0G4H2S4,R1FDF0,D2VMG4,A0A074TLL7,A0A0D1ZAJ4,Q1K660,F4PH46,A0A3M7S814,A0A164ZA52,A0A383WDW5,Q54G64,S7WCF7,I0YVB2,R7QGN7,C1DZY0,A0A2C5Z0M1,A0CB11,R9ACY5,D3BMP8,A0A1Z5TVE5,W7XD45,A0A1U7LLR0,A0A4S2MWZ7,K1VVQ6,A0A158P1R9,G7DVX0,V6R0U9,G4N9J3,E3KLI3,B7Q5I1,A0A1E3QC61,D5GGK8,S8ANP9,A0A139AUH8,L2GMR6,U4LBG4,A0A177URI1,O74957,A0A3N4IGK1,A6N7Y9,A0A0E9NDK5,A0A250WXN5,A0A2G8JLH3,Q5KAT1,L2GUF2,W2T741,A0A1W0E4B5,A0A2J7QB22,S4RYE2,A0A2K3CW87,A0A388KES6,A0A226EFL3,A0A3S3PD82,A0A0L0TEV1,A0A1S3J512,G0QTT2,A0A1J1HRI1,C4V9J2,Q9JMB7,A0A075AN09,Q5TW24,U5HIG6,A0A401PRI6,Q96J94,A0A2B4RHN2,G2QEV0,A0A397UU01,A0A2T7PFL8,K7ISV0,A0A024FT57,H3HCL6,A0A0G4IME3,E9FUN9,A0A1S3CYL5,D7FQK3,A0A1Y1YHC8,T1GSU4,F4S231,A0A1D8PMK0,A0A2G5B1D8,Q5BD61,A0A1C7M8P2,A0A4D8YSQ3,A0A158PJG6,J9JZ66,A0A0C2XG51,A0A158QZT6,A0A165QYQ9,T0SAU8,R7YY92,A0A3S1A0C3,A0A074YJ47,A0A2K1J482,A0A1Q3ENA6,O04379,A0A371I3C8,M8AEW7,A8P0D4,A0A2K3NY65,F4NYW7,A0A409Y6G2,A0A0L0HAB7,D8PZT7,A0A1D1W4K0,A7RQ46,W4YU94,A7BJS5,D8SNM6,A0A1J8PPA3,X1WG39,M5FQK2,Q69VD5,A0A2R6NSC2,A0A0D8XL16,A0A016WPN3,Q9QZ81,G5EES3,A0A0K0EFP6,Q8CJG0,A0A1D5NTU6,V2WTL2,A0A0V0YLH8,A0A139WDH0,A0A0R3W9Q7,H3DS31,A0A1Y1HWP2,G4T5G9,B7QCC4,A0A0B2UV00,M7BCJ9,E9GN30,Q7PZ41,A0A077Z361,R7U9I3,A0A1X7V1N5,A0A0K0JDP1,A0A0N4UKJ1,A0A498N3A3,A0A3M0IQP5,A0A0L8GBV4,Q32KD4,A0A1J1JBJ0,E0W4C3,A0A482XDA9,A0A3P7EJD6,J9K2Z4,A0A2J7Q8V4,T1IBM6,V3ZRX0,A0A210QKF7,A0A423TSS1,K1PT78,A0A267E8R7,A0A1D2N447,A0A226D7A9,F6YK55,T1KTE4,A0A2C9JGZ6,A0A1V9X9F0,K5X5Z7,A0A3Q0KUG5,T1FY40,1YVU,3DLB,5AWH,5G5T,5I4A,6QZK,7R8K,A0A1I7IXT4,A0A2W1JZ37,A0A2S7WBN3,A0A328VKE4,A0A420DFE6,E0ST67,A0A4V1VDY2,A0A368P5I0,C4L1M1,A0A4R1RMM2,A0A1Y2RDH8,A0A1M5ZSR3,A0A0K8QX04,A0A0M2PXX3,K9TPA9,A0A1L3JHM3,A0A1W6MIP2,A0A1C0UUC4,A0A2U2J9E0,A0A2Z6E1D5,A0A0F4NXW8,A0A142XB92,L8D0R3,B1XJG0,A0A326U7G5,A0A3D8L290,A0A1Q4R485,K9U8J6,K9RC91,A0A0D8ZUC0,A0A139XGN8,A0A1T4Y3A2,Q5P0R2,A0A0B0H9B4,A0YYT3,A0A2T1EFY0,G6FTN0,R6KUL9,A0A433NB65,A0A1Z4L0A1,K9UQR0,A0A2T1G8M7,K9VUN0,B7GJX9,A0A0P6X5X2,K9ZDE3,B0JXD6,A0A2T1LS63,A0A1Z4K1Y3,A0A2Z6E0R7,A0A1N6SSK9,A0A0P4UVI8,A0A0V7ZCG4,A0A1J0AGK2,K9PFF9,A0A2G9DT08,K9UEV4,Q9L1X1,A0A060HNJ0,A0A235B542,R5XQK4,A0A1H3LE92,A0A496APJ8,A0A062U2W9,H0HWQ5,A0A1V9G9U4,A0A1I2ZGP1,A0A317EJY3,A0A1I2BD20,F8ERC7,S7VLM7,A0A1A5X8H4,A0A1I2T6Q1,A0A1R3T9N6,A0A0Q2M2Z1,H8KXJ0,A0A2D1U4H7,A0A0B7I4Z6,A0LL61,Q8DKB1,A0A139WY18,A0A1J1EK56,A0A2T1E1K4,A0A1Q8ZD62,A0A4Q6XKV6,A0A1Z3HNN4,A0A239JE83,A0A2N4XBY2,Q53W94,R5JEI2,A0A0Q0ZC47,A0A2T0XH18,A0A1V4CHV0,A0A1K1RQP7,A0A2T1EKT1,A0A1N6LUI7,A0A0P0NGR6,A0A1X7IML5,A0A0A2LKJ7,K1L112,A0A0U3AL92,A0A1H3A054,E0UCX3,K9XZC6,A0A0C1VHB4,Q31N05,A0A0C5JKF3,R5NJJ8,A5D4D9,Q2JI93,A0A142Y7A9,A0A432MEQ5,A0A372DKU2,A0A3R7KLK4,C1F5Q7,A0A4R3EV39,A0A1P8WP90,A0A222F7P0,A0A1C9VH88,A0A2T2YMB1,A0A329TD61,A0A101R2A0,A0A1E3XF49,A0A1U9ND56,A0A4R7BQC4,A0A1H3DGN3,A0A1Q1FPH0,E0TGY3,A0A259TUP4,F6EYI8,A0A2S9Q9J0,A0A4Q2UIU6,A0A1H0LH25,A0A318LG42,H1YCU5,L0JS08,A0A1Q5ZS75,A0A345E7N0,M0AF24,A0A1W2A082,A0A1H3X247,A0A0C1XUA0,M0D2X3,A0A2R5G167,A0A346PK63,R7RTW6,A0A1H2RBI2,A0A1C3ZXN2,B9LVP8,M5RSF0,W0JW77,B7K585,F8D8G0,A0A343TL88,L0AJX6,A0A2A5QS34,A0A343JEE2,A0A3P3RGE5,A0A329TBQ3,A0A285N2A8,A0A0W1S8B8,A0A1V4C8L7,L9VRQ2,E4NRV1,A0A1I6HGN0,A0A1I0NI68,,",366,37
"1108","C.S3.2","C.S5.3",349,179,170,1.58241866579034,"4F1N,4F3T,4KRE,5GUH,5VM9,6KR6,6OON,7KX7,7SWF,A0A163JTZ6,A0A0N4X8S8,A0A196SDB4,J9D5G4,Q389P5,C4LVV2,A8BCK6,A0A0G4H2S4,T1H8B3,S4RWI0,D2VMG4,A0A074TLL7,A0A0D1ZAJ4,Q1K660,F4PH46,A0A3M7S814,A0A164ZA52,A0A383WDW5,Q54G64,S7WCF7,I0YVB2,R7QGN7,C1DZY0,A0A2C5Z0M1,A0CB11,R9ACY5,D3BMP8,A0A1Z5TVE5,W7XD45,A0A1U7LLR0,A0A4S2MWZ7,K1VVQ6,A0A158P1R9,G7DVX0,V6R0U9,G4N9J3,E3KLI3,B7Q5I1,A0A1E3QC61,D5GGK8,S8ANP9,A0A139AUH8,L2GMR6,U4LBG4,A0A177URI1,O74957,A0A3N4IGK1,A6N7Y9,A0A0E9NDK5,T1KZ60,A0A250WXN5,A0A2G8JLH3,Q5KAT1,L2GUF2,W2T741,A0A1W0E4B5,A0A2J7QB22,S4RYE2,A0A2K3CW87,A0A388KES6,A0A226EFL3,A0A3S3PD82,A0A0L0TEV1,A0A1S3J512,G0QTT2,A0A1J1HRI1,C4V9J2,Q9JMB7,A0A075AN09,Q5TW24,U5HIG6,A0A401PRI6,Q96J94,A0A2B4RHN2,G2QEV0,A0A397UU01,A0A2T7PFL8,K7ISV0,A0A024FT57,H3HCL6,A0A0G4IME3,E9FUN9,A0A1S3CYL5,D7FQK3,A0A1Y1YHC8,F4S231,A0A1D8PMK0,A0A2G5B1D8,Q5BD61,A0A1C7M8P2,A0A4D8YSQ3,A0A158PJG6,J9JZ66,A0A0C2XG51,A0A158QZT6,A0A165QYQ9,T0SAU8,R7YY92,A0A3S1A0C3,A0A074YJ47,A0A2K1J482,A0A1Q3ENA6,O04379,A0A371I3C8,M8AEW7,A8P0D4,A0A2K3NY65,F4NYW7,A0A409Y6G2,A0A0L0HAB7,D8PZT7,A0A1D1W4K0,A7RQ46,W4YU94,A7BJS5,D8SNM6,A0A1J8PPA3,X1WG39,M5FQK2,Q69VD5,A0A2R6NSC2,A0A0D8XL16,A0A016WPN3,Q9QZ81,G5EES3,A0A0K0EFP6,Q8CJG0,A0A1D5NTU6,V2WTL2,A0A0V0YLH8,A0A139WDH0,A0A0R3W9Q7,H3DS31,A0A1Y1HWP2,G4T5G9,B7QCC4,A0A0B2UV00,M7BCJ9,E9GN30,Q7PZ41,A0A077Z361,R7U9I3,A0A1X7V1N5,A0A0K0JDP1,A0A0N4UKJ1,A0A498N3A3,A0A3M0IQP5,A0A0L8GBV4,Q32KD4,A0A1J1JBJ0,E0W4C3,A0A482XDA9,A0A3P7EJD6,J9K2Z4,A0A2J7Q8V4,T1IBM6,V3ZRX0,A0A210QKF7,A0A423TSS1,K1PT78,A0A267E8R7,A0A1D2N447,A0A226D7A9,F6YK55,T1KTE4,A0A2C9JGZ6,A0A1V9X9F0,K5X5Z7,A0A3Q0KUG5,T1FY40,1YVU,1Z26,3DLB,5AWH,5G5T,5I4A,6QZK,7R8K,E8N0K8,A0A1I7IXT4,A0A2W1JZ37,A0A2S7WBN3,A0A328VKE4,A0A420DFE6,E0ST67,A0A4V1VDY2,A0A368P5I0,C4L1M1,A0A4R1RMM2,A0A1Y2RDH8,A0A1M5ZSR3,A0A0K8QX04,A0A0M2PXX3,A0A1I3LMA1,K9TPA9,A0A1L3JHM3,A0A1W6MIP2,A0A1C0UUC4,A0A2U2J9E0,B1XJG0,A0A326U7G5,A0A1Q4R485,K9U8J6,K9RC91,A0A0D8ZUC0,A0A139XGN8,A0A1T4Y3A2,A0A0B0H9B4,A0YYT3,A0A2T1EFY0,G6FTN0,R6KUL9,A0A433NB65,A0A1Z4L0A1,K9UQR0,A0A2T1G8M7,K9VUN0,B7GJX9,A0A0P6X5X2,K9ZDE3,B0JXD6,A0A2T1LS63,A0A1Z4K1Y3,A0A1N6SSK9,A0A0P4UVI8,A0A0V7ZCG4,A0A1J0AGK2,K9PFF9,A0A2G9DT08,K9UEV4,Q9L1X1,A0A060HNJ0,A0A235B542,R5XQK4,A0A1H3LE92,A0A496APJ8,A0A062U2W9,H0HWQ5,A0A1V9G9U4,A0A1I2ZGP1,A0A317EJY3,A0A1I2BD20,F8ERC7,S7VLM7,A0A1A5X8H4,A0A1I2T6Q1,A0A1R3T9N6,A0A0Q2M2Z1,H8KXJ0,D3S0S6,A0A2D1U4H7,I3TE64,A0A0B7I4Z6,A0LL61,Q8DKB1,A0A139WY18,A0A1J1EK56,A0A2T1E1K4,A0A1Q8ZD62,A0A4Q6XKV6,A0A1Z3HNN4,A0A239JE83,A0A2N4XBY2,Q53W94,R5JEI2,A0A0Q0ZC47,A0A2T0XH18,A0A1V4CHV0,A0A1K1RQP7,A0A2T1EKT1,A0A1N6LUI7,A0A0P0NGR6,A0A1X7IML5,A0A0A2LKJ7,K1L112,A0A0U3AL92,A0A1H3A054,E0UCX3,K9XZC6,B9LVW4,A0A0C1VHB4,Q31N05,A0A0C5JKF3,R5NJJ8,A5D4D9,Q2JI93,A0A142Y7A9,A0A432MEQ5,A0A372DKU2,A0A3R7KLK4,C1F5Q7,A0A4R3EV39,A0A1P8WP90,A0A222F7P0,A0A1C9VH88,A0A2T2YMB1,A0A101R2A0,A0A1E3XF49,A0A1U9ND56,A0A4R7BQC4,A0A1H3DGN3,A0A1Q1FPH0,E0TGY3,A0A259TUP4,F6EYI8,A0A2S9Q9J0,A0A4Q2UIU6,A0A1H0LH25,A0A318LG42,H1YCU5,L0JS08,A0A1Q5ZS75,M0AF24,A0A1W2A082,A0A1H3X247,A0A0C1XUA0,M0D2X3,A0A2R5G167,A0A346PK63,R7RTW6,A0A1H2RBI2,A0A1C3ZXN2,B9LVP8,M5RSF0,W0JW77,B7K585,F8D8G0,A0A343TL88,L0AJX6,A0A2A5QS34,A0A343JEE2,A0A3P3RGE5,A0A329TBQ3,A0A285N2A8,A0A0W1S8B8,A0A1V4C8L7,L9VRQ2,E4NRV1,A0A1I6HGN0,A0A1I0NI68,,",366,37
"1109","C.S3.3","C.S5.3",337,179,158,2.43904250053037,"4F1N,4F3T,4KRE,5GUH,5VM9,6KR6,6OON,7KX7,7SWF,A0A163JTZ6,A0A0N4X8S8,A0A196SDB4,J9D5G4,Q389P5,C4LVV2,A8BCK6,A2DPV7,T1H8B3,S4RWI0,D2VMG4,A0A074TLL7,A0A0D1ZAJ4,Q1K660,F4PH46,A0A3M7S814,A0A164ZA52,A0A383WDW5,Q54G64,S7WCF7,I0YVB2,R7QGN7,C1DZY0,A0A2C5Z0M1,A0CB11,R9ACY5,D3BMP8,A0A1Z5TVE5,W7XD45,A0A1U7LLR0,A0A4S2MWZ7,K1VVQ6,A0A158P1R9,G7DVX0,V6R0U9,G4N9J3,E3KLI3,B7Q5I1,A0A1E3QC61,D5GGK8,S8ANP9,A0A139AUH8,L2GMR6,U4LBG4,A0A177URI1,O74957,A0A3N4IGK1,A6N7Y9,A0A0E9NDK5,T1KZ60,A0A250WXN5,A0A2G8JLH3,Q5KAT1,L2GUF2,W2T741,A0A1W0E4B5,A0A2J7QB22,S4RYE2,A0A2K3CW87,A0A388KES6,A0A226EFL3,A0A3S3PD82,A0A0L0TEV1,A0A1S3J512,G0QTT2,A0A1J1HRI1,C4V9J2,Q9JMB7,A0A075AN09,Q5TW24,U5HIG6,A0A401PRI6,Q96J94,A0A2B4RHN2,G2QEV0,A0A397UU01,A0A2T7PFL8,K7ISV0,A0A024FT57,H3HCL6,A0A0G4IME3,E9FUN9,A0A1S3CYL5,D7FQK3,A0A1Y1YHC8,F4S231,A0A1D8PMK0,A0A2G5B1D8,Q5BD61,A0A1C7M8P2,A0A4D8YSQ3,A0A158PJG6,J9JZ66,A0A0C2XG51,A0A158QZT6,A0A165QYQ9,T0SAU8,R7YY92,A0A3S1A0C3,A0A074YJ47,A0A2K1J482,A0A1Q3ENA6,O04379,A0A371I3C8,M8AEW7,A8P0D4,A0A2K3NY65,F4NYW7,A0A409Y6G2,A0A0L0HAB7,D8PZT7,A0A1D1W4K0,A7RQ46,W4YU94,A7BJS5,D8SNM6,A0A1J8PPA3,X1WG39,M5FQK2,Q69VD5,A0A2R6NSC2,A0A0D8XL16,A0A016WPN3,Q9QZ81,G5EES3,A0A0K0EFP6,Q8CJG0,A0A1D5NTU6,V2WTL2,A0A0V0YLH8,A0A139WDH0,A0A0R3W9Q7,H3DS31,A0A1Y1HWP2,G4T5G9,B7QCC4,A0A0B2UV00,M7BCJ9,E9GN30,Q7PZ41,A0A077Z361,R7U9I3,A0A1X7V1N5,A0A0K0JDP1,A0A0N4UKJ1,A0A498N3A3,A0A3M0IQP5,A0A0L8GBV4,Q32KD4,A0A1J1JBJ0,E0W4C3,A0A482XDA9,A0A3P7EJD6,J9K2Z4,A0A2J7Q8V4,T1IBM6,V3ZRX0,A0A210QKF7,A0A423TSS1,K1PT78,A0A267E8R7,A0A1D2N447,A0A226D7A9,F6YK55,T1KTE4,A0A2C9JGZ6,A0A1V9X9F0,K5X5Z7,A0A3Q0KUG5,T1FY40,1YVU,1Z26,3DLB,5AWH,5G5T,5I4A,6QZK,7R8K,E8N0K8,A0A328VKE4,E0ST67,C4L1M1,A0A0M2PXX3,A0A1I3LMA1,K9TPA9,A0A1C0UUC4,B1XJG0,A0A326U7G5,A0A3D8L290,A0A1Q4R485,K9U8J6,A0A097QRL6,K9RC91,A0A0D8ZUC0,A0A139XGN8,A0A1T4Y3A2,A0A0B0H9B4,A0YYT3,A0A2T1EFY0,G6FTN0,R6KUL9,A0A433NB65,A0A1Z4L0A1,K9UQR0,A0A2T1G8M7,K9VUN0,B7GJX9,A0A0P6X5X2,K9ZDE3,B0JXD6,A0A2T1LS63,A0A1Z4K1Y3,A0A1N6SSK9,A0A0P4UVI8,A0A0V7ZCG4,A0A1J0AGK2,K9PFF9,A0A2G9DT08,K9UEV4,Q9L1X1,A0A060HNJ0,A0A235B542,R5XQK4,A0A1H3LE92,A0A496APJ8,A0A062U2W9,H0HWQ5,A0A1V9G9U4,A0A1I2ZGP1,A0A317EJY3,A0A1I2BD20,F8ERC7,S7VLM7,A0A1A5X8H4,A0A1I2T6Q1,A0A1R3T9N6,A0A0Q2M2Z1,H8KXJ0,A0A2D1U4H7,I3TE64,A0A0B7I4Z6,A0LL61,Q8DKB1,A0A139WY18,A0A1J1EK56,A0A2T1E1K4,A0A1Q8ZD62,A0A4Q6XKV6,A0A1Z3HNN4,A0A239JE83,A0A2N4XBY2,Q53W94,R5JEI2,A0A0Q0ZC47,A0A2T0XH18,A0A1V4CHV0,A0A1K1RQP7,A0A2T1EKT1,A0A1N6LUI7,A0A0P0NGR6,A0A1X7IML5,A0A0A2LKJ7,K1L112,A0A0U3AL92,A0A1H3A054,E0UCX3,K9XZC6,B9LVW4,A0A0C1VHB4,Q31N05,A0A0C5JKF3,R5NJJ8,A5D4D9,Q2JI93,A0A142Y7A9,A0A432MEQ5,A0A372DKU2,A0A3R7KLK4,C1F5Q7,A0A4R3EV39,A0A1P8WP90,A0A222F7P0,A0A1C9VH88,A0A2T2YMB1,A0A101R2A0,A0A1E3XF49,A0A1U9ND56,A0A4R7BQC4,A0A1H3DGN3,A0A1Q1FPH0,E0TGY3,A0A259TUP4,F6EYI8,A0A2S9Q9J0,A0A4Q2UIU6,A0A1H0LH25,A0A318LG42,H1YCU5,L0JS08,A0A1Q5ZS75,M0AF24,A0A1W2A082,A0A1H3X247,A0A0C1XUA0,M0D2X3,A0A2R5G167,A0A346PK63,R7RTW6,A0A1H2RBI2,A0A1C3ZXN2,B9LVP8,M5RSF0,W0JW77,B7K585,F8D8G0,A0A343TL88,L0AJX6,A0A2A5QS34,A0A343JEE2,A0A3P3RGE5,A0A329TBQ3,A0A285N2A8,A0A0W1S8B8,A0A1V4C8L7,L9VRQ2,E4NRV1,A0A1I6HGN0,A0A1I0NI68,,",366,37
"1111","C.S5.4","C.S6.5",350,179,171,1.99010095070077,"4F1N,4F3T,4KRE,5GUH,5VM9,6KR6,6OON,7KX7,7SWF,A0A163JTZ6,A0A0N4X8S8,A0A196SDB4,J9D5G4,Q389P5,C4LVV2,A0A2P6N8X7,A8BCK6,A2DPV7,T1H8B3,S4RWI0,D2VMG4,A0A074TLL7,A0A0D1ZAJ4,Q1K660,F4PH46,A0A3M7S814,A0A164ZA52,A0A383WDW5,Q54G64,S7WCF7,I0YVB2,R7QGN7,C1DZY0,A0A2C5Z0M1,A0CB11,R9ACY5,D3BMP8,A0A1Z5TVE5,W7XD45,A0A1U7LLR0,A0A4S2MWZ7,K1VVQ6,A0A158P1R9,G7DVX0,V6R0U9,G4N9J3,E3KLI3,B7Q5I1,A0A1E3QC61,D5GGK8,S8ANP9,A0A139AUH8,L2GMR6,U4LBG4,A0A177URI1,O74957,A0A3N4IGK1,A6N7Y9,A0A0E9NDK5,T1KZ60,A0A250WXN5,A0A2G8JLH3,Q5KAT1,L2GUF2,W2T741,A0A1W0E4B5,A0A2J7QB22,S4RYE2,A0A2K3CW87,A0A388KES6,A0A226EFL3,A0A3S3PD82,A0A0L0TEV1,A0A1S3J512,G0QTT2,A0A1J1HRI1,C4V9J2,Q9JMB7,A0A075AN09,Q5TW24,U5HIG6,A0A401PRI6,Q96J94,A0A2B4RHN2,G2QEV0,A0A397UU01,A0A2T7PFL8,K7ISV0,A0A024FT57,H3HCL6,A0A0G4IME3,A0A1S3CYL5,D7FQK3,A0A1Y1YHC8,F4S231,A0A1D8PMK0,A0A2G5B1D8,Q5BD61,A0A1C7M8P2,A0A4D8YSQ3,A0A158PJG6,J9JZ66,A0A0C2XG51,A0A158QZT6,A0A165QYQ9,T0SAU8,R7YY92,A0A3S1A0C3,A0A074YJ47,A0A2K1J482,A0A1Q3ENA6,O04379,A0A371I3C8,M8AEW7,A8P0D4,A0A2K3NY65,F4NYW7,A0A409Y6G2,A0A0L0HAB7,D8PZT7,A0A1D1W4K0,A7RQ46,W4YU94,A7BJS5,D8SNM6,A0A1J8PPA3,X1WG39,M5FQK2,Q69VD5,A0A2R6NSC2,A0A0D8XL16,A0A016WPN3,Q9QZ81,G5EES3,A0A0K0EFP6,Q8CJG0,A0A1D5NTU6,V2WTL2,A0A0V0YLH8,A0A139WDH0,A0A0R3W9Q7,H3DS31,A0A1Y1HWP2,G4T5G9,B7QCC4,A0A0B2UV00,M7BCJ9,E9GN30,Q7PZ41,A0A077Z361,R7U9I3,A0A1X7V1N5,A0A0K0JDP1,A0A0N4UKJ1,A0A498N3A3,A0A3M0IQP5,A0A0L8GBV4,Q32KD4,A0A1J1JBJ0,E0W4C3,A0A482XDA9,A0A3P7EJD6,J9K2Z4,A0A2J7Q8V4,T1IBM6,V3ZRX0,A0A210QKF7,A0A423TSS1,K1PT78,A0A267E8R7,A0A1D2N447,A0A226D7A9,F6YK55,T1KTE4,A0A2C9JGZ6,A0A1V9X9F0,K5X5Z7,A0A3Q0KUG5,T1FY40,1YVU,1Z26,3DLB,5AWH,5G5T,5I4A,6QZK,7R8K,E8N0K8,A0A1I7IXT4,A0A2W1JZ37,A0A328VKE4,E0ST67,C4L1M1,Q11QW7,A0A0M2PXX3,A0A1I3LMA1,K9TPA9,A0A1W6MIP2,A0A1C0UUC4,A0A2Z6E1D5,A0A0F4NXW8,A0A142XB92,L8D0R3,B1XJG0,A0A326U7G5,A0A3D8L290,H1KXR6,A0A1Q4R485,K9U8J6,A0A097QRL6,K9RC91,A0A0D8ZUC0,A0A139XGN8,A0A1T4Y3A2,Q5P0R2,B6YTQ5,A0A0B0H9B4,A0YYT3,A0A2T1EFY0,G6FTN0,R6KUL9,A0A433NB65,A0A1Z4L0A1,K9UQR0,A0A2T1G8M7,K9VUN0,B7GJX9,A0A0P6X5X2,K9ZDE3,B0JXD6,A0A2T1LS63,A0A1Z4K1Y3,A0A2Z6E0R7,A0A1N6SSK9,A0A0P4UVI8,A0A0V7ZCG4,A0A1J0AGK2,K9PFF9,A0A2G9DT08,K9UEV4,Q9L1X1,A0A060HNJ0,A0A235B542,R5XQK4,A0A1H3LE92,A0A496APJ8,A0A062U2W9,H0HWQ5,A0A1V9G9U4,A0A1I2ZGP1,A0A317EJY3,A0A1I2BD20,F8ERC7,S7VLM7,A0A1A5X8H4,A0A1I2T6Q1,A0A1R3T9N6,A0A0Q2M2Z1,H8KXJ0,D3S0S6,A0A2D1U4H7,I3TE64,A0A0B7I4Z6,A0LL61,Q8DKB1,A0A139WY18,A0A1J1EK56,A0A2T1E1K4,A0A1Q8ZD62,A0A4Q6XKV6,A0A1Z3HNN4,A0A239JE83,A0A2N4XBY2,Q53W94,R5JEI2,A0A0Q0ZC47,A0A2T0XH18,A0A1V4CHV0,A0A1K1RQP7,A0A2T1EKT1,A0A1N6LUI7,A0A0P0NGR6,A0A1X7IML5,A0A0A2LKJ7,K1L112,A0A0U3AL92,A0A1H3A054,E0UCX3,K9XZC6,A0A0C1VHB4,Q31N05,A0A0C5JKF3,R5NJJ8,A5D4D9,Q2JI93,A0A142Y7A9,A0A432MEQ5,A0A372DKU2,A0A3R7KLK4,C1F5Q7,A0A4R3EV39,A0A1P8WP90,A0A222F7P0,A0A1C9VH88,A0A2T2YMB1,A0A329TD61,A0A101R2A0,A0A1E3XF49,A0A1U9ND56,A0A4R7BQC4,A0A1H3DGN3,A0A1Q1FPH0,E0TGY3,A0A259TUP4,F6EYI8,A0A2S9Q9J0,A0A4Q2UIU6,A0A1H0LH25,A0A318LG42,H1YCU5,L0JS08,A0A1Q5ZS75,A0A345E7N0,M0AF24,A0A1W2A082,A0A1H3X247,A0A0C1XUA0,M0D2X3,A0A2R5G167,A0A346PK63,R7RTW6,A0A1H2RBI2,A0A1C3ZXN2,B9LVP8,M5RSF0,W0JW77,B7K585,F8D8G0,A0A343TL88,L0AJX6,A0A2A5QS34,A0A343JEE2,A0A3P3RGE5,A0A329TBQ3,A0A0W1S8B8,A0A1V4C8L7,L9VRQ2,E4NRV1,A0A1I6HGN0,A0A1I0NI68,,",366,37
"1112","C.S5.5","C.S6.5",358,179,179,2.55027932960894,"4F1N,4F3T,4KRE,5GUH,5VM9,6KR6,6OON,7KX7,7SWF,A0A163JTZ6,A0A0N4X8S8,A0A196SDB4,J9D5G4,Q389P5,C4LVV2,A0A2P6N8X7,A8BCK6,A2DPV7,A0A0G4H2S4,T1H8B3,S4RWI0,D2VMG4,A0A074TLL7,A0A0D1ZAJ4,Q1K660,F4PH46,A0A3M7S814,A0A164ZA52,A0A383WDW5,Q54G64,S7WCF7,R7QGN7,C1DZY0,A0A2C5Z0M1,A0CB11,R9ACY5,D3BMP8,A0A1Z5TVE5,W7XD45,A0A1U7LLR0,A0A4S2MWZ7,K1VVQ6,A0A158P1R9,G7DVX0,V6R0U9,G4N9J3,E3KLI3,B7Q5I1,A0A1E3QC61,D5GGK8,S8ANP9,A0A139AUH8,L2GMR6,U4LBG4,A0A177URI1,O74957,A0A3N4IGK1,A6N7Y9,A0A0E9NDK5,T1KZ60,A0A250WXN5,A0A2G8JLH3,Q5KAT1,L2GUF2,W2T741,A0A1W0E4B5,A0A2J7QB22,S4RYE2,A0A2K3CW87,A0A388KES6,A0A226EFL3,A0A3S3PD82,A0A0L0TEV1,A0A1S3J512,G0QTT2,A0A1J1HRI1,C4V9J2,Q9JMB7,A0A075AN09,Q5TW24,U5HIG6,A0A401PRI6,Q96J94,A0A2B4RHN2,G2QEV0,A0A397UU01,A0A2T7PFL8,K7ISV0,A0A024FT57,H3HCL6,A0A0G4IME3,A0A1S3CYL5,D7FQK3,A0A1Y1YHC8,F4S231,A0A1D8PMK0,A0A2G5B1D8,Q5BD61,A0A1C7M8P2,A0A4D8YSQ3,A0A158PJG6,J9JZ66,A0A0C2XG51,A0A158QZT6,A0A165QYQ9,T0SAU8,R7YY92,A0A3S1A0C3,A0A074YJ47,A0A2K1J482,A0A1Q3ENA6,O04379,A0A371I3C8,M8AEW7,A8P0D4,A0A2K3NY65,F4NYW7,A0A409Y6G2,A0A0L0HAB7,D8PZT7,A0A1D1W4K0,A7RQ46,W4YU94,A7BJS5,D8SNM6,A0A1J8PPA3,X1WG39,M5FQK2,Q69VD5,A0A2R6NSC2,A0A0D8XL16,A0A016WPN3,Q9QZ81,G5EES3,A0A0K0EFP6,Q8CJG0,A0A1D5NTU6,V2WTL2,A0A0V0YLH8,A0A139WDH0,A0A0R3W9Q7,H3DS31,A0A1Y1HWP2,G4T5G9,B7QCC4,A0A0B2UV00,M7BCJ9,E9GN30,Q7PZ41,A0A077Z361,R7U9I3,A0A1X7V1N5,A0A0K0JDP1,A0A0N4UKJ1,A0A498N3A3,A0A3M0IQP5,A0A0L8GBV4,Q32KD4,A0A1J1JBJ0,E0W4C3,A0A482XDA9,A0A3P7EJD6,J9K2Z4,A0A2J7Q8V4,T1IBM6,V3ZRX0,A0A210QKF7,A0A423TSS1,K1PT78,A0A267E8R7,A0A1D2N447,A0A226D7A9,F6YK55,T1KTE4,A0A2C9JGZ6,A0A1V9X9F0,K5X5Z7,A0A3Q0KUG5,T1FY40,1YVU,1Z26,3DLB,5AWH,5G5T,5I4A,6QZK,7R8K,E8N0K8,A0A1I7IXT4,A0A2W1JZ37,A0A2S7WBN3,A0A328VKE4,A0A420DFE6,E0ST67,A0A4V1VDY2,A0A368P5I0,C4L1M1,A0A4R1RMM2,A0A1Y2RDH8,Q11QW7,A0A1M5ZSR3,A0A0K8QX04,A0A0M2PXX3,A0A1I3LMA1,K9TPA9,A0A1L3JHM3,A0A1W6MIP2,A0A1C0UUC4,A0A2U2J9E0,A0A2Z6E1D5,A0A0F4NXW8,A0A142XB92,L8D0R3,B1XJG0,A0A326U7G5,A0A3D8L290,H1KXR6,A0A1Q4R485,K9U8J6,K9RC91,A0A0D8ZUC0,A0A139XGN8,A0A1T4Y3A2,Q5P0R2,A0A0B0H9B4,A0YYT3,A0A2T1EFY0,G6FTN0,R6KUL9,A0A433NB65,A0A1Z4L0A1,K9UQR0,A0A2T1G8M7,K9VUN0,B7GJX9,A0A0P6X5X2,K9ZDE3,B0JXD6,A0A2T1LS63,A0A1Z4K1Y3,A0A2Z6E0R7,A0A1N6SSK9,A0A0P4UVI8,A0A0V7ZCG4,A0A1J0AGK2,K9PFF9,A0A2G9DT08,K9UEV4,Q9L1X1,A0A060HNJ0,A0A235B542,R5XQK4,A0A1H3LE92,A0A496APJ8,A0A062U2W9,H0HWQ5,A0A1V9G9U4,A0A1I2ZGP1,A0A317EJY3,A0A1I2BD20,F8ERC7,S7VLM7,A0A1A5X8H4,A0A1I2T6Q1,A0A1R3T9N6,A0A0Q2M2Z1,H8KXJ0,D3S0S6,A0A2D1U4H7,I3TE64,A0A0B7I4Z6,A0LL61,Q8DKB1,A0A139WY18,A0A1J1EK56,A0A2T1E1K4,A0A1Q8ZD62,A0A4Q6XKV6,A0A1Z3HNN4,A0A239JE83,A0A2N4XBY2,Q53W94,R5JEI2,A0A0Q0ZC47,A0A2T0XH18,A0A1V4CHV0,A0A1K1RQP7,A0A2T1EKT1,A0A1N6LUI7,A0A0P0NGR6,A0A1X7IML5,A0A0A2LKJ7,K1L112,A0A0U3AL92,A0A1H3A054,E0UCX3,K9XZC6,A0A0C1VHB4,Q31N05,A0A0C5JKF3,R5NJJ8,A5D4D9,Q2JI93,A0A142Y7A9,A0A432MEQ5,A0A372DKU2,A0A3R7KLK4,C1F5Q7,A0A4R3EV39,A0A1P8WP90,A0A222F7P0,A0A1C9VH88,A0A2T2YMB1,A0A329TD61,A0A101R2A0,A0A1E3XF49,A0A1U9ND56,A0A4R7BQC4,A0A1H3DGN3,A0A1Q1FPH0,E0TGY3,A0A259TUP4,F6EYI8,A0A2S9Q9J0,A0A4Q2UIU6,A0A1H0LH25,A0A318LG42,H1YCU5,L0JS08,A0A1Q5ZS75,A0A345E7N0,M0AF24,A0A1W2A082,A0A1H3X247,A0A0C1XUA0,M0D2X3,A0A2R5G167,A0A346PK63,R7RTW6,A0A1H2RBI2,A0A1C3ZXN2,B9LVP8,M5RSF0,W0JW77,B7K585,F8D8G0,A0A343TL88,L0AJX6,A0A2A5QS34,A0A343JEE2,A0A3P3RGE5,A0A329TBQ3,A0A0W1S8B8,A0A1V4C8L7,L9VRQ2,E4NRV1,A0A1I6HGN0,A0A1I0NI68,,",366,37
"1113","C.S8.7","C.S9.3",235,179,56,1.96094373503591,"4F1N,4F3T,4KRE,5GUH,5VM9,6KR6,6OON,7KX7,A0A163JTZ6,A0A0N4X8S8,A0A196SDB4,J9D5G4,C4LVV2,A8BCK6,A2DPV7,A0A0G4H2S4,T1H8B3,R1FDF0,S4RWI0,D2VMG4,A0A074TLL7,A0A0D1ZAJ4,Q1K660,F4PH46,A0A3M7S814,A0A164ZA52,A0A383WDW5,Q54G64,S7WCF7,I0YVB2,R7QGN7,C1DZY0,A0A2C5Z0M1,A0CB11,R9ACY5,D3BMP8,A0A1Z5TVE5,W7XD45,A0A1U7LLR0,A0A4S2MWZ7,K1VVQ6,A0A158P1R9,G7DVX0,V6R0U9,G4N9J3,E3KLI3,B7Q5I1,A0A1E3QC61,D5GGK8,S8ANP9,L2GMR6,U4LBG4,A0A177URI1,O74957,A0A3N4IGK1,A6N7Y9,A0A0E9NDK5,T1KZ60,A0A250WXN5,A0A2G8JLH3,Q5KAT1,L2GUF2,W2T741,A0A1W0E4B5,A0A2J7QB22,S4RYE2,A0A2K3CW87,A0A388KES6,A0A226EFL3,A0A3S3PD82,A0A0L0TEV1,A0A1S3J512,G0QTT2,A0A1J1HRI1,C4V9J2,Q9JMB7,A0A075AN09,Q5TW24,U5HIG6,A0A401PRI6,Q96J94,A0A2B4RHN2,G2QEV0,A0A397UU01,A0A2T7PFL8,K7ISV0,A0A024FT57,H3HCL6,A0A0G4IME3,E9FUN9,A0A1S3CYL5,D7FQK3,A0A1Y1YHC8,T1GSU4,F4S231,A0A1D8PMK0,A0A2G5B1D8,Q5BD61,A0A1C7M8P2,A0A4D8YSQ3,A0A158PJG6,J9JZ66,A0A0C2XG51,A0A158QZT6,A0A165QYQ9,T0SAU8,R7YY92,A0A3S1A0C3,A0A074YJ47,A0A2K1J482,A0A1Q3ENA6,O04379,A0A371I3C8,M8AEW7,A8P0D4,A0A2K3NY65,F4NYW7,A0A409Y6G2,A0A0L0HAB7,D8PZT7,A0A1D1W4K0,A7RQ46,W4YU94,A7BJS5,D8SNM6,A0A1J8PPA3,X1WG39,M5FQK2,Q69VD5,A0A2R6NSC2,A0A0D8XL16,A0A016WPN3,Q9QZ81,G5EES3,A0A0K0EFP6,Q8CJG0,A0A1D5NTU6,V2WTL2,A0A0V0YLH8,A0A139WDH0,A0A0R3W9Q7,H3DS31,A0A1Y1HWP2,G4T5G9,B7QCC4,A0A0B2UV00,M7BCJ9,E9GN30,Q7PZ41,A0A077Z361,R7U9I3,A0A1X7V1N5,A0A0K0JDP1,A0A0N4UKJ1,A0A498N3A3,A0A3M0IQP5,A0A0L8GBV4,Q32KD4,A0A1J1JBJ0,E0W4C3,A0A482XDA9,A0A3P7EJD6,J9K2Z4,A0A2J7Q8V4,T1IBM6,V3ZRX0,A0A210QKF7,A0A423TSS1,K1PT78,A0A267E8R7,A0A1D2N447,A0A226D7A9,F6YK55,T1KTE4,A0A2C9JGZ6,A0A1V9X9F0,K5X5Z7,A0A3Q0KUG5,T1FY40,1YVU,1Z26,3DLB,5AWH,5G5T,5I4A,6QZK,7R8K,E8N0K8,A0A328VKE4,A0A1M5ZSR3,A0A0K8QX04,A0A326U7G5,A0A1Q4R485,A0A097QRL6,A0A139XGN8,B6YTQ5,A0A2T1EFY0,A0A1Z4L0A1,K9UQR0,K9UEV4,A0A496APJ8,A0A062U2W9,H0HWQ5,A0A1V9G9U4,A0A1I2ZGP1,A0A317EJY3,A0A1I2BD20,F8ERC7,A0A0Q2M2Z1,I3TE64,A0A139WY18,A0A2T1E1K4,A0A1Q8ZD62,A0A1Z3HNN4,A5D4D9,A0A329TD61,A0A1E3XF49,A0A1Q1FPH0,H1YCU5,A0A1Q5ZS75,A0A345E7N0,A0A1W2A082,A0A1H3X247,A0A0C1XUA0,A0A1H2RBI2,A0A1C3ZXN2,B9LVP8,A0A343TL88,A0A3P3RGE5,A0A329TBQ3,A0A285N2A8,A0A0W1S8B8,L9VRQ2,E4NRV1,A0A1I6HGN0,,",366,37
"1117","N.H8.1","N.H8.5",340,179,161,2.66012005968285,"4F1N,4F3T,4KRE,5GUH,5VM9,6KR6,6OON,7KX7,7SWF,A0A163JTZ6,A0A0N4X8S8,J9D5G4,Q389P5,C4LVV2,A0A2P6N8X7,A8BCK6,A0A0G4H2S4,T1H8B3,R1FDF0,S4RWI0,D2VMG4,A0A074TLL7,A0A0D1ZAJ4,Q1K660,F4PH46,A0A3M7S814,A0A164ZA52,A0A383WDW5,Q54G64,S7WCF7,I0YVB2,R7QGN7,C1DZY0,A0A2C5Z0M1,A0CB11,R9ACY5,D3BMP8,A0A1Z5TVE5,W7XD45,A0A1U7LLR0,A0A4S2MWZ7,K1VVQ6,A0A158P1R9,G7DVX0,V6R0U9,G4N9J3,E3KLI3,B7Q5I1,A0A1E3QC61,D5GGK8,S8ANP9,A0A139AUH8,L2GMR6,U4LBG4,A0A177URI1,O74957,A0A3N4IGK1,A6N7Y9,A0A0E9NDK5,T1KZ60,A0A2G8JLH3,Q5KAT1,L2GUF2,W2T741,A0A1W0E4B5,A0A2J7QB22,S4RYE2,A0A388KES6,A0A226EFL3,A0A3S3PD82,A0A0L0TEV1,A0A1S3J512,G0QTT2,A0A1J1HRI1,C4V9J2,Q9JMB7,A0A075AN09,Q5TW24,U5HIG6,A0A401PRI6,Q96J94,A0A2B4RHN2,G2QEV0,A0A397UU01,A0A2T7PFL8,K7ISV0,A0A024FT57,H3HCL6,A0A0G4IME3,E9FUN9,A0A1S3CYL5,D7FQK3,A0A1Y1YHC8,T1GSU4,F4S231,A0A1D8PMK0,A0A2G5B1D8,Q5BD61,A0A1C7M8P2,A0A4D8YSQ3,A0A158PJG6,J9JZ66,A0A0C2XG51,A0A158QZT6,A0A165QYQ9,T0SAU8,R7YY92,A0A3S1A0C3,A0A074YJ47,A0A2K1J482,A0A1Q3ENA6,O04379,A0A371I3C8,M8AEW7,A8P0D4,A0A2K3NY65,F4NYW7,A0A409Y6G2,A0A0L0HAB7,D8PZT7,A0A1D1W4K0,A7RQ46,W4YU94,A7BJS5,D8SNM6,A0A1J8PPA3,X1WG39,M5FQK2,Q69VD5,A0A2R6NSC2,A0A0D8XL16,A0A016WPN3,Q9QZ81,G5EES3,A0A0K0EFP6,Q8CJG0,A0A1D5NTU6,V2WTL2,A0A0V0YLH8,A0A139WDH0,A0A0R3W9Q7,H3DS31,A0A1Y1HWP2,G4T5G9,B7QCC4,A0A0B2UV00,M7BCJ9,E9GN30,Q7PZ41,A0A077Z361,R7U9I3,A0A1X7V1N5,A0A0K0JDP1,A0A0N4UKJ1,A0A498N3A3,A0A3M0IQP5,A0A0L8GBV4,Q32KD4,A0A1J1JBJ0,E0W4C3,A0A482XDA9,A0A3P7EJD6,J9K2Z4,A0A2J7Q8V4,T1IBM6,V3ZRX0,A0A210QKF7,A0A423TSS1,K1PT78,A0A267E8R7,A0A1D2N447,A0A226D7A9,F6YK55,T1KTE4,A0A2C9JGZ6,A0A1V9X9F0,K5X5Z7,A0A3Q0KUG5,T1FY40,1YVU,1Z26,3DLB,5AWH,5G5T,6QZK,7R8K,E8N0K8,A0A328VKE4,C4L1M1,Q11QW7,A0A0K8QX04,A0A1I3LMA1,K9TPA9,A0A2Z6E1D5,A0A0F4NXW8,A0A142XB92,L8D0R3,B1XJG0,A0A326U7G5,A0A3D8L290,K9U8J6,K9RC91,A0A0D8ZUC0,A0A139XGN8,A0A1T4Y3A2,Q5P0R2,A0A0B0H9B4,A0YYT3,A0A2T1EFY0,G6FTN0,R6KUL9,A0A433NB65,A0A1Z4L0A1,K9UQR0,A0A2T1G8M7,K9VUN0,B7GJX9,A0A0P6X5X2,K9ZDE3,B0JXD6,A0A2T1LS63,A0A1Z4K1Y3,A0A2Z6E0R7,A0A1N6SSK9,A0A0P4UVI8,A0A0V7ZCG4,A0A1J0AGK2,K9PFF9,A0A2G9DT08,K9UEV4,Q9L1X1,A0A060HNJ0,A0A235B542,R5XQK4,A0A1H3LE92,A0A496APJ8,A0A062U2W9,H0HWQ5,A0A1V9G9U4,A0A1I2ZGP1,A0A317EJY3,A0A1I2BD20,F8ERC7,S7VLM7,A0A1A5X8H4,A0A1I2T6Q1,A0A1R3T9N6,A0A0Q2M2Z1,H8KXJ0,A0A2D1U4H7,A0A0B7I4Z6,A0LL61,Q8DKB1,A0A139WY18,A0A1J1EK56,A0A2T1E1K4,A0A1Q8ZD62,A0A4Q6XKV6,A0A1Z3HNN4,A0A239JE83,A0A2N4XBY2,Q53W94,R5JEI2,A0A0Q0ZC47,A0A2T0XH18,A0A1V4CHV0,A0A1K1RQP7,A0A2T1EKT1,A0A1N6LUI7,A0A0P0NGR6,A0A1X7IML5,A0A0A2LKJ7,K1L112,A0A0U3AL92,A0A1H3A054,E0UCX3,K9XZC6,B9LVW4,A0A0C1VHB4,Q31N05,A0A0C5JKF3,R5NJJ8,A5D4D9,Q2JI93,A0A142Y7A9,A0A432MEQ5,A0A372DKU2,A0A3R7KLK4,C1F5Q7,A0A4R3EV39,A0A1P8WP90,A0A222F7P0,A0A1C9VH88,A0A2T2YMB1,A0A329TD61,A0A101R2A0,A0A1E3XF49,A0A1U9ND56,A0A4R7BQC4,A0A1H3DGN3,A0A1Q1FPH0,E0TGY3,A0A259TUP4,F6EYI8,A0A2S9Q9J0,A0A4Q2UIU6,A0A1H0LH25,A0A318LG42,H1YCU5,L0JS08,A0A1Q5ZS75,A0A345E7N0,M0AF24,A0A1W2A082,A0A1H3X247,A0A0C1XUA0,M0D2X3,A0A2R5G167,A0A346PK63,R7RTW6,A0A1H2RBI2,A0A1C3ZXN2,B9LVP8,M5RSF0,W0JW77,B7K585,F8D8G0,A0A343TL88,L0AJX6,A0A2A5QS34,A0A343JEE2,A0A3P3RGE5,A0A329TBQ3,A0A285N2A8,A0A0W1S8B8,A0A1V4C8L7,L9VRQ2,E4NRV1,A0A1I6HGN0,A0A1I0NI68,,",366,37
"1118","N.H8.2","N.H8.5",331,179,152,1.75189282563952,"4F1N,4F3T,4KRE,5GUH,5VM9,6KR6,6OON,7KX7,7SWF,A0A163JTZ6,A0A0N4X8S8,J9D5G4,Q389P5,C4LVV2,A0A2P6N8X7,A8BCK6,A2DPV7,A0A0G4H2S4,T1H8B3,R1FDF0,S4RWI0,D2VMG4,A0A074TLL7,A0A0D1ZAJ4,Q1K660,F4PH46,A0A3M7S814,A0A164ZA52,A0A383WDW5,Q54G64,S7WCF7,I0YVB2,R7QGN7,C1DZY0,A0A2C5Z0M1,A0CB11,R9ACY5,D3BMP8,A0A1Z5TVE5,W7XD45,A0A1U7LLR0,A0A4S2MWZ7,K1VVQ6,A0A158P1R9,G7DVX0,V6R0U9,G4N9J3,E3KLI3,B7Q5I1,A0A1E3QC61,D5GGK8,S8ANP9,A0A139AUH8,L2GMR6,U4LBG4,A0A177URI1,O74957,A0A3N4IGK1,A6N7Y9,A0A0E9NDK5,A0A2G8JLH3,Q5KAT1,L2GUF2,W2T741,A0A1W0E4B5,A0A2J7QB22,S4RYE2,A0A388KES6,A0A226EFL3,A0A3S3PD82,A0A0L0TEV1,A0A1S3J512,G0QTT2,A0A1J1HRI1,C4V9J2,Q9JMB7,A0A075AN09,Q5TW24,U5HIG6,A0A401PRI6,Q96J94,A0A2B4RHN2,G2QEV0,A0A397UU01,A0A2T7PFL8,K7ISV0,A0A024FT57,H3HCL6,A0A0G4IME3,E9FUN9,A0A1S3CYL5,D7FQK3,A0A1Y1YHC8,T1GSU4,F4S231,A0A1D8PMK0,A0A2G5B1D8,Q5BD61,A0A1C7M8P2,A0A4D8YSQ3,A0A158PJG6,J9JZ66,A0A0C2XG51,A0A158QZT6,A0A165QYQ9,T0SAU8,R7YY92,A0A3S1A0C3,A0A074YJ47,A0A2K1J482,A0A1Q3ENA6,O04379,A0A371I3C8,M8AEW7,A8P0D4,A0A2K3NY65,F4NYW7,A0A409Y6G2,A0A0L0HAB7,D8PZT7,A0A1D1W4K0,A7RQ46,W4YU94,A7BJS5,D8SNM6,A0A1J8PPA3,X1WG39,M5FQK2,Q69VD5,A0A2R6NSC2,A0A0D8XL16,A0A016WPN3,Q9QZ81,G5EES3,A0A0K0EFP6,Q8CJG0,A0A1D5NTU6,V2WTL2,A0A0V0YLH8,A0A139WDH0,A0A0R3W9Q7,H3DS31,A0A1Y1HWP2,G4T5G9,B7QCC4,A0A0B2UV00,M7BCJ9,E9GN30,Q7PZ41,A0A077Z361,R7U9I3,A0A1X7V1N5,A0A0K0JDP1,A0A0N4UKJ1,A0A498N3A3,A0A3M0IQP5,A0A0L8GBV4,Q32KD4,A0A1J1JBJ0,E0W4C3,A0A482XDA9,A0A3P7EJD6,J9K2Z4,A0A2J7Q8V4,T1IBM6,V3ZRX0,A0A210QKF7,A0A423TSS1,K1PT78,A0A267E8R7,A0A1D2N447,A0A226D7A9,F6YK55,T1KTE4,A0A2C9JGZ6,A0A1V9X9F0,K5X5Z7,A0A3Q0KUG5,T1FY40,3DLB,5AWH,5G5T,6QZK,7R8K,E8N0K8,A0A328VKE4,C4L1M1,Q11QW7,A0A1I3LMA1,K9TPA9,A0A2Z6E1D5,A0A0F4NXW8,A0A142XB92,L8D0R3,B1XJG0,A0A326U7G5,A0A3D8L290,K9U8J6,K9RC91,A0A0D8ZUC0,A0A139XGN8,A0A1T4Y3A2,Q5P0R2,A0A0B0H9B4,A0YYT3,A0A2T1EFY0,G6FTN0,R6KUL9,A0A433NB65,A0A1Z4L0A1,K9UQR0,A0A2T1G8M7,K9VUN0,B7GJX9,A0A0P6X5X2,K9ZDE3,B0JXD6,A0A2T1LS63,A0A1Z4K1Y3,A0A2Z6E0R7,A0A1N6SSK9,A0A0P4UVI8,A0A0V7ZCG4,A0A1J0AGK2,K9PFF9,A0A2G9DT08,K9UEV4,Q9L1X1,A0A060HNJ0,R5XQK4,A0A1H3LE92,A0A496APJ8,A0A062U2W9,H0HWQ5,A0A1V9G9U4,A0A1I2ZGP1,A0A317EJY3,A0A1I2BD20,F8ERC7,S7VLM7,A0A1A5X8H4,A0A1I2T6Q1,A0A1R3T9N6,A0A0Q2M2Z1,H8KXJ0,A0A2D1U4H7,A0A0B7I4Z6,A0LL61,Q8DKB1,A0A1J1EK56,A0A2T1E1K4,A0A1Q8ZD62,A0A4Q6XKV6,A0A1Z3HNN4,A0A239JE83,A0A2N4XBY2,Q53W94,R5JEI2,A0A0Q0ZC47,A0A2T0XH18,A0A1V4CHV0,A0A1K1RQP7,A0A2T1EKT1,A0A1N6LUI7,A0A0P0NGR6,A0A1X7IML5,A0A0A2LKJ7,K1L112,E0UCX3,K9XZC6,B9LVW4,A0A0C1VHB4,Q31N05,A0A0C5JKF3,R5NJJ8,A5D4D9,Q2JI93,A0A142Y7A9,A0A432MEQ5,A0A372DKU2,A0A3R7KLK4,C1F5Q7,A0A4R3EV39,A0A1P8WP90,A0A222F7P0,A0A2T2YMB1,A0A329TD61,A0A101R2A0,A0A1E3XF49,A0A1U9ND56,A0A4R7BQC4,A0A1H3DGN3,A0A1Q1FPH0,E0TGY3,A0A259TUP4,F6EYI8,A0A2S9Q9J0,A0A4Q2UIU6,A0A1H0LH25,A0A318LG42,H1YCU5,L0JS08,A0A1Q5ZS75,A0A345E7N0,M0AF24,A0A1W2A082,A0A1H3X247,A0A0C1XUA0,M0D2X3,A0A2R5G167,A0A346PK63,R7RTW6,A0A1H2RBI2,A0A1C3ZXN2,B9LVP8,W0JW77,B7K585,F8D8G0,A0A343TL88,L0AJX6,A0A2A5QS34,A0A343JEE2,A0A3P3RGE5,A0A329TBQ3,A0A285N2A8,A0A0W1S8B8,A0A1V4C8L7,L9VRQ2,E4NRV1,A0A1I6HGN0,A0A1I0NI68,,",366,37
"1120","N.L22.1","N.S19.1",313,179,134,2.79302509797382,"4F1N,4F3T,4KRE,5GUH,5VM9,6KR6,6OON,7KX7,A0A163JTZ6,A0A0N4X8S8,A0A196SDB4,J9D5G4,Q389P5,A0A2P6N8X7,A8BCK6,A2DPV7,A0A0G4H2S4,T1H8B3,R1FDF0,S4RWI0,A0A074TLL7,A0A0D1ZAJ4,Q1K660,F4PH46,A0A3M7S814,A0A164ZA52,A0A383WDW5,Q54G64,S7WCF7,I0YVB2,R7QGN7,C1DZY0,A0A2C5Z0M1,A0CB11,R9ACY5,D3BMP8,A0A1Z5TVE5,W7XD45,A0A1U7LLR0,A0A4S2MWZ7,K1VVQ6,A0A158P1R9,G7DVX0,V6R0U9,G4N9J3,E3KLI3,A0A1E3QC61,D5GGK8,S8ANP9,A0A139AUH8,L2GMR6,U4LBG4,A0A177URI1,O74957,A0A3N4IGK1,A6N7Y9,A0A0E9NDK5,T1KZ60,A0A250WXN5,A0A2G8JLH3,Q5KAT1,L2GUF2,W2T741,A0A1W0E4B5,A0A2J7QB22,S4RYE2,A0A2K3CW87,A0A388KES6,A0A226EFL3,A0A3S3PD82,A0A0L0TEV1,A0A1S3J512,G0QTT2,A0A1J1HRI1,C4V9J2,Q9JMB7,A0A075AN09,Q5TW24,U5HIG6,A0A401PRI6,Q96J94,A0A2B4RHN2,G2QEV0,A0A397UU01,A0A2T7PFL8,K7ISV0,A0A024FT57,H3HCL6,A0A0G4IME3,E9FUN9,A0A1S3CYL5,D7FQK3,A0A1Y1YHC8,T1GSU4,F4S231,A0A1D8PMK0,A0A2G5B1D8,Q5BD61,A0A1C7M8P2,A0A4D8YSQ3,A0A158PJG6,J9JZ66,A0A0C2XG51,A0A158QZT6,A0A165QYQ9,T0SAU8,R7YY92,A0A3S1A0C3,A0A074YJ47,A0A2K1J482,A0A1Q3ENA6,O04379,A0A371I3C8,M8AEW7,A8P0D4,A0A2K3NY65,F4NYW7,A0A409Y6G2,A0A0L0HAB7,D8PZT7,A0A1D1W4K0,A7RQ46,W4YU94,A7BJS5,D8SNM6,A0A1J8PPA3,X1WG39,M5FQK2,Q69VD5,A0A2R6NSC2,A0A0D8XL16,A0A016WPN3,Q9QZ81,G5EES3,A0A0K0EFP6,Q8CJG0,A0A1D5NTU6,V2WTL2,A0A0V0YLH8,A0A139WDH0,A0A0R3W9Q7,H3DS31,A0A1Y1HWP2,G4T5G9,B7QCC4,A0A0B2UV00,M7BCJ9,E9GN30,Q7PZ41,A0A077Z361,R7U9I3,A0A1X7V1N5,A0A0K0JDP1,A0A0N4UKJ1,A0A498N3A3,A0A3M0IQP5,A0A0L8GBV4,Q32KD4,A0A1J1JBJ0,E0W4C3,A0A482XDA9,A0A3P7EJD6,J9K2Z4,A0A2J7Q8V4,T1IBM6,V3ZRX0,A0A210QKF7,A0A423TSS1,K1PT78,A0A267E8R7,A0A1D2N447,A0A226D7A9,F6YK55,T1KTE4,A0A2C9JGZ6,A0A1V9X9F0,K5X5Z7,A0A3Q0KUG5,T1FY40,1YVU,1Z26,3DLB,5AWH,5G5T,5I4A,6QZK,7R8K,E8N0K8,A0A328VKE4,E0ST67,A0A2Z6E1D5,A0A0F4NXW8,L8D0R3,B1XJG0,A0A326U7G5,A0A1Q4R485,K9U8J6,K9RC91,A0A1T4Y3A2,Q5P0R2,A0YYT3,A0A433NB65,A0A1Z4L0A1,K9UQR0,A0A2T1G8M7,K9VUN0,A0A2T1LS63,A0A1Z4K1Y3,A0A2Z6E0R7,A0A0P4UVI8,A0A0V7ZCG4,A0A1J0AGK2,K9PFF9,A0A2G9DT08,Q9L1X1,A0A496APJ8,A0A062U2W9,H0HWQ5,A0A1V9G9U4,A0A1I2ZGP1,A0A317EJY3,A0A1I2BD20,F8ERC7,S7VLM7,A0A1A5X8H4,A0A1I2T6Q1,A0A1R3T9N6,A0A0Q2M2Z1,H8KXJ0,D3S0S6,A0A2D1U4H7,A0A0B7I4Z6,A0LL61,Q8DKB1,A0A139WY18,A0A1J1EK56,A0A2T1E1K4,A0A1Q8ZD62,A0A4Q6XKV6,A0A1Z3HNN4,A0A239JE83,A0A2N4XBY2,Q53W94,R5JEI2,A0A0Q0ZC47,A0A2T0XH18,A0A1V4CHV0,A0A1K1RQP7,A0A2T1EKT1,A0A1N6LUI7,A0A0P0NGR6,A0A1X7IML5,A0A0A2LKJ7,K1L112,A0A0U3AL92,A0A1H3A054,E0UCX3,K9XZC6,A0A0C1VHB4,Q31N05,A0A0C5JKF3,R5NJJ8,A5D4D9,Q2JI93,A0A142Y7A9,A0A432MEQ5,A0A372DKU2,C1F5Q7,A0A4R3EV39,A0A1P8WP90,A0A222F7P0,A0A1C9VH88,A0A2T2YMB1,A0A329TD61,A0A101R2A0,A0A1E3XF49,A0A1U9ND56,A0A4R7BQC4,A0A1Q1FPH0,E0TGY3,A0A259TUP4,F6EYI8,A0A2S9Q9J0,A0A4Q2UIU6,A0A318LG42,H1YCU5,L0JS08,A0A1Q5ZS75,A0A345E7N0,M0AF24,A0A1W2A082,A0A1H3X247,A0A0C1XUA0,M0D2X3,A0A2R5G167,A0A346PK63,R7RTW6,A0A1H2RBI2,A0A1C3ZXN2,B9LVP8,M5RSF0,B7K585,F8D8G0,A0A343TL88,A0A343JEE2,A0A3P3RGE5,A0A329TBQ3,A0A0W1S8B8,A0A1V4C8L7,L9VRQ2,E4NRV1,A0A1I6HGN0,A0A1I0NI68,,",366,37
"1121","N.S13.2","N.S19.2",302,179,123,3.07671344869873,"4F1N,4F3T,4KRE,5GUH,5VM9,6KR6,6OON,7KX7,7SWF,A0A163JTZ6,A0A0N4X8S8,A0A196SDB4,J9D5G4,A0A2P6N8X7,A8BCK6,A2DPV7,A0A0G4H2S4,T1H8B3,S4RWI0,D2VMG4,A0A074TLL7,A0A0D1ZAJ4,Q1K660,F4PH46,A0A3M7S814,A0A164ZA52,A0A383WDW5,Q54G64,S7WCF7,I0YVB2,R7QGN7,C1DZY0,A0A2C5Z0M1,A0CB11,R9ACY5,D3BMP8,A0A1Z5TVE5,W7XD45,A0A1U7LLR0,A0A4S2MWZ7,K1VVQ6,A0A158P1R9,G7DVX0,V6R0U9,G4N9J3,E3KLI3,A0A1E3QC61,D5GGK8,S8ANP9,A0A139AUH8,L2GMR6,U4LBG4,A0A177URI1,O74957,A0A3N4IGK1,A6N7Y9,A0A0E9NDK5,T1KZ60,A0A250WXN5,A0A2G8JLH3,Q5KAT1,L2GUF2,W2T741,A0A1W0E4B5,A0A2J7QB22,S4RYE2,A0A2K3CW87,A0A388KES6,A0A226EFL3,A0A3S3PD82,A0A0L0TEV1,A0A1S3J512,G0QTT2,A0A1J1HRI1,C4V9J2,Q9JMB7,A0A075AN09,Q5TW24,U5HIG6,A0A401PRI6,Q96J94,A0A2B4RHN2,G2QEV0,A0A397UU01,A0A2T7PFL8,K7ISV0,A0A024FT57,H3HCL6,A0A0G4IME3,E9FUN9,A0A1S3CYL5,D7FQK3,A0A1Y1YHC8,T1GSU4,F4S231,A0A1D8PMK0,A0A2G5B1D8,Q5BD61,A0A1C7M8P2,A0A4D8YSQ3,A0A158PJG6,J9JZ66,A0A0C2XG51,A0A158QZT6,A0A165QYQ9,T0SAU8,R7YY92,A0A3S1A0C3,A0A074YJ47,A0A2K1J482,A0A1Q3ENA6,O04379,A0A371I3C8,M8AEW7,A8P0D4,A0A2K3NY65,F4NYW7,A0A409Y6G2,A0A0L0HAB7,D8PZT7,A0A1D1W4K0,A7RQ46,W4YU94,A7BJS5,D8SNM6,A0A1J8PPA3,X1WG39,M5FQK2,Q69VD5,A0A2R6NSC2,A0A0D8XL16,A0A016WPN3,Q9QZ81,G5EES3,A0A0K0EFP6,Q8CJG0,A0A1D5NTU6,V2WTL2,A0A0V0YLH8,A0A139WDH0,A0A0R3W9Q7,H3DS31,A0A1Y1HWP2,G4T5G9,B7QCC4,A0A0B2UV00,M7BCJ9,E9GN30,Q7PZ41,A0A077Z361,R7U9I3,A0A1X7V1N5,A0A0K0JDP1,A0A0N4UKJ1,A0A498N3A3,A0A3M0IQP5,A0A0L8GBV4,Q32KD4,A0A1J1JBJ0,E0W4C3,A0A482XDA9,A0A3P7EJD6,J9K2Z4,A0A2J7Q8V4,T1IBM6,V3ZRX0,A0A210QKF7,A0A423TSS1,K1PT78,A0A267E8R7,A0A1D2N447,A0A226D7A9,F6YK55,T1KTE4,A0A2C9JGZ6,A0A1V9X9F0,K5X5Z7,A0A3Q0KUG5,T1FY40,1YVU,1Z26,3DLB,5AWH,5G5T,5I4A,6QZK,7R8K,E0ST67,C4L1M1,A0A1I3LMA1,B1XJG0,H1KXR6,A0A1T4Y3A2,A0A0B0H9B4,R6KUL9,B7GJX9,A0A1N6SSK9,A0A2G9DT08,Q9L1X1,A0A060HNJ0,A0A235B542,R5XQK4,A0A1H3LE92,A0A496APJ8,A0A062U2W9,H0HWQ5,A0A1V9G9U4,A0A1I2ZGP1,A0A317EJY3,A0A1I2BD20,F8ERC7,S7VLM7,A0A1A5X8H4,A0A1I2T6Q1,A0A1R3T9N6,A0A0Q2M2Z1,H8KXJ0,D3S0S6,A0A2D1U4H7,A0A0B7I4Z6,A0LL61,Q8DKB1,A0A139WY18,A0A1J1EK56,A0A2T1E1K4,A0A1Q8ZD62,A0A4Q6XKV6,A0A1Z3HNN4,A0A239JE83,A0A2N4XBY2,Q53W94,R5JEI2,A0A0Q0ZC47,A0A2T0XH18,A0A1V4CHV0,A0A1K1RQP7,A0A2T1EKT1,A0A1N6LUI7,A0A0P0NGR6,A0A1X7IML5,A0A0A2LKJ7,K1L112,A0A0U3AL92,A0A1H3A054,E0UCX3,K9XZC6,A0A0C1VHB4,Q31N05,A0A0C5JKF3,R5NJJ8,A5D4D9,Q2JI93,A0A142Y7A9,A0A432MEQ5,A0A372DKU2,A0A4R3EV39,A0A1P8WP90,A0A222F7P0,A0A1C9VH88,A0A2T2YMB1,A0A101R2A0,A0A1E3XF49,A0A1U9ND56,A0A4R7BQC4,E0TGY3,A0A259TUP4,F6EYI8,A0A2S9Q9J0,A0A4Q2UIU6,A0A1H0LH25,A0A318LG42,H1YCU5,L0JS08,A0A1Q5ZS75,M0AF24,A0A1W2A082,A0A1H3X247,A0A0C1XUA0,M0D2X3,A0A2R5G167,A0A346PK63,R7RTW6,A0A1H2RBI2,A0A1C3ZXN2,B9LVP8,M5RSF0,W0JW77,B7K585,F8D8G0,A0A343TL88,L0AJX6,A0A2A5QS34,A0A343JEE2,A0A3P3RGE5,A0A329TBQ3,A0A285N2A8,A0A0W1S8B8,A0A1V4C8L7,L9VRQ2,E4NRV1,A0A1I6HGN0,A0A1I0NI68,,",366,37
"1124","C.H1.12","C.H1.14",354,180,174,1.82183908045977,"4F1N,4F3T,4KRE,5GUH,5VM9,6KR6,6OON,7KX7,7SWF,A0A163JTZ6,A0A0N4X8S8,A0A196SDB4,J9D5G4,C4LVV2,A0A2P6N8X7,A8BCK6,A2DPV7,A0A0G4H2S4,T1H8B3,S4RWI0,D2VMG4,A0A074TLL7,A0A0D1ZAJ4,Q1K660,F4PH46,A0A3M7S814,A0A164ZA52,A0A383WDW5,Q54G64,S7WCF7,I0YVB2,R7QGN7,A0A2C5Z0M1,A0CB11,R9ACY5,D3BMP8,A0A1Z5TVE5,W7XD45,A0A1U7LLR0,A0A4S2MWZ7,K1VVQ6,A0A158P1R9,G7DVX0,V6R0U9,G4N9J3,E3KLI3,B7Q5I1,A0A1E3QC61,D5GGK8,S8ANP9,A0A139AUH8,L2GMR6,U4LBG4,A0A177URI1,O74957,A0A3N4IGK1,A6N7Y9,A0A0E9NDK5,T1KZ60,A0A250WXN5,A0A2G8JLH3,Q5KAT1,L2GUF2,W2T741,A0A1W0E4B5,A0A2J7QB22,S4RYE2,A0A2K3CW87,A0A388KES6,A0A226EFL3,A0A3S3PD82,A0A0L0TEV1,A0A1S3J512,G0QTT2,A0A1J1HRI1,C4V9J2,Q9JMB7,A0A075AN09,Q5TW24,U5HIG6,A0A401PRI6,Q96J94,A0A2B4RHN2,G2QEV0,A0A397UU01,A0A2T7PFL8,K7ISV0,A0A024FT57,H3HCL6,A0A0G4IME3,E9FUN9,A0A1S3CYL5,D7FQK3,A0A1Y1YHC8,T1GSU4,F4S231,A0A1D8PMK0,A0A2G5B1D8,Q5BD61,A0A1C7M8P2,A0A4D8YSQ3,A0A158PJG6,J9JZ66,A0A0C2XG51,A0A158QZT6,A0A165QYQ9,T0SAU8,R7YY92,A0A3S1A0C3,A0A074YJ47,A0A2K1J482,A0A1Q3ENA6,O04379,A0A371I3C8,M8AEW7,A8P0D4,A0A2K3NY65,F4NYW7,A0A409Y6G2,A0A0L0HAB7,D8PZT7,A0A1D1W4K0,A7RQ46,W4YU94,A7BJS5,D8SNM6,A0A1J8PPA3,X1WG39,M5FQK2,Q69VD5,A0A2R6NSC2,A0A0D8XL16,A0A016WPN3,Q9QZ81,G5EES3,A0A0K0EFP6,Q8CJG0,A0A1D5NTU6,V2WTL2,A0A0V0YLH8,A0A139WDH0,A0A0R3W9Q7,H3DS31,A0A1Y1HWP2,G4T5G9,B7QCC4,A0A0B2UV00,M7BCJ9,E9GN30,Q7PZ41,A0A077Z361,R7U9I3,A0A1X7V1N5,A0A0K0JDP1,A0A0N4UKJ1,A0A498N3A3,A0A3M0IQP5,A0A0L8GBV4,Q32KD4,A0A1J1JBJ0,E0W4C3,A0A482XDA9,A0A3P7EJD6,J9K2Z4,A0A2J7Q8V4,T1IBM6,V3ZRX0,A0A210QKF7,A0A423TSS1,K1PT78,A0A267E8R7,A0A1D2N447,A0A226D7A9,F6YK55,T1KTE4,A0A2C9JGZ6,A0A1V9X9F0,K5X5Z7,A0A3Q0KUG5,T1FY40,1YVU,1Z26,3DLB,5AWH,5G5T,5I4A,6QZK,7R8K,E8N0K8,A0A328VKE4,E0ST67,C4L1M1,A0A4R1RMM2,A0A1Y2RDH8,Q11QW7,A0A1M5ZSR3,A0A0K8QX04,A0A0M2PXX3,A0A1I3LMA1,K9TPA9,A0A1L3JHM3,A0A1W6MIP2,A0A1C0UUC4,A0A2U2J9E0,A0A2Z6E1D5,A0A0F4NXW8,A0A142XB92,L8D0R3,B1XJG0,A0A326U7G5,A0A3D8L290,A0A1Q4R485,K9U8J6,A0A097QRL6,K9RC91,A0A0D8ZUC0,A0A139XGN8,A0A1T4Y3A2,Q5P0R2,B6YTQ5,A0A0B0H9B4,A0YYT3,A0A2T1EFY0,G6FTN0,R6KUL9,A0A433NB65,A0A1Z4L0A1,K9UQR0,A0A2T1G8M7,K9VUN0,B7GJX9,K9ZDE3,B0JXD6,A0A2T1LS63,A0A1Z4K1Y3,A0A2Z6E0R7,A0A1N6SSK9,A0A0P4UVI8,A0A0V7ZCG4,A0A1J0AGK2,K9PFF9,A0A2G9DT08,K9UEV4,Q9L1X1,A0A060HNJ0,A0A235B542,R5XQK4,A0A1H3LE92,A0A496APJ8,A0A062U2W9,H0HWQ5,A0A1V9G9U4,A0A1I2ZGP1,A0A317EJY3,A0A1I2BD20,F8ERC7,S7VLM7,A0A1A5X8H4,A0A1I2T6Q1,A0A1R3T9N6,A0A0Q2M2Z1,H8KXJ0,D3S0S6,A0A2D1U4H7,I3TE64,A0A0B7I4Z6,A0LL61,Q8DKB1,A0A139WY18,A0A1J1EK56,A0A2T1E1K4,A0A1Q8ZD62,A0A4Q6XKV6,A0A1Z3HNN4,A0A239JE83,A0A2N4XBY2,Q53W94,R5JEI2,A0A0Q0ZC47,A0A2T0XH18,A0A1V4CHV0,A0A1K1RQP7,A0A2T1EKT1,A0A1N6LUI7,A0A0P0NGR6,A0A1X7IML5,A0A0A2LKJ7,K1L112,A0A0U3AL92,A0A1H3A054,E0UCX3,K9XZC6,A0A0C1VHB4,Q31N05,A0A0C5JKF3,R5NJJ8,A5D4D9,Q2JI93,A0A142Y7A9,A0A432MEQ5,A0A372DKU2,A0A3R7KLK4,C1F5Q7,A0A4R3EV39,A0A1P8WP90,A0A222F7P0,A0A1C9VH88,A0A2T2YMB1,A0A329TD61,A0A101R2A0,A0A1E3XF49,A0A1U9ND56,A0A4R7BQC4,A0A1H3DGN3,A0A1Q1FPH0,E0TGY3,A0A259TUP4,F6EYI8,A0A2S9Q9J0,A0A4Q2UIU6,A0A1H0LH25,A0A318LG42,H1YCU5,L0JS08,A0A1Q5ZS75,A0A345E7N0,M0AF24,A0A1W2A082,A0A1H3X247,A0A0C1XUA0,M0D2X3,A0A2R5G167,A0A346PK63,R7RTW6,A0A1H2RBI2,A0A1C3ZXN2,B9LVP8,M5RSF0,W0JW77,B7K585,F8D8G0,A0A343TL88,L0AJX6,A0A2A5QS34,A0A343JEE2,A0A3P3RGE5,A0A329TBQ3,A0A285N2A8,A0A0W1S8B8,A0A1V4C8L7,L9VRQ2,E4NRV1,A0A1I6HGN0,A0A1I0NI68,,",366,37
"1126","C.H3.3","C.H3.5",348,180,168,1.87956349206349,"4F1N,4F3T,4KRE,5GUH,5VM9,6KR6,6OON,7KX7,7SWF,A0A163JTZ6,A0A0N4X8S8,A0A196SDB4,J9D5G4,Q389P5,C4LVV2,A0A2P6N8X7,A8BCK6,A2DPV7,A0A0G4H2S4,T1H8B3,S4RWI0,D2VMG4,A0A074TLL7,A0A0D1ZAJ4,Q1K660,F4PH46,A0A3M7S814,A0A164ZA52,A0A383WDW5,Q54G64,S7WCF7,I0YVB2,R7QGN7,C1DZY0,A0A2C5Z0M1,A0CB11,R9ACY5,D3BMP8,A0A1Z5TVE5,W7XD45,A0A1U7LLR0,A0A4S2MWZ7,K1VVQ6,A0A158P1R9,G7DVX0,V6R0U9,G4N9J3,E3KLI3,B7Q5I1,A0A1E3QC61,D5GGK8,S8ANP9,A0A139AUH8,L2GMR6,U4LBG4,A0A177URI1,O74957,A0A3N4IGK1,A6N7Y9,A0A0E9NDK5,T1KZ60,A0A250WXN5,A0A2G8JLH3,Q5KAT1,L2GUF2,W2T741,A0A1W0E4B5,A0A2J7QB22,S4RYE2,A0A2K3CW87,A0A388KES6,A0A226EFL3,A0A3S3PD82,A0A0L0TEV1,A0A1S3J512,G0QTT2,A0A1J1HRI1,C4V9J2,Q9JMB7,A0A075AN09,Q5TW24,U5HIG6,A0A401PRI6,Q96J94,A0A2B4RHN2,G2QEV0,A0A397UU01,A0A2T7PFL8,K7ISV0,A0A024FT57,H3HCL6,A0A0G4IME3,E9FUN9,A0A1S3CYL5,D7FQK3,A0A1Y1YHC8,A0A1D8PMK0,A0A2G5B1D8,Q5BD61,A0A1C7M8P2,A0A4D8YSQ3,A0A158PJG6,J9JZ66,A0A0C2XG51,A0A158QZT6,A0A165QYQ9,T0SAU8,R7YY92,A0A3S1A0C3,A0A074YJ47,A0A2K1J482,A0A1Q3ENA6,O04379,A0A371I3C8,M8AEW7,A8P0D4,A0A2K3NY65,F4NYW7,A0A409Y6G2,A0A0L0HAB7,D8PZT7,A0A1D1W4K0,A7RQ46,W4YU94,A7BJS5,D8SNM6,A0A1J8PPA3,X1WG39,M5FQK2,Q69VD5,A0A2R6NSC2,A0A0D8XL16,A0A016WPN3,Q9QZ81,G5EES3,A0A0K0EFP6,Q8CJG0,A0A1D5NTU6,V2WTL2,A0A0V0YLH8,A0A139WDH0,A0A0R3W9Q7,H3DS31,A0A1Y1HWP2,G4T5G9,B7QCC4,A0A0B2UV00,M7BCJ9,E9GN30,Q7PZ41,A0A077Z361,R7U9I3,A0A1X7V1N5,A0A0K0JDP1,A0A0N4UKJ1,A0A498N3A3,A0A3M0IQP5,A0A0L8GBV4,Q32KD4,A0A1J1JBJ0,E0W4C3,A0A482XDA9,A0A3P7EJD6,J9K2Z4,A0A2J7Q8V4,T1IBM6,V3ZRX0,A0A210QKF7,A0A423TSS1,K1PT78,A0A267E8R7,A0A1D2N447,A0A226D7A9,F6YK55,T1KTE4,A0A2C9JGZ6,A0A1V9X9F0,K5X5Z7,A0A3Q0KUG5,T1FY40,1YVU,1Z26,3DLB,5AWH,5G5T,5I4A,6QZK,7R8K,E8N0K8,A0A1I7IXT4,A0A2W1JZ37,A0A2S7WBN3,A0A328VKE4,A0A420DFE6,E0ST67,A0A4V1VDY2,A0A368P5I0,C4L1M1,A0A4R1RMM2,A0A1Y2RDH8,Q11QW7,A0A1M5ZSR3,A0A0K8QX04,A0A0M2PXX3,A0A1I3LMA1,K9TPA9,A0A1L3JHM3,A0A1W6MIP2,A0A1C0UUC4,A0A2U2J9E0,A0A142XB92,B1XJG0,A0A326U7G5,H1KXR6,A0A1Q4R485,K9U8J6,A0A097QRL6,K9RC91,A0A0D8ZUC0,A0A139XGN8,A0A1T4Y3A2,B6YTQ5,A0A0B0H9B4,A0YYT3,A0A2T1EFY0,G6FTN0,R6KUL9,A0A433NB65,A0A1Z4L0A1,K9UQR0,A0A2T1G8M7,K9VUN0,B7GJX9,A0A0P6X5X2,K9ZDE3,B0JXD6,A0A2T1LS63,A0A1Z4K1Y3,A0A1N6SSK9,A0A0P4UVI8,A0A0V7ZCG4,A0A1J0AGK2,K9PFF9,A0A2G9DT08,K9UEV4,Q9L1X1,A0A235B542,R5XQK4,A0A1H3LE92,A0A496APJ8,A0A062U2W9,H0HWQ5,A0A1V9G9U4,A0A1I2ZGP1,A0A317EJY3,A0A1I2BD20,F8ERC7,S7VLM7,A0A1A5X8H4,A0A1I2T6Q1,A0A1R3T9N6,H8KXJ0,A0A2D1U4H7,I3TE64,A0A0B7I4Z6,A0LL61,Q8DKB1,A0A139WY18,A0A1J1EK56,A0A2T1E1K4,A0A1Q8ZD62,A0A4Q6XKV6,A0A1Z3HNN4,A0A239JE83,A0A2N4XBY2,Q53W94,R5JEI2,A0A0Q0ZC47,A0A2T0XH18,A0A1V4CHV0,A0A1K1RQP7,A0A2T1EKT1,A0A1N6LUI7,A0A0P0NGR6,A0A1X7IML5,A0A0A2LKJ7,K1L112,A0A0U3AL92,A0A1H3A054,E0UCX3,K9XZC6,A0A0C1VHB4,Q31N05,A0A0C5JKF3,R5NJJ8,A5D4D9,Q2JI93,A0A142Y7A9,A0A432MEQ5,A0A372DKU2,A0A3R7KLK4,C1F5Q7,A0A4R3EV39,A0A1P8WP90,A0A222F7P0,A0A1C9VH88,A0A2T2YMB1,A0A329TD61,A0A101R2A0,A0A1U9ND56,A0A4R7BQC4,A0A1H3DGN3,A0A1Q1FPH0,E0TGY3,A0A259TUP4,F6EYI8,A0A2S9Q9J0,A0A4Q2UIU6,A0A1H0LH25,A0A318LG42,L0JS08,A0A345E7N0,M0AF24,A0A1W2A082,A0A1H3X247,M0D2X3,A0A2R5G167,A0A346PK63,R7RTW6,A0A1H2RBI2,B9LVP8,M5RSF0,W0JW77,B7K585,F8D8G0,A0A343TL88,L0AJX6,A0A2A5QS34,A0A343JEE2,A0A3P3RGE5,A0A329TBQ3,A0A285N2A8,A0A0W1S8B8,A0A1V4C8L7,L9VRQ2,E4NRV1,A0A1I6HGN0,A0A1I0NI68,,",366,37
"1127","C.H3.4","C.H3.7",337,180,157,1.39746992215145,"4F3T,4KRE,5GUH,5VM9,6KR6,6OON,7KX7,7SWF,A0A163JTZ6,A0A0N4X8S8,A0A196SDB4,J9D5G4,Q389P5,C4LVV2,A0A2P6N8X7,A8BCK6,A2DPV7,A0A0G4H2S4,T1H8B3,S4RWI0,D2VMG4,A0A074TLL7,A0A0D1ZAJ4,Q1K660,F4PH46,A0A3M7S814,A0A164ZA52,A0A383WDW5,Q54G64,S7WCF7,I0YVB2,R7QGN7,C1DZY0,A0A2C5Z0M1,A0CB11,R9ACY5,D3BMP8,A0A1Z5TVE5,W7XD45,A0A1U7LLR0,A0A4S2MWZ7,K1VVQ6,A0A158P1R9,G7DVX0,V6R0U9,G4N9J3,E3KLI3,B7Q5I1,A0A1E3QC61,D5GGK8,S8ANP9,A0A139AUH8,L2GMR6,U4LBG4,A0A177URI1,O74957,A0A3N4IGK1,A6N7Y9,A0A0E9NDK5,T1KZ60,A0A250WXN5,A0A2G8JLH3,Q5KAT1,L2GUF2,W2T741,A0A1W0E4B5,A0A2J7QB22,S4RYE2,A0A2K3CW87,A0A388KES6,A0A226EFL3,A0A3S3PD82,A0A0L0TEV1,A0A1S3J512,G0QTT2,A0A1J1HRI1,C4V9J2,Q9JMB7,A0A075AN09,Q5TW24,U5HIG6,A0A401PRI6,Q96J94,A0A2B4RHN2,G2QEV0,A0A397UU01,A0A2T7PFL8,K7ISV0,A0A024FT57,H3HCL6,A0A0G4IME3,E9FUN9,A0A1S3CYL5,D7FQK3,A0A1Y1YHC8,T1GSU4,A0A1D8PMK0,A0A2G5B1D8,Q5BD61,A0A1C7M8P2,A0A4D8YSQ3,A0A158PJG6,J9JZ66,A0A0C2XG51,A0A158QZT6,A0A165QYQ9,T0SAU8,R7YY92,A0A3S1A0C3,A0A074YJ47,A0A2K1J482,A0A1Q3ENA6,O04379,A0A371I3C8,M8AEW7,A8P0D4,A0A2K3NY65,F4NYW7,A0A409Y6G2,A0A0L0HAB7,D8PZT7,A0A1D1W4K0,A7RQ46,W4YU94,A7BJS5,D8SNM6,A0A1J8PPA3,X1WG39,M5FQK2,Q69VD5,A0A2R6NSC2,A0A0D8XL16,A0A016WPN3,Q9QZ81,G5EES3,A0A0K0EFP6,Q8CJG0,A0A1D5NTU6,V2WTL2,A0A0V0YLH8,A0A139WDH0,A0A0R3W9Q7,H3DS31,A0A1Y1HWP2,G4T5G9,B7QCC4,A0A0B2UV00,M7BCJ9,E9GN30,Q7PZ41,A0A077Z361,R7U9I3,A0A1X7V1N5,A0A0K0JDP1,A0A0N4UKJ1,A0A498N3A3,A0A3M0IQP5,A0A0L8GBV4,Q32KD4,A0A1J1JBJ0,E0W4C3,A0A482XDA9,A0A3P7EJD6,J9K2Z4,A0A2J7Q8V4,T1IBM6,V3ZRX0,A0A210QKF7,A0A423TSS1,K1PT78,A0A267E8R7,A0A1D2N447,A0A226D7A9,F6YK55,T1KTE4,A0A2C9JGZ6,A0A1V9X9F0,K5X5Z7,A0A3Q0KUG5,T1FY40,5AWH,5I4A,6QZK,E8N0K8,A0A1I7IXT4,A0A2W1JZ37,A0A2S7WBN3,A0A328VKE4,A0A420DFE6,E0ST67,A0A4V1VDY2,A0A368P5I0,C4L1M1,A0A4R1RMM2,A0A1Y2RDH8,Q11QW7,A0A0K8QX04,A0A0M2PXX3,A0A1I3LMA1,A0A1L3JHM3,A0A1W6MIP2,A0A1C0UUC4,A0A2U2J9E0,A0A2Z6E1D5,A0A0F4NXW8,A0A142XB92,L8D0R3,B1XJG0,A0A326U7G5,H1KXR6,A0A1Q4R485,A0A097QRL6,A0A0D8ZUC0,A0A139XGN8,A0A1T4Y3A2,Q5P0R2,B6YTQ5,A0A0B0H9B4,A0YYT3,A0A2T1EFY0,G6FTN0,R6KUL9,A0A433NB65,A0A1Z4L0A1,K9UQR0,A0A2T1G8M7,K9VUN0,B7GJX9,K9ZDE3,B0JXD6,A0A2T1LS63,A0A1Z4K1Y3,A0A2Z6E0R7,A0A1N6SSK9,A0A0P4UVI8,A0A0V7ZCG4,A0A1J0AGK2,K9PFF9,A0A2G9DT08,K9UEV4,Q9L1X1,A0A235B542,R5XQK4,A0A1H3LE92,A0A1V9G9U4,S7VLM7,A0A1A5X8H4,A0A1I2T6Q1,A0A1R3T9N6,A0A0Q2M2Z1,H8KXJ0,A0A2D1U4H7,I3TE64,A0A0B7I4Z6,A0LL61,Q8DKB1,A0A139WY18,A0A1J1EK56,A0A2T1E1K4,A0A1Q8ZD62,A0A4Q6XKV6,A0A1Z3HNN4,A0A239JE83,A0A2N4XBY2,Q53W94,R5JEI2,A0A0Q0ZC47,A0A2T0XH18,A0A1V4CHV0,A0A1K1RQP7,A0A2T1EKT1,A0A1N6LUI7,A0A0P0NGR6,A0A1X7IML5,A0A0A2LKJ7,K1L112,A0A0U3AL92,A0A1H3A054,E0UCX3,K9XZC6,A0A0C1VHB4,Q31N05,A0A0C5JKF3,R5NJJ8,A5D4D9,Q2JI93,A0A142Y7A9,A0A432MEQ5,A0A372DKU2,C1F5Q7,A0A4R3EV39,A0A1P8WP90,A0A222F7P0,A0A1C9VH88,A0A2T2YMB1,A0A329TD61,A0A101R2A0,A0A1U9ND56,A0A4R7BQC4,A0A1Q1FPH0,E0TGY3,A0A259TUP4,F6EYI8,A0A2S9Q9J0,A0A4Q2UIU6,A0A1H0LH25,A0A318LG42,L0JS08,A0A1Q5ZS75,A0A345E7N0,M0AF24,A0A1W2A082,A0A1H3X247,M0D2X3,A0A2R5G167,A0A346PK63,R7RTW6,A0A1H2RBI2,A0A1C3ZXN2,B9LVP8,M5RSF0,W0JW77,B7K585,F8D8G0,A0A343TL88,L0AJX6,A0A2A5QS34,A0A343JEE2,A0A3P3RGE5,A0A329TBQ3,A0A285N2A8,A0A0W1S8B8,A0A1V4C8L7,L9VRQ2,E4NRV1,A0A1I6HGN0,A0A1I0NI68,,",366,37
"1130","C.H5.10","C.H5.8",353,180,173,1.97976878612717,"4F1N,4F3T,4KRE,5GUH,5VM9,6KR6,6OON,7KX7,7SWF,A0A163JTZ6,A0A196SDB4,J9D5G4,Q389P5,C4LVV2,A8BCK6,A2DPV7,A0A0G4H2S4,T1H8B3,R1FDF0,S4RWI0,D2VMG4,A0A074TLL7,A0A0D1ZAJ4,Q1K660,F4PH46,A0A3M7S814,A0A164ZA52,A0A383WDW5,Q54G64,S7WCF7,I0YVB2,R7QGN7,C1DZY0,A0A2C5Z0M1,A0CB11,R9ACY5,D3BMP8,A0A1Z5TVE5,W7XD45,A0A1U7LLR0,A0A4S2MWZ7,K1VVQ6,A0A158P1R9,G7DVX0,V6R0U9,G4N9J3,E3KLI3,B7Q5I1,A0A1E3QC61,D5GGK8,S8ANP9,A0A139AUH8,L2GMR6,U4LBG4,A0A177URI1,O74957,A0A3N4IGK1,A6N7Y9,A0A0E9NDK5,T1KZ60,A0A250WXN5,A0A2G8JLH3,Q5KAT1,L2GUF2,W2T741,A0A1W0E4B5,A0A2J7QB22,S4RYE2,A0A2K3CW87,A0A388KES6,A0A226EFL3,A0A3S3PD82,A0A0L0TEV1,A0A1S3J512,G0QTT2,A0A1J1HRI1,C4V9J2,Q9JMB7,A0A075AN09,Q5TW24,U5HIG6,A0A401PRI6,Q96J94,A0A2B4RHN2,G2QEV0,A0A397UU01,A0A2T7PFL8,K7ISV0,A0A024FT57,H3HCL6,A0A0G4IME3,E9FUN9,A0A1S3CYL5,D7FQK3,A0A1Y1YHC8,T1GSU4,F4S231,A0A1D8PMK0,A0A2G5B1D8,Q5BD61,A0A1C7M8P2,A0A4D8YSQ3,A0A158PJG6,J9JZ66,A0A0C2XG51,A0A158QZT6,T0SAU8,R7YY92,A0A3S1A0C3,A0A074YJ47,A0A2K1J482,A0A1Q3ENA6,O04379,A0A371I3C8,M8AEW7,A8P0D4,A0A2K3NY65,F4NYW7,A0A409Y6G2,A0A0L0HAB7,D8PZT7,A0A1D1W4K0,A7RQ46,W4YU94,A7BJS5,D8SNM6,A0A1J8PPA3,X1WG39,M5FQK2,Q69VD5,A0A2R6NSC2,A0A0D8XL16,A0A016WPN3,Q9QZ81,G5EES3,A0A0K0EFP6,Q8CJG0,A0A1D5NTU6,V2WTL2,A0A0V0YLH8,A0A139WDH0,A0A0R3W9Q7,H3DS31,A0A1Y1HWP2,G4T5G9,B7QCC4,A0A0B2UV00,M7BCJ9,E9GN30,Q7PZ41,A0A077Z361,R7U9I3,A0A1X7V1N5,A0A0K0JDP1,A0A0N4UKJ1,A0A498N3A3,A0A3M0IQP5,A0A0L8GBV4,Q32KD4,A0A1J1JBJ0,E0W4C3,A0A482XDA9,A0A3P7EJD6,J9K2Z4,A0A2J7Q8V4,T1IBM6,V3ZRX0,A0A210QKF7,A0A423TSS1,K1PT78,A0A267E8R7,A0A1D2N447,A0A226D7A9,F6YK55,T1KTE4,A0A2C9JGZ6,A0A1V9X9F0,K5X5Z7,A0A3Q0KUG5,T1FY40,1YVU,1Z26,3DLB,5AWH,5G5T,5I4A,6QZK,E8N0K8,A0A1I7IXT4,A0A2W1JZ37,A0A2S7WBN3,A0A328VKE4,A0A420DFE6,E0ST67,A0A4V1VDY2,A0A368P5I0,C4L1M1,A0A4R1RMM2,A0A1Y2RDH8,Q11QW7,A0A1M5ZSR3,A0A0K8QX04,A0A0M2PXX3,A0A1I3LMA1,K9TPA9,A0A1L3JHM3,A0A1W6MIP2,A0A1C0UUC4,A0A2U2J9E0,A0A2Z6E1D5,A0A0F4NXW8,L8D0R3,B1XJG0,A0A326U7G5,A0A3D8L290,H1KXR6,A0A1Q4R485,K9U8J6,A0A097QRL6,K9RC91,A0A0D8ZUC0,A0A139XGN8,A0A1T4Y3A2,Q5P0R2,B6YTQ5,A0A0B0H9B4,A0YYT3,A0A2T1EFY0,G6FTN0,R6KUL9,A0A433NB65,A0A1Z4L0A1,K9UQR0,A0A2T1G8M7,K9VUN0,B7GJX9,K9ZDE3,B0JXD6,A0A2T1LS63,A0A1Z4K1Y3,A0A2Z6E0R7,A0A1N6SSK9,A0A0P4UVI8,A0A0V7ZCG4,A0A1J0AGK2,K9PFF9,A0A2G9DT08,K9UEV4,Q9L1X1,A0A060HNJ0,A0A235B542,R5XQK4,A0A1H3LE92,A0A496APJ8,A0A1V9G9U4,S7VLM7,A0A1A5X8H4,A0A1I2T6Q1,A0A1R3T9N6,A0A0Q2M2Z1,H8KXJ0,D3S0S6,A0A2D1U4H7,I3TE64,A0A0B7I4Z6,A0LL61,Q8DKB1,A0A139WY18,A0A1J1EK56,A0A2T1E1K4,A0A1Q8ZD62,A0A4Q6XKV6,A0A1Z3HNN4,A0A239JE83,A0A2N4XBY2,Q53W94,R5JEI2,A0A0Q0ZC47,A0A2T0XH18,A0A1V4CHV0,A0A1K1RQP7,A0A2T1EKT1,A0A1N6LUI7,A0A0P0NGR6,A0A1X7IML5,A0A0A2LKJ7,K1L112,A0A0U3AL92,A0A1H3A054,E0UCX3,K9XZC6,A0A0C1VHB4,Q31N05,A0A0C5JKF3,R5NJJ8,A5D4D9,Q2JI93,A0A142Y7A9,A0A432MEQ5,A0A372DKU2,A0A3R7KLK4,C1F5Q7,A0A4R3EV39,A0A1P8WP90,A0A222F7P0,A0A1C9VH88,A0A2T2YMB1,A0A329TD61,A0A101R2A0,A0A1E3XF49,A0A1U9ND56,A0A4R7BQC4,A0A1H3DGN3,A0A1Q1FPH0,E0TGY3,A0A259TUP4,F6EYI8,A0A2S9Q9J0,A0A4Q2UIU6,A0A1H0LH25,A0A318LG42,H1YCU5,L0JS08,A0A1Q5ZS75,A0A345E7N0,M0AF24,A0A1W2A082,A0A1H3X247,A0A0C1XUA0,M0D2X3,A0A2R5G167,A0A346PK63,R7RTW6,A0A1H2RBI2,A0A1C3ZXN2,B9LVP8,M5RSF0,W0JW77,B7K585,F8D8G0,A0A343TL88,L0AJX6,A0A2A5QS34,A0A343JEE2,A0A3P3RGE5,A0A329TBQ3,A0A285N2A8,A0A0W1S8B8,A0A1V4C8L7,L9VRQ2,E4NRV1,A0A1I6HGN0,A0A1I0NI68,,",366,37
"1131","C.H5.11","C.H5.15",350,180,170,3.3812091503268,"4F1N,4F3T,4KRE,5GUH,5VM9,6KR6,6OON,7KX7,7SWF,A0A163JTZ6,A0A196SDB4,J9D5G4,Q389P5,C4LVV2,A8BCK6,A2DPV7,A0A0G4H2S4,T1H8B3,R1FDF0,S4RWI0,D2VMG4,A0A074TLL7,A0A0D1ZAJ4,Q1K660,F4PH46,A0A3M7S814,A0A164ZA52,A0A383WDW5,Q54G64,S7WCF7,I0YVB2,R7QGN7,C1DZY0,A0A2C5Z0M1,A0CB11,R9ACY5,D3BMP8,A0A1Z5TVE5,W7XD45,A0A1U7LLR0,A0A4S2MWZ7,K1VVQ6,A0A158P1R9,G7DVX0,V6R0U9,G4N9J3,E3KLI3,B7Q5I1,A0A1E3QC61,D5GGK8,S8ANP9,A0A139AUH8,L2GMR6,U4LBG4,A0A177URI1,O74957,A0A3N4IGK1,A6N7Y9,A0A0E9NDK5,T1KZ60,A0A250WXN5,A0A2G8JLH3,Q5KAT1,L2GUF2,W2T741,A0A1W0E4B5,A0A2J7QB22,S4RYE2,A0A2K3CW87,A0A388KES6,A0A226EFL3,A0A3S3PD82,A0A0L0TEV1,A0A1S3J512,G0QTT2,A0A1J1HRI1,C4V9J2,Q9JMB7,A0A075AN09,Q5TW24,U5HIG6,A0A401PRI6,Q96J94,A0A2B4RHN2,G2QEV0,A0A397UU01,A0A2T7PFL8,K7ISV0,A0A024FT57,H3HCL6,A0A0G4IME3,E9FUN9,A0A1S3CYL5,D7FQK3,A0A1Y1YHC8,T1GSU4,F4S231,A0A1D8PMK0,A0A2G5B1D8,Q5BD61,A0A1C7M8P2,A0A4D8YSQ3,A0A158PJG6,J9JZ66,A0A0C2XG51,A0A158QZT6,T0SAU8,R7YY92,A0A3S1A0C3,A0A074YJ47,A0A2K1J482,A0A1Q3ENA6,O04379,A0A371I3C8,M8AEW7,A8P0D4,A0A2K3NY65,F4NYW7,A0A409Y6G2,A0A0L0HAB7,D8PZT7,A0A1D1W4K0,A7RQ46,W4YU94,A7BJS5,D8SNM6,A0A1J8PPA3,X1WG39,M5FQK2,Q69VD5,A0A2R6NSC2,A0A0D8XL16,A0A016WPN3,Q9QZ81,G5EES3,A0A0K0EFP6,Q8CJG0,A0A1D5NTU6,V2WTL2,A0A0V0YLH8,A0A139WDH0,A0A0R3W9Q7,H3DS31,A0A1Y1HWP2,G4T5G9,B7QCC4,A0A0B2UV00,M7BCJ9,E9GN30,Q7PZ41,A0A077Z361,R7U9I3,A0A1X7V1N5,A0A0K0JDP1,A0A0N4UKJ1,A0A498N3A3,A0A3M0IQP5,A0A0L8GBV4,Q32KD4,A0A1J1JBJ0,E0W4C3,A0A482XDA9,A0A3P7EJD6,J9K2Z4,A0A2J7Q8V4,T1IBM6,V3ZRX0,A0A210QKF7,A0A423TSS1,K1PT78,A0A267E8R7,A0A1D2N447,A0A226D7A9,F6YK55,T1KTE4,A0A2C9JGZ6,A0A1V9X9F0,K5X5Z7,A0A3Q0KUG5,T1FY40,1YVU,1Z26,3DLB,5AWH,5G5T,5I4A,6QZK,E8N0K8,A0A1I7IXT4,A0A2W1JZ37,A0A2S7WBN3,A0A328VKE4,A0A420DFE6,E0ST67,A0A4V1VDY2,A0A368P5I0,C4L1M1,A0A4R1RMM2,A0A1Y2RDH8,Q11QW7,A0A1M5ZSR3,A0A0K8QX04,A0A0M2PXX3,A0A1I3LMA1,K9TPA9,A0A1L3JHM3,A0A1W6MIP2,A0A1C0UUC4,A0A2U2J9E0,A0A2Z6E1D5,A0A0F4NXW8,B1XJG0,A0A326U7G5,A0A3D8L290,H1KXR6,A0A1Q4R485,K9U8J6,A0A097QRL6,K9RC91,A0A0D8ZUC0,A0A139XGN8,A0A1T4Y3A2,Q5P0R2,B6YTQ5,A0A0B0H9B4,A0YYT3,A0A2T1EFY0,G6FTN0,R6KUL9,A0A433NB65,A0A1Z4L0A1,K9UQR0,A0A2T1G8M7,K9VUN0,B7GJX9,K9ZDE3,B0JXD6,A0A2T1LS63,A0A1Z4K1Y3,A0A2Z6E0R7,A0A1N6SSK9,A0A0P4UVI8,A0A0V7ZCG4,A0A1J0AGK2,K9PFF9,A0A2G9DT08,K9UEV4,Q9L1X1,A0A060HNJ0,A0A235B542,R5XQK4,A0A1H3LE92,A0A496APJ8,A0A1V9G9U4,S7VLM7,A0A1A5X8H4,A0A1I2T6Q1,A0A1R3T9N6,A0A0Q2M2Z1,H8KXJ0,D3S0S6,A0A2D1U4H7,I3TE64,A0A0B7I4Z6,A0LL61,Q8DKB1,A0A139WY18,A0A1J1EK56,A0A2T1E1K4,A0A1Q8ZD62,A0A4Q6XKV6,A0A1Z3HNN4,A0A239JE83,A0A2N4XBY2,Q53W94,R5JEI2,A0A0Q0ZC47,A0A2T0XH18,A0A1V4CHV0,A0A1K1RQP7,A0A2T1EKT1,A0A1N6LUI7,A0A0P0NGR6,A0A1X7IML5,A0A0A2LKJ7,K1L112,A0A0U3AL92,A0A1H3A054,E0UCX3,K9XZC6,A0A0C1VHB4,Q31N05,A0A0C5JKF3,R5NJJ8,A5D4D9,Q2JI93,A0A142Y7A9,A0A432MEQ5,A0A372DKU2,C1F5Q7,A0A4R3EV39,A0A1P8WP90,A0A222F7P0,A0A1C9VH88,A0A2T2YMB1,A0A329TD61,A0A101R2A0,A0A1E3XF49,A0A1U9ND56,A0A4R7BQC4,A0A1Q1FPH0,E0TGY3,A0A259TUP4,F6EYI8,A0A2S9Q9J0,A0A4Q2UIU6,A0A1H0LH25,A0A318LG42,H1YCU5,L0JS08,A0A1Q5ZS75,A0A345E7N0,M0AF24,A0A1W2A082,A0A1H3X247,A0A0C1XUA0,M0D2X3,A0A2R5G167,A0A346PK63,R7RTW6,A0A1H2RBI2,A0A1C3ZXN2,B9LVP8,M5RSF0,W0JW77,B7K585,F8D8G0,A0A343TL88,L0AJX6,A0A2A5QS34,A0A343JEE2,A0A3P3RGE5,A0A329TBQ3,A0A285N2A8,A0A0W1S8B8,A0A1V4C8L7,L9VRQ2,E4NRV1,A0A1I6HGN0,A0A1I0NI68,,",366,37
"1132","C.H5.11","C.H5.8",359,180,179,3.04030105524519,"4F1N,4F3T,4KRE,5GUH,5VM9,6KR6,6OON,7KX7,7SWF,A0A163JTZ6,A0A196SDB4,J9D5G4,Q389P5,C4LVV2,A8BCK6,A2DPV7,A0A0G4H2S4,T1H8B3,R1FDF0,S4RWI0,D2VMG4,A0A074TLL7,A0A0D1ZAJ4,Q1K660,F4PH46,A0A3M7S814,A0A164ZA52,A0A383WDW5,Q54G64,S7WCF7,I0YVB2,R7QGN7,C1DZY0,A0A2C5Z0M1,A0CB11,R9ACY5,D3BMP8,A0A1Z5TVE5,W7XD45,A0A1U7LLR0,A0A4S2MWZ7,K1VVQ6,A0A158P1R9,G7DVX0,V6R0U9,G4N9J3,E3KLI3,B7Q5I1,A0A1E3QC61,D5GGK8,S8ANP9,A0A139AUH8,L2GMR6,U4LBG4,A0A177URI1,O74957,A0A3N4IGK1,A6N7Y9,A0A0E9NDK5,T1KZ60,A0A250WXN5,A0A2G8JLH3,Q5KAT1,L2GUF2,W2T741,A0A1W0E4B5,A0A2J7QB22,S4RYE2,A0A2K3CW87,A0A388KES6,A0A226EFL3,A0A3S3PD82,A0A0L0TEV1,A0A1S3J512,G0QTT2,A0A1J1HRI1,C4V9J2,Q9JMB7,A0A075AN09,Q5TW24,U5HIG6,A0A401PRI6,Q96J94,A0A2B4RHN2,G2QEV0,A0A397UU01,A0A2T7PFL8,K7ISV0,A0A024FT57,H3HCL6,A0A0G4IME3,E9FUN9,A0A1S3CYL5,D7FQK3,A0A1Y1YHC8,T1GSU4,F4S231,A0A1D8PMK0,A0A2G5B1D8,Q5BD61,A0A1C7M8P2,A0A4D8YSQ3,A0A158PJG6,J9JZ66,A0A0C2XG51,A0A158QZT6,T0SAU8,R7YY92,A0A3S1A0C3,A0A074YJ47,A0A2K1J482,A0A1Q3ENA6,O04379,A0A371I3C8,M8AEW7,A8P0D4,A0A2K3NY65,F4NYW7,A0A409Y6G2,A0A0L0HAB7,D8PZT7,A0A1D1W4K0,A7RQ46,W4YU94,A7BJS5,D8SNM6,A0A1J8PPA3,X1WG39,M5FQK2,Q69VD5,A0A2R6NSC2,A0A0D8XL16,A0A016WPN3,Q9QZ81,G5EES3,A0A0K0EFP6,Q8CJG0,A0A1D5NTU6,V2WTL2,A0A0V0YLH8,A0A139WDH0,A0A0R3W9Q7,H3DS31,A0A1Y1HWP2,G4T5G9,B7QCC4,A0A0B2UV00,M7BCJ9,E9GN30,Q7PZ41,A0A077Z361,R7U9I3,A0A1X7V1N5,A0A0K0JDP1,A0A0N4UKJ1,A0A498N3A3,A0A3M0IQP5,A0A0L8GBV4,Q32KD4,A0A1J1JBJ0,E0W4C3,A0A482XDA9,A0A3P7EJD6,J9K2Z4,A0A2J7Q8V4,T1IBM6,V3ZRX0,A0A210QKF7,A0A423TSS1,K1PT78,A0A267E8R7,A0A1D2N447,A0A226D7A9,F6YK55,T1KTE4,A0A2C9JGZ6,A0A1V9X9F0,K5X5Z7,A0A3Q0KUG5,T1FY40,1YVU,1Z26,3DLB,5AWH,5G5T,5I4A,6QZK,7R8K,E8N0K8,A0A1I7IXT4,A0A2W1JZ37,A0A2S7WBN3,A0A328VKE4,A0A420DFE6,E0ST67,A0A4V1VDY2,A0A368P5I0,C4L1M1,A0A4R1RMM2,A0A1Y2RDH8,Q11QW7,A0A1M5ZSR3,A0A0K8QX04,A0A0M2PXX3,A0A1I3LMA1,K9TPA9,A0A1L3JHM3,A0A1W6MIP2,A0A1C0UUC4,A0A2U2J9E0,A0A2Z6E1D5,A0A0F4NXW8,B1XJG0,A0A326U7G5,A0A3D8L290,H1KXR6,A0A1Q4R485,K9U8J6,A0A097QRL6,K9RC91,A0A0D8ZUC0,A0A139XGN8,A0A1T4Y3A2,Q5P0R2,B6YTQ5,A0A0B0H9B4,A0YYT3,A0A2T1EFY0,G6FTN0,R6KUL9,A0A433NB65,A0A1Z4L0A1,K9UQR0,A0A2T1G8M7,K9VUN0,B7GJX9,K9ZDE3,B0JXD6,A0A2T1LS63,A0A1Z4K1Y3,A0A2Z6E0R7,A0A1N6SSK9,A0A0P4UVI8,A0A0V7ZCG4,A0A1J0AGK2,K9PFF9,A0A2G9DT08,K9UEV4,Q9L1X1,A0A060HNJ0,A0A235B542,R5XQK4,A0A1H3LE92,A0A496APJ8,A0A062U2W9,H0HWQ5,A0A1V9G9U4,A0A1I2ZGP1,A0A317EJY3,A0A1I2BD20,F8ERC7,S7VLM7,A0A1A5X8H4,A0A1I2T6Q1,A0A1R3T9N6,A0A0Q2M2Z1,H8KXJ0,D3S0S6,A0A2D1U4H7,I3TE64,A0A0B7I4Z6,A0LL61,Q8DKB1,A0A139WY18,A0A1J1EK56,A0A2T1E1K4,A0A1Q8ZD62,A0A4Q6XKV6,A0A1Z3HNN4,A0A239JE83,A0A2N4XBY2,Q53W94,R5JEI2,A0A0Q0ZC47,A0A2T0XH18,A0A1V4CHV0,A0A1K1RQP7,A0A2T1EKT1,A0A1N6LUI7,A0A0P0NGR6,A0A1X7IML5,A0A0A2LKJ7,K1L112,A0A0U3AL92,A0A1H3A054,E0UCX3,K9XZC6,A0A0C1VHB4,Q31N05,A0A0C5JKF3,R5NJJ8,A5D4D9,Q2JI93,A0A142Y7A9,A0A432MEQ5,A0A372DKU2,A0A3R7KLK4,C1F5Q7,A0A4R3EV39,A0A1P8WP90,A0A222F7P0,A0A1C9VH88,A0A2T2YMB1,A0A329TD61,A0A101R2A0,A0A1E3XF49,A0A1U9ND56,A0A4R7BQC4,A0A1H3DGN3,A0A1Q1FPH0,E0TGY3,A0A259TUP4,F6EYI8,A0A2S9Q9J0,A0A4Q2UIU6,A0A1H0LH25,A0A318LG42,H1YCU5,L0JS08,A0A1Q5ZS75,A0A345E7N0,M0AF24,A0A1W2A082,A0A1H3X247,A0A0C1XUA0,M0D2X3,A0A2R5G167,A0A346PK63,R7RTW6,A0A1H2RBI2,A0A1C3ZXN2,B9LVP8,M5RSF0,W0JW77,B7K585,F8D8G0,A0A343TL88,L0AJX6,A0A2A5QS34,A0A343JEE2,A0A3P3RGE5,A0A329TBQ3,A0A285N2A8,A0A0W1S8B8,A0A1V4C8L7,L9VRQ2,E4NRV1,A0A1I6HGN0,A0A1I0NI68,,",366,37
"1133","C.H5.12","C.H5.14",350,180,170,1.98267973856209,"4F1N,4F3T,4KRE,5GUH,5VM9,6KR6,6OON,7KX7,7SWF,A0A163JTZ6,A0A196SDB4,J9D5G4,Q389P5,C4LVV2,A8BCK6,A2DPV7,A0A0G4H2S4,T1H8B3,R1FDF0,S4RWI0,D2VMG4,A0A074TLL7,A0A0D1ZAJ4,Q1K660,F4PH46,A0A3M7S814,A0A164ZA52,A0A383WDW5,Q54G64,S7WCF7,I0YVB2,R7QGN7,C1DZY0,A0A2C5Z0M1,A0CB11,R9ACY5,D3BMP8,A0A1Z5TVE5,W7XD45,A0A1U7LLR0,A0A4S2MWZ7,K1VVQ6,A0A158P1R9,G7DVX0,V6R0U9,G4N9J3,E3KLI3,B7Q5I1,A0A1E3QC61,D5GGK8,S8ANP9,A0A139AUH8,L2GMR6,U4LBG4,A0A177URI1,O74957,A0A3N4IGK1,A6N7Y9,A0A0E9NDK5,T1KZ60,A0A250WXN5,A0A2G8JLH3,Q5KAT1,L2GUF2,W2T741,A0A1W0E4B5,A0A2J7QB22,S4RYE2,A0A2K3CW87,A0A388KES6,A0A226EFL3,A0A3S3PD82,A0A0L0TEV1,A0A1S3J512,G0QTT2,A0A1J1HRI1,C4V9J2,Q9JMB7,A0A075AN09,Q5TW24,U5HIG6,A0A401PRI6,Q96J94,A0A2B4RHN2,G2QEV0,A0A397UU01,A0A2T7PFL8,K7ISV0,A0A024FT57,H3HCL6,A0A0G4IME3,E9FUN9,A0A1S3CYL5,D7FQK3,A0A1Y1YHC8,T1GSU4,F4S231,A0A1D8PMK0,A0A2G5B1D8,Q5BD61,A0A1C7M8P2,A0A4D8YSQ3,A0A158PJG6,J9JZ66,A0A0C2XG51,A0A158QZT6,T0SAU8,R7YY92,A0A3S1A0C3,A0A074YJ47,A0A2K1J482,A0A1Q3ENA6,O04379,A0A371I3C8,M8AEW7,A8P0D4,A0A2K3NY65,F4NYW7,A0A409Y6G2,A0A0L0HAB7,D8PZT7,A0A1D1W4K0,A7RQ46,W4YU94,A7BJS5,D8SNM6,A0A1J8PPA3,X1WG39,M5FQK2,Q69VD5,A0A2R6NSC2,A0A0D8XL16,A0A016WPN3,Q9QZ81,G5EES3,A0A0K0EFP6,Q8CJG0,A0A1D5NTU6,V2WTL2,A0A0V0YLH8,A0A139WDH0,A0A0R3W9Q7,H3DS31,A0A1Y1HWP2,G4T5G9,B7QCC4,A0A0B2UV00,M7BCJ9,E9GN30,Q7PZ41,A0A077Z361,R7U9I3,A0A1X7V1N5,A0A0K0JDP1,A0A0N4UKJ1,A0A498N3A3,A0A3M0IQP5,A0A0L8GBV4,Q32KD4,A0A1J1JBJ0,E0W4C3,A0A482XDA9,A0A3P7EJD6,J9K2Z4,A0A2J7Q8V4,T1IBM6,V3ZRX0,A0A210QKF7,A0A423TSS1,K1PT78,A0A267E8R7,A0A1D2N447,A0A226D7A9,F6YK55,T1KTE4,A0A2C9JGZ6,A0A1V9X9F0,K5X5Z7,A0A3Q0KUG5,T1FY40,1YVU,1Z26,3DLB,5AWH,5G5T,5I4A,6QZK,E8N0K8,A0A1I7IXT4,A0A2W1JZ37,A0A2S7WBN3,A0A328VKE4,A0A420DFE6,E0ST67,A0A4V1VDY2,A0A368P5I0,C4L1M1,A0A4R1RMM2,A0A1Y2RDH8,Q11QW7,A0A1M5ZSR3,A0A0K8QX04,A0A0M2PXX3,A0A1I3LMA1,K9TPA9,A0A1L3JHM3,A0A1W6MIP2,A0A1C0UUC4,A0A2U2J9E0,A0A2Z6E1D5,A0A0F4NXW8,B1XJG0,A0A326U7G5,A0A3D8L290,H1KXR6,A0A1Q4R485,K9U8J6,A0A097QRL6,K9RC91,A0A0D8ZUC0,A0A139XGN8,A0A1T4Y3A2,Q5P0R2,B6YTQ5,A0A0B0H9B4,A0YYT3,A0A2T1EFY0,G6FTN0,R6KUL9,A0A433NB65,A0A1Z4L0A1,K9UQR0,A0A2T1G8M7,K9VUN0,B7GJX9,K9ZDE3,B0JXD6,A0A2T1LS63,A0A1Z4K1Y3,A0A2Z6E0R7,A0A1N6SSK9,A0A0P4UVI8,A0A0V7ZCG4,A0A1J0AGK2,K9PFF9,A0A2G9DT08,K9UEV4,Q9L1X1,A0A060HNJ0,A0A235B542,R5XQK4,A0A1H3LE92,A0A496APJ8,A0A1V9G9U4,S7VLM7,A0A1A5X8H4,A0A1I2T6Q1,A0A1R3T9N6,A0A0Q2M2Z1,H8KXJ0,D3S0S6,A0A2D1U4H7,I3TE64,A0A0B7I4Z6,A0LL61,Q8DKB1,A0A139WY18,A0A1J1EK56,A0A2T1E1K4,A0A1Q8ZD62,A0A4Q6XKV6,A0A1Z3HNN4,A0A239JE83,A0A2N4XBY2,Q53W94,R5JEI2,A0A0Q0ZC47,A0A2T0XH18,A0A1V4CHV0,A0A1K1RQP7,A0A2T1EKT1,A0A1N6LUI7,A0A0P0NGR6,A0A1X7IML5,A0A0A2LKJ7,K1L112,A0A0U3AL92,A0A1H3A054,E0UCX3,K9XZC6,A0A0C1VHB4,Q31N05,A0A0C5JKF3,R5NJJ8,A5D4D9,Q2JI93,A0A142Y7A9,A0A432MEQ5,A0A372DKU2,C1F5Q7,A0A4R3EV39,A0A1P8WP90,A0A222F7P0,A0A1C9VH88,A0A2T2YMB1,A0A329TD61,A0A101R2A0,A0A1E3XF49,A0A1U9ND56,A0A4R7BQC4,A0A1Q1FPH0,E0TGY3,A0A259TUP4,F6EYI8,A0A2S9Q9J0,A0A4Q2UIU6,A0A1H0LH25,A0A318LG42,H1YCU5,L0JS08,A0A1Q5ZS75,A0A345E7N0,M0AF24,A0A1W2A082,A0A1H3X247,A0A0C1XUA0,M0D2X3,A0A2R5G167,A0A346PK63,R7RTW6,A0A1H2RBI2,A0A1C3ZXN2,B9LVP8,M5RSF0,W0JW77,B7K585,F8D8G0,A0A343TL88,L0AJX6,A0A2A5QS34,A0A343JEE2,A0A3P3RGE5,A0A329TBQ3,A0A285N2A8,A0A0W1S8B8,A0A1V4C8L7,L9VRQ2,E4NRV1,A0A1I6HGN0,A0A1I0NI68,,",366,37
"1134","C.H5.12","C.H5.8",359,180,179,3.50346058348852,"4F1N,4F3T,4KRE,5GUH,5VM9,6KR6,6OON,7KX7,7SWF,A0A163JTZ6,A0A196SDB4,J9D5G4,Q389P5,C4LVV2,A8BCK6,A2DPV7,A0A0G4H2S4,T1H8B3,R1FDF0,S4RWI0,D2VMG4,A0A074TLL7,A0A0D1ZAJ4,Q1K660,F4PH46,A0A3M7S814,A0A164ZA52,A0A383WDW5,Q54G64,S7WCF7,I0YVB2,R7QGN7,C1DZY0,A0A2C5Z0M1,A0CB11,R9ACY5,D3BMP8,A0A1Z5TVE5,W7XD45,A0A1U7LLR0,A0A4S2MWZ7,K1VVQ6,A0A158P1R9,G7DVX0,V6R0U9,G4N9J3,E3KLI3,B7Q5I1,A0A1E3QC61,D5GGK8,S8ANP9,A0A139AUH8,L2GMR6,U4LBG4,A0A177URI1,O74957,A0A3N4IGK1,A6N7Y9,A0A0E9NDK5,T1KZ60,A0A250WXN5,A0A2G8JLH3,Q5KAT1,L2GUF2,W2T741,A0A1W0E4B5,A0A2J7QB22,S4RYE2,A0A2K3CW87,A0A388KES6,A0A226EFL3,A0A3S3PD82,A0A0L0TEV1,A0A1S3J512,G0QTT2,A0A1J1HRI1,C4V9J2,Q9JMB7,A0A075AN09,Q5TW24,U5HIG6,A0A401PRI6,Q96J94,A0A2B4RHN2,G2QEV0,A0A397UU01,A0A2T7PFL8,K7ISV0,A0A024FT57,H3HCL6,A0A0G4IME3,E9FUN9,A0A1S3CYL5,D7FQK3,A0A1Y1YHC8,T1GSU4,F4S231,A0A1D8PMK0,A0A2G5B1D8,Q5BD61,A0A1C7M8P2,A0A4D8YSQ3,A0A158PJG6,J9JZ66,A0A0C2XG51,A0A158QZT6,T0SAU8,R7YY92,A0A3S1A0C3,A0A074YJ47,A0A2K1J482,A0A1Q3ENA6,O04379,A0A371I3C8,M8AEW7,A8P0D4,A0A2K3NY65,F4NYW7,A0A409Y6G2,A0A0L0HAB7,D8PZT7,A0A1D1W4K0,A7RQ46,W4YU94,A7BJS5,D8SNM6,A0A1J8PPA3,X1WG39,M5FQK2,Q69VD5,A0A2R6NSC2,A0A0D8XL16,A0A016WPN3,Q9QZ81,G5EES3,A0A0K0EFP6,Q8CJG0,A0A1D5NTU6,V2WTL2,A0A0V0YLH8,A0A139WDH0,A0A0R3W9Q7,H3DS31,A0A1Y1HWP2,G4T5G9,B7QCC4,A0A0B2UV00,M7BCJ9,E9GN30,Q7PZ41,A0A077Z361,R7U9I3,A0A1X7V1N5,A0A0K0JDP1,A0A0N4UKJ1,A0A498N3A3,A0A3M0IQP5,A0A0L8GBV4,Q32KD4,A0A1J1JBJ0,E0W4C3,A0A482XDA9,A0A3P7EJD6,J9K2Z4,A0A2J7Q8V4,T1IBM6,V3ZRX0,A0A210QKF7,A0A423TSS1,K1PT78,A0A267E8R7,A0A1D2N447,A0A226D7A9,F6YK55,T1KTE4,A0A2C9JGZ6,A0A1V9X9F0,K5X5Z7,A0A3Q0KUG5,T1FY40,1YVU,1Z26,3DLB,5AWH,5G5T,5I4A,6QZK,E8N0K8,A0A1I7IXT4,A0A2W1JZ37,A0A2S7WBN3,A0A328VKE4,A0A420DFE6,E0ST67,A0A4V1VDY2,A0A368P5I0,C4L1M1,A0A4R1RMM2,A0A1Y2RDH8,Q11QW7,A0A1M5ZSR3,A0A0K8QX04,A0A0M2PXX3,A0A1I3LMA1,K9TPA9,A0A1L3JHM3,A0A1W6MIP2,A0A1C0UUC4,A0A2U2J9E0,A0A2Z6E1D5,A0A0F4NXW8,B1XJG0,A0A326U7G5,A0A3D8L290,H1KXR6,A0A1Q4R485,K9U8J6,A0A097QRL6,K9RC91,A0A0D8ZUC0,A0A139XGN8,A0A1T4Y3A2,Q5P0R2,B6YTQ5,A0A0B0H9B4,A0YYT3,A0A2T1EFY0,G6FTN0,R6KUL9,A0A433NB65,A0A1Z4L0A1,K9UQR0,A0A2T1G8M7,K9VUN0,B7GJX9,A0A0P6X5X2,K9ZDE3,B0JXD6,A0A2T1LS63,A0A1Z4K1Y3,A0A2Z6E0R7,A0A1N6SSK9,A0A0P4UVI8,A0A0V7ZCG4,A0A1J0AGK2,K9PFF9,A0A2G9DT08,K9UEV4,Q9L1X1,A0A060HNJ0,A0A235B542,R5XQK4,A0A1H3LE92,A0A496APJ8,A0A062U2W9,H0HWQ5,A0A1V9G9U4,A0A1I2ZGP1,A0A317EJY3,A0A1I2BD20,F8ERC7,S7VLM7,A0A1A5X8H4,A0A1I2T6Q1,A0A1R3T9N6,A0A0Q2M2Z1,H8KXJ0,D3S0S6,A0A2D1U4H7,I3TE64,A0A0B7I4Z6,A0LL61,Q8DKB1,A0A139WY18,A0A1J1EK56,A0A2T1E1K4,A0A1Q8ZD62,A0A4Q6XKV6,A0A1Z3HNN4,A0A239JE83,A0A2N4XBY2,Q53W94,R5JEI2,A0A0Q0ZC47,A0A2T0XH18,A0A1V4CHV0,A0A1K1RQP7,A0A2T1EKT1,A0A1N6LUI7,A0A0P0NGR6,A0A1X7IML5,A0A0A2LKJ7,K1L112,A0A0U3AL92,A0A1H3A054,E0UCX3,K9XZC6,A0A0C1VHB4,Q31N05,A0A0C5JKF3,R5NJJ8,A5D4D9,Q2JI93,A0A142Y7A9,A0A432MEQ5,A0A372DKU2,A0A3R7KLK4,C1F5Q7,A0A4R3EV39,A0A1P8WP90,A0A222F7P0,A0A1C9VH88,A0A2T2YMB1,A0A329TD61,A0A101R2A0,A0A1E3XF49,A0A1U9ND56,A0A4R7BQC4,A0A1H3DGN3,A0A1Q1FPH0,E0TGY3,A0A259TUP4,F6EYI8,A0A2S9Q9J0,A0A4Q2UIU6,A0A1H0LH25,A0A318LG42,H1YCU5,L0JS08,A0A1Q5ZS75,A0A345E7N0,M0AF24,A0A1W2A082,A0A1H3X247,A0A0C1XUA0,M0D2X3,A0A2R5G167,A0A346PK63,R7RTW6,A0A1H2RBI2,A0A1C3ZXN2,B9LVP8,M5RSF0,W0JW77,B7K585,F8D8G0,A0A343TL88,L0AJX6,A0A2A5QS34,A0A343JEE2,A0A3P3RGE5,A0A329TBQ3,A0A285N2A8,A0A0W1S8B8,A0A1V4C8L7,L9VRQ2,E4NRV1,A0A1I6HGN0,A0A1I0NI68,,",366,37
"1136","C.H5.14","C.L11.1",343,180,163,2.75519768234492,"4F1N,4F3T,4KRE,5GUH,5VM9,6KR6,6OON,7KX7,A0A163JTZ6,A0A196SDB4,J9D5G4,Q389P5,C4LVV2,A0A2P6N8X7,A8BCK6,A2DPV7,A0A0G4H2S4,T1H8B3,R1FDF0,S4RWI0,D2VMG4,A0A074TLL7,A0A0D1ZAJ4,Q1K660,F4PH46,A0A3M7S814,A0A164ZA52,A0A383WDW5,Q54G64,S7WCF7,I0YVB2,R7QGN7,C1DZY0,A0A2C5Z0M1,A0CB11,R9ACY5,D3BMP8,A0A1Z5TVE5,W7XD45,A0A1U7LLR0,A0A4S2MWZ7,K1VVQ6,A0A158P1R9,G7DVX0,V6R0U9,G4N9J3,E3KLI3,B7Q5I1,A0A1E3QC61,D5GGK8,S8ANP9,A0A139AUH8,L2GMR6,U4LBG4,A0A177URI1,O74957,A0A3N4IGK1,A6N7Y9,A0A0E9NDK5,T1KZ60,A0A250WXN5,A0A2G8JLH3,Q5KAT1,L2GUF2,W2T741,A0A1W0E4B5,A0A2J7QB22,S4RYE2,A0A2K3CW87,A0A388KES6,A0A226EFL3,A0A3S3PD82,A0A1S3J512,G0QTT2,A0A1J1HRI1,C4V9J2,Q9JMB7,A0A075AN09,Q5TW24,U5HIG6,A0A401PRI6,Q96J94,A0A2B4RHN2,G2QEV0,A0A397UU01,A0A2T7PFL8,K7ISV0,A0A024FT57,H3HCL6,A0A0G4IME3,E9FUN9,A0A1S3CYL5,D7FQK3,A0A1Y1YHC8,T1GSU4,F4S231,A0A1D8PMK0,A0A2G5B1D8,Q5BD61,A0A1C7M8P2,A0A4D8YSQ3,A0A158PJG6,J9JZ66,A0A0C2XG51,A0A158QZT6,A0A165QYQ9,T0SAU8,R7YY92,A0A3S1A0C3,A0A074YJ47,A0A2K1J482,A0A1Q3ENA6,O04379,A0A371I3C8,M8AEW7,A8P0D4,A0A2K3NY65,F4NYW7,A0A409Y6G2,A0A0L0HAB7,D8PZT7,A0A1D1W4K0,A7RQ46,W4YU94,A7BJS5,D8SNM6,A0A1J8PPA3,X1WG39,M5FQK2,Q69VD5,A0A2R6NSC2,A0A0D8XL16,A0A016WPN3,Q9QZ81,G5EES3,A0A0K0EFP6,Q8CJG0,A0A1D5NTU6,V2WTL2,A0A0V0YLH8,A0A139WDH0,A0A0R3W9Q7,H3DS31,A0A1Y1HWP2,G4T5G9,B7QCC4,A0A0B2UV00,M7BCJ9,E9GN30,Q7PZ41,A0A077Z361,R7U9I3,A0A1X7V1N5,A0A0K0JDP1,A0A0N4UKJ1,A0A498N3A3,A0A3M0IQP5,A0A0L8GBV4,Q32KD4,A0A1J1JBJ0,E0W4C3,A0A482XDA9,A0A3P7EJD6,J9K2Z4,A0A2J7Q8V4,T1IBM6,V3ZRX0,A0A210QKF7,A0A423TSS1,K1PT78,A0A267E8R7,A0A1D2N447,A0A226D7A9,F6YK55,T1KTE4,A0A2C9JGZ6,A0A1V9X9F0,K5X5Z7,A0A3Q0KUG5,T1FY40,1YVU,1Z26,3DLB,5AWH,5G5T,E8N0K8,A0A328VKE4,C4L1M1,A0A4R1RMM2,A0A1Y2RDH8,Q11QW7,A0A1M5ZSR3,A0A0K8QX04,A0A0M2PXX3,A0A1I3LMA1,K9TPA9,A0A1L3JHM3,A0A1W6MIP2,A0A1C0UUC4,A0A2U2J9E0,A0A2Z6E1D5,A0A0F4NXW8,A0A142XB92,B1XJG0,A0A326U7G5,A0A3D8L290,H1KXR6,A0A1Q4R485,K9U8J6,A0A097QRL6,K9RC91,A0A0D8ZUC0,A0A139XGN8,A0A1T4Y3A2,Q5P0R2,B6YTQ5,A0A0B0H9B4,A0YYT3,A0A2T1EFY0,G6FTN0,R6KUL9,A0A433NB65,A0A1Z4L0A1,K9UQR0,A0A2T1G8M7,K9VUN0,B7GJX9,K9ZDE3,B0JXD6,A0A2T1LS63,A0A1Z4K1Y3,A0A2Z6E0R7,A0A1N6SSK9,A0A0P4UVI8,A0A0V7ZCG4,A0A1J0AGK2,K9PFF9,A0A2G9DT08,K9UEV4,Q9L1X1,A0A060HNJ0,A0A235B542,R5XQK4,A0A1H3LE92,A0A496APJ8,A0A1V9G9U4,S7VLM7,A0A1A5X8H4,A0A1I2T6Q1,A0A1R3T9N6,A0A0Q2M2Z1,H8KXJ0,D3S0S6,A0A2D1U4H7,I3TE64,A0A0B7I4Z6,A0LL61,Q8DKB1,A0A139WY18,A0A1J1EK56,A0A2T1E1K4,A0A1Q8ZD62,A0A4Q6XKV6,A0A1Z3HNN4,A0A239JE83,A0A2N4XBY2,Q53W94,R5JEI2,A0A0Q0ZC47,A0A2T0XH18,A0A1V4CHV0,A0A1K1RQP7,A0A2T1EKT1,A0A1N6LUI7,A0A0P0NGR6,A0A1X7IML5,A0A0A2LKJ7,K1L112,A0A0U3AL92,A0A1H3A054,E0UCX3,K9XZC6,B9LVW4,A0A0C1VHB4,Q31N05,A0A0C5JKF3,R5NJJ8,A5D4D9,Q2JI93,A0A142Y7A9,A0A432MEQ5,A0A372DKU2,C1F5Q7,A0A4R3EV39,A0A1P8WP90,A0A222F7P0,A0A1C9VH88,A0A2T2YMB1,A0A329TD61,A0A101R2A0,A0A1E3XF49,A0A1U9ND56,A0A4R7BQC4,A0A1Q1FPH0,E0TGY3,A0A259TUP4,F6EYI8,A0A2S9Q9J0,A0A4Q2UIU6,A0A1H0LH25,A0A318LG42,H1YCU5,L0JS08,A0A1Q5ZS75,A0A345E7N0,M0AF24,A0A1W2A082,A0A1H3X247,A0A0C1XUA0,M0D2X3,A0A2R5G167,A0A346PK63,R7RTW6,A0A1H2RBI2,A0A1C3ZXN2,B9LVP8,M5RSF0,W0JW77,B7K585,F8D8G0,A0A343TL88,L0AJX6,A0A2A5QS34,A0A343JEE2,A0A3P3RGE5,A0A329TBQ3,A0A285N2A8,A0A0W1S8B8,A0A1V4C8L7,L9VRQ2,E4NRV1,A0A1I6HGN0,A0A1I0NI68,,",366,37
"1137","C.H5.15","C.L11.1",350,180,170,1.50800653594771,"4F1N,4F3T,4KRE,5GUH,5VM9,6KR6,6OON,7KX7,7SWF,A0A163JTZ6,A0A196SDB4,J9D5G4,Q389P5,C4LVV2,A0A2P6N8X7,A8BCK6,A0A0G4H2S4,T1H8B3,R1FDF0,S4RWI0,D2VMG4,A0A074TLL7,A0A0D1ZAJ4,Q1K660,F4PH46,A0A3M7S814,A0A164ZA52,A0A383WDW5,Q54G64,S7WCF7,I0YVB2,R7QGN7,C1DZY0,A0A2C5Z0M1,A0CB11,R9ACY5,D3BMP8,A0A1Z5TVE5,W7XD45,A0A1U7LLR0,A0A4S2MWZ7,K1VVQ6,A0A158P1R9,G7DVX0,V6R0U9,G4N9J3,E3KLI3,B7Q5I1,A0A1E3QC61,D5GGK8,S8ANP9,A0A139AUH8,L2GMR6,U4LBG4,A0A177URI1,O74957,A0A3N4IGK1,A6N7Y9,A0A0E9NDK5,T1KZ60,A0A250WXN5,A0A2G8JLH3,Q5KAT1,L2GUF2,W2T741,A0A1W0E4B5,A0A2J7QB22,S4RYE2,A0A2K3CW87,A0A388KES6,A0A226EFL3,A0A3S3PD82,A0A1S3J512,G0QTT2,A0A1J1HRI1,C4V9J2,Q9JMB7,A0A075AN09,Q5TW24,U5HIG6,A0A401PRI6,Q96J94,A0A2B4RHN2,G2QEV0,A0A397UU01,A0A2T7PFL8,K7ISV0,A0A024FT57,H3HCL6,A0A0G4IME3,E9FUN9,A0A1S3CYL5,D7FQK3,A0A1Y1YHC8,T1GSU4,F4S231,A0A1D8PMK0,A0A2G5B1D8,Q5BD61,A0A1C7M8P2,A0A4D8YSQ3,A0A158PJG6,J9JZ66,A0A0C2XG51,A0A158QZT6,A0A165QYQ9,T0SAU8,R7YY92,A0A3S1A0C3,A0A074YJ47,A0A2K1J482,A0A1Q3ENA6,O04379,A0A371I3C8,M8AEW7,A8P0D4,A0A2K3NY65,F4NYW7,A0A409Y6G2,A0A0L0HAB7,D8PZT7,A0A1D1W4K0,A7RQ46,W4YU94,A7BJS5,D8SNM6,A0A1J8PPA3,X1WG39,M5FQK2,Q69VD5,A0A2R6NSC2,A0A0D8XL16,A0A016WPN3,Q9QZ81,G5EES3,A0A0K0EFP6,Q8CJG0,A0A1D5NTU6,V2WTL2,A0A0V0YLH8,A0A139WDH0,A0A0R3W9Q7,H3DS31,A0A1Y1HWP2,G4T5G9,B7QCC4,A0A0B2UV00,M7BCJ9,E9GN30,Q7PZ41,A0A077Z361,R7U9I3,A0A1X7V1N5,A0A0K0JDP1,A0A0N4UKJ1,A0A498N3A3,A0A3M0IQP5,A0A0L8GBV4,Q32KD4,A0A1J1JBJ0,E0W4C3,A0A482XDA9,A0A3P7EJD6,J9K2Z4,A0A2J7Q8V4,T1IBM6,V3ZRX0,A0A210QKF7,A0A423TSS1,K1PT78,A0A267E8R7,A0A1D2N447,A0A226D7A9,F6YK55,T1KTE4,A0A2C9JGZ6,A0A1V9X9F0,K5X5Z7,A0A3Q0KUG5,T1FY40,1YVU,1Z26,3DLB,5AWH,5G5T,5I4A,E8N0K8,A0A1I7IXT4,A0A2W1JZ37,A0A2S7WBN3,A0A328VKE4,A0A420DFE6,A0A4V1VDY2,A0A368P5I0,C4L1M1,A0A4R1RMM2,A0A1Y2RDH8,Q11QW7,A0A1M5ZSR3,A0A0K8QX04,A0A0M2PXX3,A0A1I3LMA1,K9TPA9,A0A1L3JHM3,A0A1W6MIP2,A0A1C0UUC4,A0A2U2J9E0,A0A2Z6E1D5,A0A0F4NXW8,A0A142XB92,B1XJG0,A0A326U7G5,A0A3D8L290,H1KXR6,A0A1Q4R485,K9U8J6,A0A097QRL6,K9RC91,A0A0D8ZUC0,A0A139XGN8,A0A1T4Y3A2,Q5P0R2,B6YTQ5,A0A0B0H9B4,A0YYT3,A0A2T1EFY0,G6FTN0,R6KUL9,A0A433NB65,A0A1Z4L0A1,K9UQR0,A0A2T1G8M7,K9VUN0,B7GJX9,K9ZDE3,B0JXD6,A0A2T1LS63,A0A1Z4K1Y3,A0A2Z6E0R7,A0A1N6SSK9,A0A0P4UVI8,A0A0V7ZCG4,A0A1J0AGK2,K9PFF9,A0A2G9DT08,K9UEV4,Q9L1X1,A0A060HNJ0,A0A235B542,R5XQK4,A0A1H3LE92,A0A496APJ8,A0A1V9G9U4,S7VLM7,A0A1A5X8H4,A0A1I2T6Q1,A0A1R3T9N6,A0A0Q2M2Z1,H8KXJ0,D3S0S6,A0A2D1U4H7,I3TE64,A0A0B7I4Z6,A0LL61,Q8DKB1,A0A139WY18,A0A1J1EK56,A0A2T1E1K4,A0A1Q8ZD62,A0A4Q6XKV6,A0A1Z3HNN4,A0A239JE83,A0A2N4XBY2,Q53W94,R5JEI2,A0A0Q0ZC47,A0A2T0XH18,A0A1V4CHV0,A0A1K1RQP7,A0A2T1EKT1,A0A1N6LUI7,A0A0P0NGR6,A0A1X7IML5,A0A0A2LKJ7,K1L112,A0A0U3AL92,A0A1H3A054,E0UCX3,K9XZC6,B9LVW4,A0A0C1VHB4,Q31N05,A0A0C5JKF3,R5NJJ8,A5D4D9,Q2JI93,A0A142Y7A9,A0A432MEQ5,A0A372DKU2,C1F5Q7,A0A4R3EV39,A0A1P8WP90,A0A222F7P0,A0A1C9VH88,A0A2T2YMB1,A0A329TD61,A0A101R2A0,A0A1E3XF49,A0A1U9ND56,A0A4R7BQC4,A0A1Q1FPH0,E0TGY3,A0A259TUP4,F6EYI8,A0A2S9Q9J0,A0A4Q2UIU6,A0A1H0LH25,A0A318LG42,H1YCU5,L0JS08,A0A1Q5ZS75,A0A345E7N0,M0AF24,A0A1W2A082,A0A1H3X247,A0A0C1XUA0,M0D2X3,A0A2R5G167,A0A346PK63,R7RTW6,A0A1H2RBI2,A0A1C3ZXN2,B9LVP8,M5RSF0,W0JW77,B7K585,F8D8G0,A0A343TL88,L0AJX6,A0A2A5QS34,A0A343JEE2,A0A3P3RGE5,A0A329TBQ3,A0A285N2A8,A0A0W1S8B8,A0A1V4C8L7,L9VRQ2,E4NRV1,A0A1I6HGN0,A0A1I0NI68,,",366,37
"1138","C.H5.15","C.S6.2",334,180,154,2.88679653679654,"4F1N,4F3T,4KRE,5GUH,5VM9,6KR6,6OON,7KX7,7SWF,A0A163JTZ6,A0A196SDB4,J9D5G4,Q389P5,C4LVV2,A8BCK6,A2DPV7,A0A0G4H2S4,T1H8B3,S4RWI0,D2VMG4,A0A074TLL7,A0A0D1ZAJ4,Q1K660,F4PH46,A0A3M7S814,A0A164ZA52,A0A383WDW5,Q54G64,S7WCF7,I0YVB2,R7QGN7,C1DZY0,A0A2C5Z0M1,A0CB11,R9ACY5,D3BMP8,A0A1Z5TVE5,W7XD45,A0A1U7LLR0,A0A4S2MWZ7,K1VVQ6,A0A158P1R9,G7DVX0,V6R0U9,G4N9J3,E3KLI3,B7Q5I1,A0A1E3QC61,D5GGK8,S8ANP9,A0A139AUH8,L2GMR6,U4LBG4,A0A177URI1,O74957,A0A3N4IGK1,A6N7Y9,A0A0E9NDK5,T1KZ60,A0A250WXN5,A0A2G8JLH3,Q5KAT1,L2GUF2,W2T741,A0A1W0E4B5,A0A2J7QB22,S4RYE2,A0A2K3CW87,A0A388KES6,A0A226EFL3,A0A3S3PD82,A0A0L0TEV1,A0A1S3J512,G0QTT2,A0A1J1HRI1,C4V9J2,Q9JMB7,A0A075AN09,Q5TW24,U5HIG6,A0A401PRI6,Q96J94,A0A2B4RHN2,G2QEV0,A0A397UU01,A0A2T7PFL8,K7ISV0,A0A024FT57,H3HCL6,A0A0G4IME3,E9FUN9,A0A1S3CYL5,D7FQK3,A0A1Y1YHC8,T1GSU4,F4S231,A0A1D8PMK0,A0A2G5B1D8,Q5BD61,A0A1C7M8P2,A0A4D8YSQ3,A0A158PJG6,J9JZ66,A0A0C2XG51,A0A158QZT6,A0A165QYQ9,T0SAU8,R7YY92,A0A3S1A0C3,A0A074YJ47,A0A2K1J482,A0A1Q3ENA6,O04379,A0A371I3C8,M8AEW7,A8P0D4,A0A2K3NY65,F4NYW7,A0A409Y6G2,A0A0L0HAB7,D8PZT7,A0A1D1W4K0,A7RQ46,W4YU94,A7BJS5,D8SNM6,A0A1J8PPA3,X1WG39,M5FQK2,Q69VD5,A0A2R6NSC2,A0A0D8XL16,A0A016WPN3,Q9QZ81,G5EES3,A0A0K0EFP6,Q8CJG0,A0A1D5NTU6,V2WTL2,A0A0V0YLH8,A0A139WDH0,A0A0R3W9Q7,H3DS31,A0A1Y1HWP2,G4T5G9,B7QCC4,A0A0B2UV00,M7BCJ9,E9GN30,Q7PZ41,A0A077Z361,R7U9I3,A0A1X7V1N5,A0A0K0JDP1,A0A0N4UKJ1,A0A498N3A3,A0A3M0IQP5,A0A0L8GBV4,Q32KD4,A0A1J1JBJ0,E0W4C3,A0A482XDA9,A0A3P7EJD6,J9K2Z4,A0A2J7Q8V4,T1IBM6,V3ZRX0,A0A210QKF7,A0A423TSS1,K1PT78,A0A267E8R7,A0A1D2N447,A0A226D7A9,F6YK55,T1KTE4,A0A2C9JGZ6,A0A1V9X9F0,K5X5Z7,A0A3Q0KUG5,T1FY40,1YVU,1Z26,3DLB,5AWH,5G5T,6QZK,E8N0K8,A0A1I7IXT4,A0A2W1JZ37,A0A2S7WBN3,A0A328VKE4,A0A420DFE6,A0A4V1VDY2,A0A368P5I0,C4L1M1,A0A4R1RMM2,A0A1Y2RDH8,Q11QW7,A0A1M5ZSR3,A0A0K8QX04,A0A0M2PXX3,A0A1I3LMA1,K9TPA9,A0A1L3JHM3,A0A1W6MIP2,A0A1C0UUC4,A0A2U2J9E0,A0A2Z6E1D5,A0A0F4NXW8,A0A142XB92,B1XJG0,A0A326U7G5,A0A3D8L290,H1KXR6,A0A1Q4R485,K9U8J6,K9RC91,A0A0D8ZUC0,A0A139XGN8,A0A1T4Y3A2,Q5P0R2,A0A0B0H9B4,A0YYT3,A0A2T1EFY0,G6FTN0,R6KUL9,A0A433NB65,A0A1Z4L0A1,K9UQR0,A0A2T1G8M7,K9VUN0,B7GJX9,K9ZDE3,B0JXD6,A0A2T1LS63,A0A1Z4K1Y3,A0A2Z6E0R7,A0A1N6SSK9,A0A0P4UVI8,A0A0V7ZCG4,A0A1J0AGK2,K9PFF9,A0A2G9DT08,K9UEV4,Q9L1X1,A0A060HNJ0,A0A235B542,R5XQK4,A0A496APJ8,A0A1V9G9U4,S7VLM7,A0A1A5X8H4,A0A1I2T6Q1,A0A1R3T9N6,A0A0Q2M2Z1,H8KXJ0,D3S0S6,A0A2D1U4H7,I3TE64,A0A0B7I4Z6,A0LL61,Q8DKB1,A0A139WY18,A0A1J1EK56,A0A2T1E1K4,A0A1Q8ZD62,A0A4Q6XKV6,A0A1Z3HNN4,A0A239JE83,A0A2N4XBY2,Q53W94,R5JEI2,A0A0Q0ZC47,A0A2T0XH18,A0A1V4CHV0,A0A1K1RQP7,A0A2T1EKT1,A0A1N6LUI7,A0A0P0NGR6,A0A1X7IML5,A0A0A2LKJ7,K1L112,A0A0U3AL92,A0A1H3A054,E0UCX3,K9XZC6,A0A0C1VHB4,Q31N05,A0A0C5JKF3,R5NJJ8,A5D4D9,Q2JI93,A0A142Y7A9,A0A432MEQ5,A0A372DKU2,C1F5Q7,A0A4R3EV39,A0A1P8WP90,A0A222F7P0,A0A1C9VH88,A0A2T2YMB1,A0A329TD61,A0A101R2A0,A0A1U9ND56,A0A4R7BQC4,A0A1Q1FPH0,E0TGY3,A0A259TUP4,F6EYI8,A0A2S9Q9J0,A0A4Q2UIU6,A0A1H0LH25,A0A318LG42,A0A345E7N0,A0A1W2A082,A0A1H3X247,A0A0C1XUA0,A0A2R5G167,A0A346PK63,R7RTW6,B9LVP8,M5RSF0,B7K585,F8D8G0,A0A343TL88,A0A343JEE2,A0A3P3RGE5,A0A329TBQ3,A0A0W1S8B8,A0A1V4C8L7,L9VRQ2,E4NRV1,A0A1I6HGN0,A0A1I0NI68,,",366,37
"1140","C.H5.4","C.H5.7",342,180,162,2.51697530864198,"4F1N,4F3T,4KRE,5GUH,5VM9,6KR6,6OON,7KX7,7SWF,A0A163JTZ6,A0A196SDB4,J9D5G4,Q389P5,C4LVV2,A0A2P6N8X7,A8BCK6,A2DPV7,A0A0G4H2S4,T1H8B3,S4RWI0,D2VMG4,A0A074TLL7,A0A0D1ZAJ4,Q1K660,F4PH46,A0A3M7S814,A0A164ZA52,A0A383WDW5,Q54G64,S7WCF7,I0YVB2,R7QGN7,C1DZY0,A0A2C5Z0M1,A0CB11,R9ACY5,D3BMP8,A0A1Z5TVE5,W7XD45,A0A1U7LLR0,A0A4S2MWZ7,K1VVQ6,A0A158P1R9,G7DVX0,V6R0U9,G4N9J3,E3KLI3,B7Q5I1,A0A1E3QC61,D5GGK8,S8ANP9,A0A139AUH8,L2GMR6,U4LBG4,A0A177URI1,O74957,A0A3N4IGK1,A6N7Y9,A0A0E9NDK5,T1KZ60,A0A250WXN5,A0A2G8JLH3,Q5KAT1,L2GUF2,W2T741,A0A1W0E4B5,A0A2J7QB22,S4RYE2,A0A2K3CW87,A0A388KES6,A0A226EFL3,A0A3S3PD82,A0A0L0TEV1,A0A1S3J512,G0QTT2,A0A1J1HRI1,C4V9J2,Q9JMB7,A0A075AN09,Q5TW24,U5HIG6,A0A401PRI6,Q96J94,A0A2B4RHN2,G2QEV0,A0A397UU01,A0A2T7PFL8,K7ISV0,A0A024FT57,H3HCL6,A0A0G4IME3,E9FUN9,A0A1S3CYL5,D7FQK3,A0A1Y1YHC8,T1GSU4,F4S231,A0A1D8PMK0,A0A2G5B1D8,Q5BD61,A0A1C7M8P2,A0A4D8YSQ3,A0A158PJG6,J9JZ66,A0A0C2XG51,A0A158QZT6,T0SAU8,R7YY92,A0A3S1A0C3,A0A074YJ47,A0A2K1J482,A0A1Q3ENA6,O04379,A0A371I3C8,M8AEW7,A8P0D4,A0A2K3NY65,F4NYW7,A0A409Y6G2,A0A0L0HAB7,D8PZT7,A0A1D1W4K0,A7RQ46,W4YU94,A7BJS5,D8SNM6,A0A1J8PPA3,X1WG39,M5FQK2,Q69VD5,A0A2R6NSC2,A0A0D8XL16,A0A016WPN3,Q9QZ81,G5EES3,A0A0K0EFP6,Q8CJG0,A0A1D5NTU6,V2WTL2,A0A0V0YLH8,A0A139WDH0,A0A0R3W9Q7,H3DS31,A0A1Y1HWP2,G4T5G9,B7QCC4,A0A0B2UV00,M7BCJ9,E9GN30,Q7PZ41,A0A077Z361,R7U9I3,A0A1X7V1N5,A0A0K0JDP1,A0A0N4UKJ1,A0A498N3A3,A0A3M0IQP5,A0A0L8GBV4,Q32KD4,A0A1J1JBJ0,E0W4C3,A0A482XDA9,A0A3P7EJD6,J9K2Z4,A0A2J7Q8V4,T1IBM6,V3ZRX0,A0A210QKF7,A0A423TSS1,K1PT78,A0A267E8R7,A0A1D2N447,A0A226D7A9,F6YK55,T1KTE4,A0A2C9JGZ6,A0A1V9X9F0,K5X5Z7,A0A3Q0KUG5,T1FY40,1YVU,1Z26,3DLB,5AWH,5G5T,5I4A,6QZK,7R8K,E8N0K8,A0A1I7IXT4,A0A2W1JZ37,A0A2S7WBN3,A0A328VKE4,A0A420DFE6,A0A4V1VDY2,A0A368P5I0,A0A4R1RMM2,A0A1Y2RDH8,Q11QW7,A0A1M5ZSR3,A0A0K8QX04,A0A0M2PXX3,A0A1I3LMA1,K9TPA9,A0A1L3JHM3,A0A1W6MIP2,A0A1C0UUC4,A0A2U2J9E0,A0A2Z6E1D5,A0A0F4NXW8,L8D0R3,B1XJG0,A0A326U7G5,A0A3D8L290,A0A1Q4R485,K9U8J6,K9RC91,A0A0D8ZUC0,A0A139XGN8,A0A1T4Y3A2,Q5P0R2,A0YYT3,A0A2T1EFY0,G6FTN0,R6KUL9,A0A433NB65,A0A1Z4L0A1,K9UQR0,A0A2T1G8M7,K9VUN0,K9ZDE3,B0JXD6,A0A2T1LS63,A0A1Z4K1Y3,A0A2Z6E0R7,A0A0P4UVI8,A0A0V7ZCG4,A0A1J0AGK2,K9PFF9,A0A2G9DT08,K9UEV4,Q9L1X1,A0A235B542,R5XQK4,A0A496APJ8,A0A062U2W9,H0HWQ5,A0A1V9G9U4,A0A1I2ZGP1,A0A317EJY3,A0A1I2BD20,F8ERC7,S7VLM7,A0A1A5X8H4,A0A1I2T6Q1,A0A1R3T9N6,A0A0Q2M2Z1,H8KXJ0,D3S0S6,A0A2D1U4H7,A0A0B7I4Z6,A0LL61,Q8DKB1,A0A139WY18,A0A1J1EK56,A0A2T1E1K4,A0A1Q8ZD62,A0A4Q6XKV6,A0A1Z3HNN4,A0A239JE83,A0A2N4XBY2,R5JEI2,A0A0Q0ZC47,A0A1V4CHV0,A0A1K1RQP7,A0A2T1EKT1,A0A1N6LUI7,A0A0P0NGR6,A0A1X7IML5,A0A0A2LKJ7,A0A0U3AL92,A0A1H3A054,E0UCX3,K9XZC6,A0A0C1VHB4,Q31N05,A0A0C5JKF3,R5NJJ8,A5D4D9,Q2JI93,A0A142Y7A9,A0A432MEQ5,A0A372DKU2,A0A3R7KLK4,C1F5Q7,A0A4R3EV39,A0A1P8WP90,A0A222F7P0,A0A1C9VH88,A0A2T2YMB1,A0A329TD61,A0A101R2A0,A0A1E3XF49,A0A1U9ND56,A0A4R7BQC4,A0A1H3DGN3,A0A1Q1FPH0,E0TGY3,A0A259TUP4,F6EYI8,A0A2S9Q9J0,A0A4Q2UIU6,A0A1H0LH25,A0A318LG42,H1YCU5,L0JS08,A0A1Q5ZS75,A0A345E7N0,A0A1W2A082,A0A1H3X247,A0A0C1XUA0,A0A2R5G167,A0A346PK63,R7RTW6,A0A1H2RBI2,A0A1C3ZXN2,B9LVP8,M5RSF0,B7K585,A0A343TL88,L0AJX6,A0A2A5QS34,A0A343JEE2,A0A3P3RGE5,A0A329TBQ3,A0A285N2A8,A0A0W1S8B8,A0A1V4C8L7,L9VRQ2,E4NRV1,A0A1I6HGN0,A0A1I0NI68,,",366,37
"1141","C.H5.4","C.H5.8",348,180,168,3.525,"4F1N,4F3T,4KRE,5GUH,5VM9,6KR6,6OON,7KX7,7SWF,A0A163JTZ6,A0A0N4X8S8,A0A196SDB4,J9D5G4,Q389P5,C4LVV2,A8BCK6,A2DPV7,A0A0G4H2S4,T1H8B3,S4RWI0,D2VMG4,A0A074TLL7,A0A0D1ZAJ4,Q1K660,F4PH46,A0A3M7S814,A0A164ZA52,A0A383WDW5,Q54G64,S7WCF7,I0YVB2,R7QGN7,C1DZY0,A0A2C5Z0M1,A0CB11,R9ACY5,D3BMP8,A0A1Z5TVE5,W7XD45,A0A1U7LLR0,A0A4S2MWZ7,K1VVQ6,A0A158P1R9,G7DVX0,V6R0U9,G4N9J3,E3KLI3,B7Q5I1,A0A1E3QC61,D5GGK8,S8ANP9,A0A139AUH8,L2GMR6,U4LBG4,A0A177URI1,O74957,A0A3N4IGK1,A6N7Y9,A0A0E9NDK5,T1KZ60,A0A250WXN5,A0A2G8JLH3,Q5KAT1,L2GUF2,W2T741,A0A1W0E4B5,A0A2J7QB22,S4RYE2,A0A2K3CW87,A0A388KES6,A0A226EFL3,A0A3S3PD82,A0A0L0TEV1,A0A1S3J512,G0QTT2,A0A1J1HRI1,C4V9J2,Q9JMB7,A0A075AN09,Q5TW24,U5HIG6,A0A401PRI6,Q96J94,A0A2B4RHN2,G2QEV0,A0A397UU01,A0A2T7PFL8,K7ISV0,A0A024FT57,H3HCL6,A0A0G4IME3,E9FUN9,A0A1S3CYL5,D7FQK3,A0A1Y1YHC8,T1GSU4,F4S231,A0A1D8PMK0,A0A2G5B1D8,Q5BD61,A0A1C7M8P2,A0A4D8YSQ3,A0A158PJG6,J9JZ66,A0A0C2XG51,A0A158QZT6,T0SAU8,R7YY92,A0A3S1A0C3,A0A074YJ47,A0A2K1J482,A0A1Q3ENA6,O04379,A0A371I3C8,M8AEW7,A8P0D4,A0A2K3NY65,F4NYW7,A0A409Y6G2,A0A0L0HAB7,D8PZT7,A0A1D1W4K0,A7RQ46,W4YU94,A7BJS5,D8SNM6,A0A1J8PPA3,X1WG39,M5FQK2,Q69VD5,A0A2R6NSC2,A0A0D8XL16,A0A016WPN3,Q9QZ81,G5EES3,A0A0K0EFP6,Q8CJG0,A0A1D5NTU6,V2WTL2,A0A0V0YLH8,A0A139WDH0,A0A0R3W9Q7,H3DS31,A0A1Y1HWP2,G4T5G9,B7QCC4,A0A0B2UV00,M7BCJ9,E9GN30,Q7PZ41,A0A077Z361,R7U9I3,A0A1X7V1N5,A0A0K0JDP1,A0A0N4UKJ1,A0A498N3A3,A0A3M0IQP5,A0A0L8GBV4,Q32KD4,A0A1J1JBJ0,E0W4C3,A0A482XDA9,A0A3P7EJD6,J9K2Z4,A0A2J7Q8V4,T1IBM6,V3ZRX0,A0A210QKF7,A0A423TSS1,K1PT78,A0A267E8R7,A0A1D2N447,A0A226D7A9,F6YK55,T1KTE4,A0A2C9JGZ6,A0A1V9X9F0,K5X5Z7,A0A3Q0KUG5,T1FY40,1YVU,1Z26,3DLB,5AWH,5G5T,5I4A,6QZK,7R8K,E8N0K8,A0A1I7IXT4,A0A2W1JZ37,A0A2S7WBN3,A0A328VKE4,A0A420DFE6,A0A4V1VDY2,A0A368P5I0,A0A4R1RMM2,A0A1Y2RDH8,Q11QW7,A0A1M5ZSR3,A0A0K8QX04,A0A0M2PXX3,A0A1I3LMA1,K9TPA9,A0A1L3JHM3,A0A1W6MIP2,A0A1C0UUC4,A0A2U2J9E0,A0A2Z6E1D5,A0A0F4NXW8,L8D0R3,B1XJG0,A0A326U7G5,A0A1Q4R485,K9U8J6,K9RC91,A0A0D8ZUC0,A0A139XGN8,A0A1T4Y3A2,Q5P0R2,A0YYT3,A0A2T1EFY0,G6FTN0,R6KUL9,A0A433NB65,A0A1Z4L0A1,K9UQR0,A0A2T1G8M7,K9VUN0,K9ZDE3,B0JXD6,A0A2T1LS63,A0A1Z4K1Y3,A0A2Z6E0R7,A0A0P4UVI8,A0A0V7ZCG4,A0A1J0AGK2,K9PFF9,A0A2G9DT08,K9UEV4,Q9L1X1,A0A235B542,R5XQK4,A0A496APJ8,A0A062U2W9,H0HWQ5,A0A1V9G9U4,A0A1I2ZGP1,A0A317EJY3,A0A1I2BD20,F8ERC7,S7VLM7,A0A1A5X8H4,A0A1I2T6Q1,A0A1R3T9N6,A0A0Q2M2Z1,H8KXJ0,D3S0S6,A0A2D1U4H7,I3TE64,A0A0B7I4Z6,A0LL61,Q8DKB1,A0A139WY18,A0A1J1EK56,A0A2T1E1K4,A0A1Q8ZD62,A0A4Q6XKV6,A0A1Z3HNN4,A0A239JE83,A0A2N4XBY2,Q53W94,R5JEI2,A0A0Q0ZC47,A0A2T0XH18,A0A1V4CHV0,A0A1K1RQP7,A0A2T1EKT1,A0A1N6LUI7,A0A0P0NGR6,A0A1X7IML5,A0A0A2LKJ7,K1L112,A0A0U3AL92,A0A1H3A054,E0UCX3,K9XZC6,A0A0C1VHB4,Q31N05,A0A0C5JKF3,R5NJJ8,A5D4D9,Q2JI93,A0A142Y7A9,A0A432MEQ5,A0A372DKU2,A0A3R7KLK4,C1F5Q7,A0A4R3EV39,A0A1P8WP90,A0A222F7P0,A0A1C9VH88,A0A2T2YMB1,A0A329TD61,A0A101R2A0,A0A1E3XF49,A0A1U9ND56,A0A4R7BQC4,A0A1H3DGN3,A0A1Q1FPH0,E0TGY3,A0A259TUP4,F6EYI8,A0A2S9Q9J0,A0A4Q2UIU6,A0A1H0LH25,A0A318LG42,H1YCU5,L0JS08,A0A1Q5ZS75,A0A345E7N0,M0AF24,A0A1W2A082,A0A1H3X247,A0A0C1XUA0,M0D2X3,A0A2R5G167,A0A346PK63,R7RTW6,A0A1H2RBI2,A0A1C3ZXN2,B9LVP8,M5RSF0,B7K585,F8D8G0,A0A343TL88,L0AJX6,A0A2A5QS34,A0A343JEE2,A0A3P3RGE5,A0A329TBQ3,A0A285N2A8,A0A0W1S8B8,A0A1V4C8L7,L9VRQ2,E4NRV1,A0A1I6HGN0,A0A1I0NI68,,",366,37
"1142","C.H5.5","C.H5.8",359,180,179,3.39851024208566,"4F1N,4F3T,4KRE,5GUH,5VM9,6KR6,6OON,7KX7,7SWF,A0A163JTZ6,A0A0N4X8S8,A0A196SDB4,J9D5G4,Q389P5,C4LVV2,A8BCK6,A2DPV7,A0A0G4H2S4,T1H8B3,S4RWI0,D2VMG4,A0A074TLL7,A0A0D1ZAJ4,Q1K660,F4PH46,A0A3M7S814,A0A164ZA52,A0A383WDW5,Q54G64,S7WCF7,I0YVB2,R7QGN7,C1DZY0,A0A2C5Z0M1,A0CB11,R9ACY5,D3BMP8,A0A1Z5TVE5,W7XD45,A0A1U7LLR0,A0A4S2MWZ7,K1VVQ6,A0A158P1R9,G7DVX0,V6R0U9,G4N9J3,E3KLI3,B7Q5I1,A0A1E3QC61,D5GGK8,S8ANP9,A0A139AUH8,L2GMR6,U4LBG4,A0A177URI1,O74957,A0A3N4IGK1,A6N7Y9,A0A0E9NDK5,T1KZ60,A0A250WXN5,A0A2G8JLH3,Q5KAT1,L2GUF2,W2T741,A0A1W0E4B5,A0A2J7QB22,S4RYE2,A0A2K3CW87,A0A388KES6,A0A226EFL3,A0A3S3PD82,A0A0L0TEV1,A0A1S3J512,G0QTT2,A0A1J1HRI1,C4V9J2,Q9JMB7,A0A075AN09,Q5TW24,U5HIG6,A0A401PRI6,Q96J94,A0A2B4RHN2,G2QEV0,A0A397UU01,A0A2T7PFL8,K7ISV0,A0A024FT57,H3HCL6,A0A0G4IME3,E9FUN9,A0A1S3CYL5,D7FQK3,A0A1Y1YHC8,T1GSU4,F4S231,A0A1D8PMK0,A0A2G5B1D8,Q5BD61,A0A1C7M8P2,A0A4D8YSQ3,A0A158PJG6,J9JZ66,A0A0C2XG51,A0A158QZT6,T0SAU8,R7YY92,A0A3S1A0C3,A0A074YJ47,A0A2K1J482,A0A1Q3ENA6,O04379,A0A371I3C8,M8AEW7,A8P0D4,A0A2K3NY65,F4NYW7,A0A409Y6G2,A0A0L0HAB7,D8PZT7,A0A1D1W4K0,A7RQ46,W4YU94,A7BJS5,D8SNM6,A0A1J8PPA3,X1WG39,M5FQK2,Q69VD5,A0A2R6NSC2,A0A0D8XL16,A0A016WPN3,Q9QZ81,G5EES3,A0A0K0EFP6,Q8CJG0,A0A1D5NTU6,V2WTL2,A0A0V0YLH8,A0A139WDH0,A0A0R3W9Q7,H3DS31,A0A1Y1HWP2,G4T5G9,B7QCC4,A0A0B2UV00,M7BCJ9,E9GN30,Q7PZ41,A0A077Z361,R7U9I3,A0A1X7V1N5,A0A0K0JDP1,A0A0N4UKJ1,A0A498N3A3,A0A3M0IQP5,A0A0L8GBV4,Q32KD4,A0A1J1JBJ0,E0W4C3,A0A482XDA9,A0A3P7EJD6,J9K2Z4,A0A2J7Q8V4,T1IBM6,V3ZRX0,A0A210QKF7,A0A423TSS1,K1PT78,A0A267E8R7,A0A1D2N447,A0A226D7A9,F6YK55,T1KTE4,A0A2C9JGZ6,A0A1V9X9F0,K5X5Z7,A0A3Q0KUG5,T1FY40,1YVU,1Z26,3DLB,5G5T,5I4A,6QZK,7R8K,E8N0K8,A0A1I7IXT4,A0A2W1JZ37,A0A2S7WBN3,A0A328VKE4,A0A420DFE6,E0ST67,A0A4V1VDY2,A0A368P5I0,C4L1M1,A0A4R1RMM2,A0A1Y2RDH8,Q11QW7,A0A1M5ZSR3,A0A0K8QX04,A0A0M2PXX3,A0A1I3LMA1,K9TPA9,A0A1L3JHM3,A0A1W6MIP2,A0A1C0UUC4,A0A2U2J9E0,A0A2Z6E1D5,A0A0F4NXW8,A0A142XB92,L8D0R3,B1XJG0,A0A326U7G5,A0A3D8L290,H1KXR6,A0A1Q4R485,K9U8J6,A0A097QRL6,K9RC91,A0A0D8ZUC0,A0A139XGN8,A0A1T4Y3A2,Q5P0R2,B6YTQ5,A0A0B0H9B4,A0YYT3,A0A2T1EFY0,G6FTN0,R6KUL9,A0A433NB65,A0A1Z4L0A1,K9UQR0,A0A2T1G8M7,K9VUN0,B7GJX9,A0A0P6X5X2,K9ZDE3,B0JXD6,A0A2T1LS63,A0A1Z4K1Y3,A0A2Z6E0R7,A0A1N6SSK9,A0A0P4UVI8,A0A0V7ZCG4,A0A1J0AGK2,K9PFF9,A0A2G9DT08,K9UEV4,Q9L1X1,A0A060HNJ0,A0A235B542,R5XQK4,A0A496APJ8,A0A062U2W9,H0HWQ5,A0A1V9G9U4,A0A1I2ZGP1,A0A317EJY3,A0A1I2BD20,F8ERC7,S7VLM7,A0A1A5X8H4,A0A1I2T6Q1,A0A1R3T9N6,A0A0Q2M2Z1,H8KXJ0,D3S0S6,A0A2D1U4H7,I3TE64,A0A0B7I4Z6,A0LL61,Q8DKB1,A0A139WY18,A0A1J1EK56,A0A2T1E1K4,A0A1Q8ZD62,A0A4Q6XKV6,A0A1Z3HNN4,A0A239JE83,A0A2N4XBY2,Q53W94,R5JEI2,A0A0Q0ZC47,A0A2T0XH18,A0A1V4CHV0,A0A1K1RQP7,A0A2T1EKT1,A0A1N6LUI7,A0A0P0NGR6,A0A1X7IML5,A0A0A2LKJ7,K1L112,A0A0U3AL92,A0A1H3A054,E0UCX3,K9XZC6,A0A0C1VHB4,Q31N05,A0A0C5JKF3,R5NJJ8,A5D4D9,Q2JI93,A0A142Y7A9,A0A432MEQ5,A0A372DKU2,A0A3R7KLK4,C1F5Q7,A0A4R3EV39,A0A1P8WP90,A0A222F7P0,A0A1C9VH88,A0A2T2YMB1,A0A329TD61,A0A101R2A0,A0A1E3XF49,A0A1U9ND56,A0A4R7BQC4,A0A1H3DGN3,A0A1Q1FPH0,E0TGY3,A0A259TUP4,F6EYI8,A0A2S9Q9J0,A0A4Q2UIU6,A0A1H0LH25,A0A318LG42,H1YCU5,L0JS08,A0A1Q5ZS75,A0A345E7N0,M0AF24,A0A1W2A082,A0A1H3X247,A0A0C1XUA0,M0D2X3,A0A2R5G167,A0A346PK63,R7RTW6,A0A1H2RBI2,A0A1C3ZXN2,B9LVP8,M5RSF0,B7K585,F8D8G0,A0A343TL88,L0AJX6,A0A2A5QS34,A0A343JEE2,A0A3P3RGE5,A0A329TBQ3,A0A285N2A8,A0A0W1S8B8,A0A1V4C8L7,L9VRQ2,E4NRV1,A0A1I6HGN0,A0A1I0NI68,,",366,37
"1144","C.H5.7","C.H5.9",360,180,180,1.9,"4F1N,4F3T,4KRE,5GUH,5VM9,6KR6,6OON,7KX7,7SWF,A0A163JTZ6,A0A196SDB4,J9D5G4,Q389P5,C4LVV2,A8BCK6,A2DPV7,A0A0G4H2S4,T1H8B3,R1FDF0,S4RWI0,D2VMG4,A0A074TLL7,A0A0D1ZAJ4,Q1K660,F4PH46,A0A3M7S814,A0A164ZA52,A0A383WDW5,Q54G64,S7WCF7,I0YVB2,R7QGN7,C1DZY0,A0A2C5Z0M1,A0CB11,R9ACY5,D3BMP8,A0A1Z5TVE5,W7XD45,A0A1U7LLR0,A0A4S2MWZ7,K1VVQ6,A0A158P1R9,G7DVX0,V6R0U9,G4N9J3,E3KLI3,B7Q5I1,A0A1E3QC61,D5GGK8,S8ANP9,A0A139AUH8,L2GMR6,U4LBG4,A0A177URI1,O74957,A0A3N4IGK1,A6N7Y9,A0A0E9NDK5,T1KZ60,A0A250WXN5,A0A2G8JLH3,Q5KAT1,L2GUF2,W2T741,A0A1W0E4B5,A0A2J7QB22,S4RYE2,A0A2K3CW87,A0A388KES6,A0A226EFL3,A0A3S3PD82,A0A0L0TEV1,A0A1S3J512,G0QTT2,A0A1J1HRI1,C4V9J2,Q9JMB7,A0A075AN09,Q5TW24,U5HIG6,A0A401PRI6,Q96J94,A0A2B4RHN2,G2QEV0,A0A397UU01,A0A2T7PFL8,K7ISV0,A0A024FT57,H3HCL6,A0A0G4IME3,E9FUN9,A0A1S3CYL5,D7FQK3,A0A1Y1YHC8,T1GSU4,F4S231,A0A1D8PMK0,A0A2G5B1D8,Q5BD61,A0A1C7M8P2,A0A4D8YSQ3,A0A158PJG6,J9JZ66,A0A0C2XG51,A0A158QZT6,T0SAU8,R7YY92,A0A3S1A0C3,A0A074YJ47,A0A2K1J482,A0A1Q3ENA6,O04379,A0A371I3C8,M8AEW7,A8P0D4,A0A2K3NY65,F4NYW7,A0A409Y6G2,A0A0L0HAB7,D8PZT7,A0A1D1W4K0,A7RQ46,W4YU94,A7BJS5,D8SNM6,A0A1J8PPA3,X1WG39,M5FQK2,Q69VD5,A0A2R6NSC2,A0A0D8XL16,A0A016WPN3,Q9QZ81,G5EES3,A0A0K0EFP6,Q8CJG0,A0A1D5NTU6,V2WTL2,A0A0V0YLH8,A0A139WDH0,A0A0R3W9Q7,H3DS31,A0A1Y1HWP2,G4T5G9,B7QCC4,A0A0B2UV00,M7BCJ9,E9GN30,Q7PZ41,A0A077Z361,R7U9I3,A0A1X7V1N5,A0A0K0JDP1,A0A0N4UKJ1,A0A498N3A3,A0A3M0IQP5,A0A0L8GBV4,Q32KD4,A0A1J1JBJ0,E0W4C3,A0A482XDA9,A0A3P7EJD6,J9K2Z4,A0A2J7Q8V4,T1IBM6,V3ZRX0,A0A210QKF7,A0A423TSS1,K1PT78,A0A267E8R7,A0A1D2N447,A0A226D7A9,F6YK55,T1KTE4,A0A2C9JGZ6,A0A1V9X9F0,K5X5Z7,A0A3Q0KUG5,T1FY40,1YVU,1Z26,3DLB,5AWH,5G5T,5I4A,6QZK,7R8K,E8N0K8,A0A1I7IXT4,A0A2W1JZ37,A0A2S7WBN3,A0A328VKE4,A0A420DFE6,E0ST67,A0A4V1VDY2,A0A368P5I0,C4L1M1,A0A4R1RMM2,A0A1Y2RDH8,Q11QW7,A0A1M5ZSR3,A0A0K8QX04,A0A0M2PXX3,A0A1I3LMA1,K9TPA9,A0A1L3JHM3,A0A1W6MIP2,A0A1C0UUC4,A0A2U2J9E0,A0A2Z6E1D5,A0A0F4NXW8,L8D0R3,B1XJG0,A0A326U7G5,A0A3D8L290,H1KXR6,A0A1Q4R485,K9U8J6,A0A097QRL6,K9RC91,A0A0D8ZUC0,A0A139XGN8,A0A1T4Y3A2,Q5P0R2,B6YTQ5,A0A0B0H9B4,A0YYT3,A0A2T1EFY0,G6FTN0,R6KUL9,A0A433NB65,A0A1Z4L0A1,K9UQR0,A0A2T1G8M7,K9VUN0,B7GJX9,K9ZDE3,B0JXD6,A0A2T1LS63,A0A1Z4K1Y3,A0A2Z6E0R7,A0A1N6SSK9,A0A0P4UVI8,A0A0V7ZCG4,A0A1J0AGK2,K9PFF9,A0A2G9DT08,K9UEV4,Q9L1X1,A0A060HNJ0,A0A235B542,R5XQK4,A0A1H3LE92,A0A496APJ8,A0A062U2W9,H0HWQ5,A0A1V9G9U4,A0A1I2ZGP1,A0A317EJY3,A0A1I2BD20,F8ERC7,S7VLM7,A0A1A5X8H4,A0A1I2T6Q1,A0A1R3T9N6,A0A0Q2M2Z1,H8KXJ0,D3S0S6,A0A2D1U4H7,A0A0B7I4Z6,A0LL61,Q8DKB1,A0A139WY18,A0A1J1EK56,A0A2T1E1K4,A0A1Q8ZD62,A0A4Q6XKV6,A0A1Z3HNN4,A0A239JE83,A0A2N4XBY2,Q53W94,R5JEI2,A0A0Q0ZC47,A0A2T0XH18,A0A1V4CHV0,A0A1K1RQP7,A0A2T1EKT1,A0A1N6LUI7,A0A0P0NGR6,A0A1X7IML5,A0A0A2LKJ7,K1L112,A0A0U3AL92,A0A1H3A054,E0UCX3,K9XZC6,B9LVW4,A0A0C1VHB4,Q31N05,A0A0C5JKF3,R5NJJ8,A5D4D9,Q2JI93,A0A142Y7A9,A0A432MEQ5,A0A372DKU2,A0A3R7KLK4,C1F5Q7,A0A4R3EV39,A0A1P8WP90,A0A222F7P0,A0A1C9VH88,A0A2T2YMB1,A0A329TD61,A0A101R2A0,A0A1E3XF49,A0A1U9ND56,A0A4R7BQC4,A0A1H3DGN3,A0A1Q1FPH0,E0TGY3,A0A259TUP4,F6EYI8,A0A2S9Q9J0,A0A4Q2UIU6,A0A1H0LH25,A0A318LG42,H1YCU5,L0JS08,A0A1Q5ZS75,A0A345E7N0,M0AF24,A0A1W2A082,A0A1H3X247,A0A0C1XUA0,M0D2X3,A0A2R5G167,A0A346PK63,R7RTW6,A0A1H2RBI2,A0A1C3ZXN2,B9LVP8,M5RSF0,W0JW77,B7K585,F8D8G0,A0A343TL88,L0AJX6,A0A2A5QS34,A0A343JEE2,A0A3P3RGE5,A0A329TBQ3,A0A285N2A8,A0A0W1S8B8,A0A1V4C8L7,L9VRQ2,E4NRV1,A0A1I6HGN0,A0A1I0NI68,,",366,37
"1145","C.H7.10","C.H7.13",269,180,89,3.37191011235955,"4F1N,4F3T,4KRE,5GUH,5VM9,6KR6,6OON,7KX7,7SWF,A0A163JTZ6,A0A0N4X8S8,A0A196SDB4,J9D5G4,Q389P5,C4LVV2,A0A2P6N8X7,A8BCK6,A2DPV7,T1H8B3,R1FDF0,S4RWI0,D2VMG4,A0A074TLL7,A0A0D1ZAJ4,Q1K660,F4PH46,A0A3M7S814,A0A164ZA52,A0A383WDW5,Q54G64,S7WCF7,I0YVB2,R7QGN7,C1DZY0,A0A2C5Z0M1,A0CB11,R9ACY5,D3BMP8,A0A1Z5TVE5,W7XD45,A0A1U7LLR0,A0A4S2MWZ7,K1VVQ6,A0A158P1R9,G7DVX0,V6R0U9,G4N9J3,E3KLI3,B7Q5I1,A0A1E3QC61,D5GGK8,S8ANP9,A0A139AUH8,L2GMR6,U4LBG4,A0A177URI1,O74957,A0A3N4IGK1,A6N7Y9,A0A0E9NDK5,T1KZ60,A0A250WXN5,A0A2G8JLH3,Q5KAT1,L2GUF2,W2T741,A0A1W0E4B5,A0A2J7QB22,A0A2K3CW87,A0A226EFL3,A0A3S3PD82,A0A0L0TEV1,A0A1S3J512,G0QTT2,A0A1J1HRI1,C4V9J2,Q9JMB7,A0A075AN09,Q5TW24,U5HIG6,A0A401PRI6,Q96J94,A0A2B4RHN2,G2QEV0,A0A397UU01,A0A2T7PFL8,K7ISV0,A0A024FT57,H3HCL6,A0A0G4IME3,E9FUN9,A0A1S3CYL5,D7FQK3,A0A1Y1YHC8,T1GSU4,F4S231,A0A1D8PMK0,A0A2G5B1D8,Q5BD61,A0A1C7M8P2,A0A4D8YSQ3,A0A158PJG6,J9JZ66,A0A0C2XG51,A0A158QZT6,A0A165QYQ9,T0SAU8,R7YY92,A0A3S1A0C3,A0A074YJ47,A0A2K1J482,A0A1Q3ENA6,O04379,A0A371I3C8,M8AEW7,A8P0D4,A0A2K3NY65,F4NYW7,A0A409Y6G2,A0A0L0HAB7,D8PZT7,A0A1D1W4K0,A7RQ46,W4YU94,A7BJS5,D8SNM6,A0A1J8PPA3,X1WG39,M5FQK2,Q69VD5,A0A2R6NSC2,A0A0D8XL16,A0A016WPN3,Q9QZ81,G5EES3,A0A0K0EFP6,Q8CJG0,A0A1D5NTU6,V2WTL2,A0A0V0YLH8,A0A139WDH0,A0A0R3W9Q7,H3DS31,A0A1Y1HWP2,G4T5G9,B7QCC4,A0A0B2UV00,M7BCJ9,E9GN30,Q7PZ41,A0A077Z361,R7U9I3,A0A1X7V1N5,A0A0K0JDP1,A0A0N4UKJ1,A0A498N3A3,A0A3M0IQP5,A0A0L8GBV4,Q32KD4,A0A1J1JBJ0,E0W4C3,A0A482XDA9,A0A3P7EJD6,J9K2Z4,A0A2J7Q8V4,T1IBM6,V3ZRX0,A0A210QKF7,A0A423TSS1,K1PT78,A0A267E8R7,A0A1D2N447,A0A226D7A9,F6YK55,T1KTE4,A0A2C9JGZ6,A0A1V9X9F0,K5X5Z7,A0A3Q0KUG5,T1FY40,1YVU,1Z26,3DLB,5AWH,5I4A,6QZK,7R8K,A0A2W1JZ37,A0A2S7WBN3,A0A420DFE6,E0ST67,C4L1M1,A0A1Y2RDH8,A0A1M5ZSR3,A0A0K8QX04,A0A0M2PXX3,A0A1I3LMA1,A0A1W6MIP2,A0A1C0UUC4,A0A2U2J9E0,A0A142XB92,B1XJG0,A0A3D8L290,A0A097QRL6,B6YTQ5,A0A0B0H9B4,R6KUL9,B7GJX9,A0A0P6X5X2,A0A1N6SSK9,A0A060HNJ0,A0A235B542,R5XQK4,A0A1H3LE92,A0A496APJ8,A0A062U2W9,H0HWQ5,A0A1V9G9U4,A0A1I2ZGP1,A0A317EJY3,A0A1I2BD20,F8ERC7,A0A0Q2M2Z1,I3TE64,Q8DKB1,A0A139WY18,A0A1J1EK56,A0A2T1E1K4,A0A1Q8ZD62,A0A1Z3HNN4,Q53W94,A0A2T1EKT1,E0UCX3,K9XZC6,B9LVW4,A0A0C1VHB4,Q31N05,R5NJJ8,Q2JI93,A0A432MEQ5,A0A329TD61,A0A1E3XF49,A0A1H3DGN3,H1YCU5,A0A1Q5ZS75,A0A345E7N0,A0A1W2A082,A0A1H3X247,A0A0C1XUA0,A0A2R5G167,A0A346PK63,R7RTW6,A0A1H2RBI2,A0A1C3ZXN2,B9LVP8,M5RSF0,W0JW77,B7K585,A0A343TL88,L0AJX6,A0A2A5QS34,A0A343JEE2,A0A3P3RGE5,A0A329TBQ3,A0A285N2A8,A0A0W1S8B8,L9VRQ2,E4NRV1,A0A1I6HGN0,,",366,37
"1147","C.H7.6","C.H7.8",312,180,132,1.96666666666667,"4F1N,4F3T,4KRE,5GUH,5VM9,6KR6,6OON,7KX7,7SWF,A0A163JTZ6,A0A196SDB4,J9D5G4,Q389P5,C4LVV2,A0A2P6N8X7,A8BCK6,A2DPV7,A0A0G4H2S4,T1H8B3,R1FDF0,S4RWI0,D2VMG4,A0A074TLL7,A0A0D1ZAJ4,Q1K660,F4PH46,A0A3M7S814,A0A164ZA52,A0A383WDW5,Q54G64,S7WCF7,I0YVB2,R7QGN7,C1DZY0,A0A2C5Z0M1,A0CB11,R9ACY5,D3BMP8,A0A1Z5TVE5,W7XD45,A0A1U7LLR0,A0A4S2MWZ7,K1VVQ6,A0A158P1R9,G7DVX0,V6R0U9,G4N9J3,E3KLI3,B7Q5I1,A0A1E3QC61,D5GGK8,S8ANP9,A0A139AUH8,L2GMR6,U4LBG4,A0A177URI1,O74957,A0A3N4IGK1,A6N7Y9,A0A0E9NDK5,T1KZ60,A0A250WXN5,A0A2G8JLH3,Q5KAT1,L2GUF2,W2T741,A0A1W0E4B5,A0A2J7QB22,A0A2K3CW87,A0A226EFL3,A0A3S3PD82,A0A0L0TEV1,A0A1S3J512,G0QTT2,A0A1J1HRI1,C4V9J2,Q9JMB7,A0A075AN09,Q5TW24,U5HIG6,A0A401PRI6,Q96J94,A0A2B4RHN2,G2QEV0,A0A397UU01,A0A2T7PFL8,K7ISV0,A0A024FT57,H3HCL6,A0A0G4IME3,E9FUN9,A0A1S3CYL5,D7FQK3,A0A1Y1YHC8,T1GSU4,F4S231,A0A1D8PMK0,A0A2G5B1D8,Q5BD61,A0A1C7M8P2,A0A4D8YSQ3,A0A158PJG6,J9JZ66,A0A0C2XG51,A0A158QZT6,A0A165QYQ9,T0SAU8,R7YY92,A0A3S1A0C3,A0A074YJ47,A0A2K1J482,A0A1Q3ENA6,O04379,A0A371I3C8,M8AEW7,A8P0D4,A0A2K3NY65,F4NYW7,A0A409Y6G2,A0A0L0HAB7,D8PZT7,A0A1D1W4K0,A7RQ46,W4YU94,A7BJS5,D8SNM6,A0A1J8PPA3,X1WG39,M5FQK2,Q69VD5,A0A2R6NSC2,A0A0D8XL16,A0A016WPN3,Q9QZ81,G5EES3,A0A0K0EFP6,Q8CJG0,A0A1D5NTU6,V2WTL2,A0A0V0YLH8,A0A139WDH0,A0A0R3W9Q7,H3DS31,A0A1Y1HWP2,G4T5G9,B7QCC4,A0A0B2UV00,M7BCJ9,E9GN30,Q7PZ41,A0A077Z361,R7U9I3,A0A1X7V1N5,A0A0K0JDP1,A0A0N4UKJ1,A0A498N3A3,A0A3M0IQP5,A0A0L8GBV4,Q32KD4,A0A1J1JBJ0,E0W4C3,A0A482XDA9,A0A3P7EJD6,J9K2Z4,A0A2J7Q8V4,T1IBM6,V3ZRX0,A0A210QKF7,A0A423TSS1,K1PT78,A0A267E8R7,A0A1D2N447,A0A226D7A9,F6YK55,T1KTE4,A0A2C9JGZ6,A0A1V9X9F0,K5X5Z7,A0A3Q0KUG5,T1FY40,1YVU,1Z26,3DLB,5AWH,5G5T,5I4A,6QZK,7R8K,E8N0K8,A0A2W1JZ37,A0A2S7WBN3,A0A328VKE4,A0A420DFE6,E0ST67,C4L1M1,A0A4R1RMM2,A0A1Y2RDH8,Q11QW7,A0A1M5ZSR3,A0A0K8QX04,A0A0M2PXX3,A0A1I3LMA1,A0A1L3JHM3,A0A1W6MIP2,A0A1C0UUC4,A0A2U2J9E0,A0A2Z6E1D5,A0A0F4NXW8,A0A142XB92,L8D0R3,B1XJG0,A0A3D8L290,A0A097QRL6,K9RC91,A0A0D8ZUC0,A0A1T4Y3A2,Q5P0R2,B6YTQ5,A0A0B0H9B4,A0A2T1EFY0,R6KUL9,A0A433NB65,B7GJX9,A0A0P6X5X2,B0JXD6,A0A2Z6E0R7,A0A1N6SSK9,A0A0V7ZCG4,A0A2G9DT08,A0A060HNJ0,A0A235B542,R5XQK4,A0A1H3LE92,A0A496APJ8,A0A062U2W9,H0HWQ5,A0A1V9G9U4,A0A1I2ZGP1,A0A317EJY3,A0A1I2BD20,F8ERC7,A0A1A5X8H4,A0A1I2T6Q1,A0A0Q2M2Z1,H8KXJ0,D3S0S6,A0A2D1U4H7,I3TE64,A0A0B7I4Z6,A0LL61,Q8DKB1,A0A139WY18,A0A1J1EK56,A0A2T1E1K4,A0A1Q8ZD62,A0A4Q6XKV6,A0A1Z3HNN4,A0A2N4XBY2,Q53W94,R5JEI2,A0A0Q0ZC47,A0A2T0XH18,A0A1K1RQP7,A0A2T1EKT1,A0A1N6LUI7,A0A0P0NGR6,A0A1X7IML5,A0A0A2LKJ7,K1L112,E0UCX3,K9XZC6,A0A0C1VHB4,Q31N05,R5NJJ8,A5D4D9,Q2JI93,A0A3R7KLK4,C1F5Q7,A0A4R3EV39,A0A222F7P0,A0A2T2YMB1,A0A329TD61,A0A1E3XF49,A0A1H3DGN3,A0A1Q1FPH0,E0TGY3,F6EYI8,A0A2S9Q9J0,H1YCU5,A0A1Q5ZS75,A0A345E7N0,A0A1W2A082,A0A1H3X247,A0A0C1XUA0,A0A346PK63,R7RTW6,A0A1H2RBI2,A0A1C3ZXN2,B9LVP8,M5RSF0,W0JW77,A0A343TL88,L0AJX6,A0A2A5QS34,A0A343JEE2,A0A3P3RGE5,A0A329TBQ3,A0A285N2A8,A0A0W1S8B8,L9VRQ2,E4NRV1,A0A1I6HGN0,,",366,37
"1152","C.H9.10","C.L25.1",315,180,135,5.61388888888889,"4F1N,4F3T,4KRE,5GUH,5VM9,6KR6,6OON,7KX7,7SWF,A0A163JTZ6,A0A0N4X8S8,A0A196SDB4,J9D5G4,Q389P5,C4LVV2,A0A2P6N8X7,A8BCK6,A2DPV7,A0A0G4H2S4,R1FDF0,D2VMG4,A0A074TLL7,A0A0D1ZAJ4,Q1K660,F4PH46,A0A3M7S814,A0A164ZA52,Q54G64,S7WCF7,I0YVB2,R7QGN7,C1DZY0,A0A2C5Z0M1,A0CB11,R9ACY5,D3BMP8,A0A1Z5TVE5,W7XD45,A0A1U7LLR0,A0A4S2MWZ7,K1VVQ6,A0A158P1R9,G7DVX0,V6R0U9,G4N9J3,E3KLI3,B7Q5I1,A0A1E3QC61,D5GGK8,S8ANP9,A0A139AUH8,L2GMR6,U4LBG4,A0A177URI1,O74957,A0A3N4IGK1,A6N7Y9,A0A0E9NDK5,T1KZ60,A0A250WXN5,A0A2G8JLH3,Q5KAT1,L2GUF2,W2T741,A0A1W0E4B5,A0A2J7QB22,S4RYE2,A0A2K3CW87,A0A388KES6,A0A226EFL3,A0A3S3PD82,A0A0L0TEV1,A0A1S3J512,G0QTT2,A0A1J1HRI1,C4V9J2,Q9JMB7,A0A075AN09,Q5TW24,U5HIG6,A0A401PRI6,Q96J94,A0A2B4RHN2,G2QEV0,A0A397UU01,A0A2T7PFL8,K7ISV0,A0A024FT57,H3HCL6,A0A0G4IME3,E9FUN9,A0A1S3CYL5,D7FQK3,A0A1Y1YHC8,T1GSU4,F4S231,A0A1D8PMK0,A0A2G5B1D8,Q5BD61,A0A1C7M8P2,A0A4D8YSQ3,A0A158PJG6,J9JZ66,A0A0C2XG51,A0A158QZT6,A0A165QYQ9,T0SAU8,R7YY92,A0A3S1A0C3,A0A074YJ47,A0A2K1J482,A0A1Q3ENA6,O04379,A0A371I3C8,M8AEW7,A8P0D4,A0A2K3NY65,F4NYW7,A0A409Y6G2,A0A0L0HAB7,D8PZT7,A0A1D1W4K0,A7RQ46,W4YU94,A7BJS5,D8SNM6,A0A1J8PPA3,X1WG39,M5FQK2,Q69VD5,A0A2R6NSC2,A0A0D8XL16,A0A016WPN3,Q9QZ81,G5EES3,A0A0K0EFP6,Q8CJG0,A0A1D5NTU6,V2WTL2,A0A0V0YLH8,A0A139WDH0,A0A0R3W9Q7,H3DS31,A0A1Y1HWP2,G4T5G9,B7QCC4,A0A0B2UV00,M7BCJ9,E9GN30,Q7PZ41,A0A077Z361,R7U9I3,A0A1X7V1N5,A0A0K0JDP1,A0A0N4UKJ1,A0A498N3A3,A0A3M0IQP5,A0A0L8GBV4,Q32KD4,A0A1J1JBJ0,E0W4C3,A0A482XDA9,A0A3P7EJD6,J9K2Z4,A0A2J7Q8V4,T1IBM6,V3ZRX0,A0A210QKF7,A0A423TSS1,K1PT78,A0A267E8R7,A0A1D2N447,A0A226D7A9,F6YK55,T1KTE4,A0A2C9JGZ6,A0A1V9X9F0,K5X5Z7,A0A3Q0KUG5,T1FY40,1Z26,3DLB,6QZK,7R8K,A0A1I7IXT4,A0A2W1JZ37,A0A2S7WBN3,A0A420DFE6,A0A4V1VDY2,A0A368P5I0,C4L1M1,A0A4R1RMM2,A0A1Y2RDH8,Q11QW7,A0A1M5ZSR3,A0A0M2PXX3,K9TPA9,A0A1L3JHM3,A0A1W6MIP2,A0A1C0UUC4,A0A2U2J9E0,A0A2Z6E1D5,A0A0F4NXW8,A0A142XB92,L8D0R3,B1XJG0,A0A326U7G5,A0A1Q4R485,A0A097QRL6,A0A0D8ZUC0,A0A1T4Y3A2,Q5P0R2,B6YTQ5,A0A0B0H9B4,A0YYT3,R6KUL9,A0A433NB65,B7GJX9,K9ZDE3,B0JXD6,A0A2Z6E0R7,A0A1N6SSK9,A0A0P4UVI8,A0A2G9DT08,A0A235B542,R5XQK4,A0A1H3LE92,A0A062U2W9,H0HWQ5,A0A1I2ZGP1,A0A317EJY3,A0A1I2BD20,F8ERC7,S7VLM7,A0A1A5X8H4,A0A1I2T6Q1,A0A1R3T9N6,A0A0Q2M2Z1,H8KXJ0,A0A2D1U4H7,I3TE64,A0LL61,Q8DKB1,A0A1J1EK56,A0A4Q6XKV6,A0A239JE83,A0A2N4XBY2,R5JEI2,A0A2T0XH18,A0A1V4CHV0,A0A1K1RQP7,A0A2T1EKT1,A0A1N6LUI7,A0A0P0NGR6,A0A1X7IML5,A0A0A2LKJ7,K1L112,A0A0U3AL92,E0UCX3,K9XZC6,B9LVW4,A0A0C1VHB4,Q31N05,A0A0C5JKF3,R5NJJ8,A5D4D9,Q2JI93,A0A142Y7A9,A0A372DKU2,A0A3R7KLK4,C1F5Q7,A0A4R3EV39,A0A1P8WP90,A0A222F7P0,A0A1C9VH88,A0A329TD61,A0A1E3XF49,A0A1U9ND56,A0A4R7BQC4,A0A1H3DGN3,A0A1Q1FPH0,A0A259TUP4,F6EYI8,A0A2S9Q9J0,A0A4Q2UIU6,A0A1H0LH25,H1YCU5,L0JS08,A0A1Q5ZS75,A0A345E7N0,M0AF24,A0A1W2A082,A0A1H3X247,A0A0C1XUA0,M0D2X3,A0A346PK63,R7RTW6,A0A1H2RBI2,A0A1C3ZXN2,B9LVP8,W0JW77,F8D8G0,A0A343TL88,L0AJX6,A0A2A5QS34,A0A343JEE2,A0A3P3RGE5,A0A329TBQ3,A0A285N2A8,A0A0W1S8B8,A0A1V4C8L7,L9VRQ2,E4NRV1,A0A1I6HGN0,A0A1I0NI68,,",366,37
"1153","C.H9.12","C.L25.2",343,180,163,3.05823108384458,"4F1N,4F3T,4KRE,5GUH,5VM9,6KR6,6OON,7KX7,A0A163JTZ6,A0A0N4X8S8,A0A196SDB4,J9D5G4,Q389P5,C4LVV2,A0A2P6N8X7,A8BCK6,A2DPV7,A0A0G4H2S4,R1FDF0,D2VMG4,A0A074TLL7,A0A0D1ZAJ4,Q1K660,F4PH46,A0A3M7S814,A0A164ZA52,A0A383WDW5,Q54G64,S7WCF7,I0YVB2,R7QGN7,C1DZY0,A0A2C5Z0M1,A0CB11,R9ACY5,D3BMP8,A0A1Z5TVE5,W7XD45,A0A1U7LLR0,A0A4S2MWZ7,K1VVQ6,A0A158P1R9,G7DVX0,V6R0U9,G4N9J3,E3KLI3,B7Q5I1,A0A1E3QC61,D5GGK8,S8ANP9,A0A139AUH8,L2GMR6,U4LBG4,A0A177URI1,O74957,A0A3N4IGK1,A6N7Y9,A0A0E9NDK5,T1KZ60,A0A250WXN5,A0A2G8JLH3,Q5KAT1,L2GUF2,W2T741,A0A1W0E4B5,A0A2J7QB22,S4RYE2,A0A2K3CW87,A0A388KES6,A0A226EFL3,A0A3S3PD82,A0A0L0TEV1,A0A1S3J512,G0QTT2,A0A1J1HRI1,C4V9J2,Q9JMB7,A0A075AN09,Q5TW24,U5HIG6,A0A401PRI6,Q96J94,A0A2B4RHN2,G2QEV0,A0A397UU01,A0A2T7PFL8,K7ISV0,A0A024FT57,H3HCL6,A0A0G4IME3,E9FUN9,A0A1S3CYL5,D7FQK3,A0A1Y1YHC8,T1GSU4,F4S231,A0A1D8PMK0,A0A2G5B1D8,Q5BD61,A0A1C7M8P2,A0A4D8YSQ3,A0A158PJG6,J9JZ66,A0A0C2XG51,A0A158QZT6,A0A165QYQ9,T0SAU8,R7YY92,A0A3S1A0C3,A0A074YJ47,A0A2K1J482,A0A1Q3ENA6,O04379,A0A371I3C8,M8AEW7,A8P0D4,A0A2K3NY65,F4NYW7,A0A409Y6G2,A0A0L0HAB7,D8PZT7,A0A1D1W4K0,A7RQ46,W4YU94,A7BJS5,D8SNM6,A0A1J8PPA3,X1WG39,M5FQK2,Q69VD5,A0A2R6NSC2,A0A0D8XL16,A0A016WPN3,Q9QZ81,G5EES3,A0A0K0EFP6,Q8CJG0,A0A1D5NTU6,V2WTL2,A0A0V0YLH8,A0A139WDH0,A0A0R3W9Q7,H3DS31,A0A1Y1HWP2,G4T5G9,B7QCC4,A0A0B2UV00,M7BCJ9,E9GN30,Q7PZ41,A0A077Z361,R7U9I3,A0A1X7V1N5,A0A0K0JDP1,A0A0N4UKJ1,A0A498N3A3,A0A3M0IQP5,A0A0L8GBV4,Q32KD4,A0A1J1JBJ0,E0W4C3,A0A482XDA9,A0A3P7EJD6,J9K2Z4,A0A2J7Q8V4,T1IBM6,V3ZRX0,A0A210QKF7,A0A423TSS1,K1PT78,A0A267E8R7,A0A1D2N447,A0A226D7A9,F6YK55,T1KTE4,A0A2C9JGZ6,A0A1V9X9F0,K5X5Z7,A0A3Q0KUG5,T1FY40,3DLB,5AWH,5G5T,5I4A,6QZK,A0A328VKE4,E0ST67,C4L1M1,A0A4R1RMM2,A0A1Y2RDH8,Q11QW7,A0A1M5ZSR3,A0A0K8QX04,A0A0M2PXX3,K9TPA9,A0A1L3JHM3,A0A1W6MIP2,A0A1C0UUC4,A0A2U2J9E0,A0A2Z6E1D5,A0A0F4NXW8,L8D0R3,B1XJG0,A0A326U7G5,A0A3D8L290,A0A1Q4R485,K9U8J6,K9RC91,A0A0D8ZUC0,A0A139XGN8,A0A1T4Y3A2,Q5P0R2,A0A0B0H9B4,A0YYT3,A0A2T1EFY0,G6FTN0,R6KUL9,A0A433NB65,A0A1Z4L0A1,K9UQR0,A0A2T1G8M7,K9VUN0,B7GJX9,K9ZDE3,B0JXD6,A0A2T1LS63,A0A1Z4K1Y3,A0A2Z6E0R7,A0A1N6SSK9,A0A0P4UVI8,A0A0V7ZCG4,A0A1J0AGK2,K9PFF9,A0A2G9DT08,K9UEV4,Q9L1X1,A0A235B542,R5XQK4,A0A496APJ8,A0A062U2W9,H0HWQ5,A0A1V9G9U4,A0A1I2ZGP1,A0A317EJY3,A0A1I2BD20,F8ERC7,S7VLM7,A0A1A5X8H4,A0A1I2T6Q1,A0A1R3T9N6,A0A0Q2M2Z1,H8KXJ0,D3S0S6,A0A2D1U4H7,I3TE64,A0A0B7I4Z6,A0LL61,Q8DKB1,A0A139WY18,A0A1J1EK56,A0A2T1E1K4,A0A1Q8ZD62,A0A4Q6XKV6,A0A1Z3HNN4,A0A239JE83,A0A2N4XBY2,Q53W94,R5JEI2,A0A0Q0ZC47,A0A2T0XH18,A0A1V4CHV0,A0A1K1RQP7,A0A2T1EKT1,A0A1N6LUI7,A0A0P0NGR6,A0A1X7IML5,A0A0A2LKJ7,K1L112,A0A0U3AL92,A0A1H3A054,E0UCX3,K9XZC6,B9LVW4,Q31N05,A0A0C5JKF3,R5NJJ8,A5D4D9,Q2JI93,A0A142Y7A9,A0A432MEQ5,A0A372DKU2,A0A3R7KLK4,C1F5Q7,A0A4R3EV39,A0A1P8WP90,A0A222F7P0,A0A1C9VH88,A0A2T2YMB1,A0A329TD61,A0A101R2A0,A0A1E3XF49,A0A1U9ND56,A0A4R7BQC4,A0A1H3DGN3,A0A1Q1FPH0,A0A259TUP4,F6EYI8,A0A2S9Q9J0,A0A4Q2UIU6,A0A1H0LH25,A0A318LG42,H1YCU5,L0JS08,A0A1Q5ZS75,A0A345E7N0,M0AF24,A0A1W2A082,A0A1H3X247,A0A0C1XUA0,M0D2X3,A0A2R5G167,A0A346PK63,R7RTW6,A0A1H2RBI2,A0A1C3ZXN2,B9LVP8,M5RSF0,W0JW77,B7K585,F8D8G0,A0A343TL88,L0AJX6,A0A2A5QS34,A0A343JEE2,A0A3P3RGE5,A0A329TBQ3,A0A285N2A8,A0A0W1S8B8,A0A1V4C8L7,L9VRQ2,E4NRV1,A0A1I6HGN0,A0A1I0NI68,,",366,37
"1157","C.H9.5","C.H9.7",361,180,181,1.92526089625537,"4F1N,4F3T,4KRE,5GUH,5VM9,6KR6,6OON,7KX7,7SWF,A0A163JTZ6,A0A0N4X8S8,J9D5G4,Q389P5,C4LVV2,A0A2P6N8X7,A8BCK6,A2DPV7,A0A0G4H2S4,R1FDF0,D2VMG4,A0A074TLL7,A0A0D1ZAJ4,Q1K660,F4PH46,A0A3M7S814,A0A164ZA52,A0A383WDW5,Q54G64,S7WCF7,I0YVB2,R7QGN7,C1DZY0,A0A2C5Z0M1,A0CB11,R9ACY5,D3BMP8,A0A1Z5TVE5,W7XD45,A0A1U7LLR0,A0A4S2MWZ7,K1VVQ6,A0A158P1R9,G7DVX0,V6R0U9,G4N9J3,E3KLI3,B7Q5I1,A0A1E3QC61,D5GGK8,S8ANP9,A0A139AUH8,L2GMR6,U4LBG4,A0A177URI1,O74957,A0A3N4IGK1,A6N7Y9,A0A0E9NDK5,T1KZ60,A0A250WXN5,A0A2G8JLH3,Q5KAT1,L2GUF2,W2T741,A0A1W0E4B5,A0A2J7QB22,S4RYE2,A0A2K3CW87,A0A388KES6,A0A226EFL3,A0A3S3PD82,A0A0L0TEV1,A0A1S3J512,G0QTT2,A0A1J1HRI1,C4V9J2,Q9JMB7,A0A075AN09,Q5TW24,U5HIG6,A0A401PRI6,Q96J94,A0A2B4RHN2,G2QEV0,A0A397UU01,A0A2T7PFL8,K7ISV0,A0A024FT57,H3HCL6,A0A0G4IME3,E9FUN9,A0A1S3CYL5,D7FQK3,A0A1Y1YHC8,T1GSU4,F4S231,A0A1D8PMK0,A0A2G5B1D8,Q5BD61,A0A1C7M8P2,A0A4D8YSQ3,A0A158PJG6,J9JZ66,A0A0C2XG51,A0A158QZT6,A0A165QYQ9,T0SAU8,R7YY92,A0A3S1A0C3,A0A074YJ47,A0A2K1J482,A0A1Q3ENA6,O04379,A0A371I3C8,M8AEW7,A8P0D4,A0A2K3NY65,F4NYW7,A0A409Y6G2,A0A0L0HAB7,D8PZT7,A0A1D1W4K0,A7RQ46,W4YU94,A7BJS5,D8SNM6,A0A1J8PPA3,X1WG39,M5FQK2,Q69VD5,A0A2R6NSC2,A0A0D8XL16,A0A016WPN3,Q9QZ81,G5EES3,A0A0K0EFP6,Q8CJG0,A0A1D5NTU6,V2WTL2,A0A0V0YLH8,A0A139WDH0,A0A0R3W9Q7,H3DS31,A0A1Y1HWP2,G4T5G9,B7QCC4,A0A0B2UV00,M7BCJ9,E9GN30,Q7PZ41,A0A077Z361,R7U9I3,A0A1X7V1N5,A0A0K0JDP1,A0A0N4UKJ1,A0A498N3A3,A0A3M0IQP5,A0A0L8GBV4,Q32KD4,A0A1J1JBJ0,E0W4C3,A0A482XDA9,A0A3P7EJD6,J9K2Z4,A0A2J7Q8V4,T1IBM6,V3ZRX0,A0A210QKF7,A0A423TSS1,K1PT78,A0A267E8R7,A0A1D2N447,A0A226D7A9,F6YK55,T1KTE4,A0A2C9JGZ6,A0A1V9X9F0,K5X5Z7,A0A3Q0KUG5,T1FY40,1YVU,1Z26,3DLB,5AWH,5G5T,5I4A,6QZK,7R8K,A0A1I7IXT4,A0A2W1JZ37,A0A2S7WBN3,A0A328VKE4,A0A420DFE6,E0ST67,A0A4V1VDY2,A0A368P5I0,C4L1M1,A0A4R1RMM2,A0A1Y2RDH8,Q11QW7,A0A1M5ZSR3,A0A0K8QX04,A0A0M2PXX3,K9TPA9,A0A1L3JHM3,A0A1W6MIP2,A0A1C0UUC4,A0A2U2J9E0,A0A2Z6E1D5,A0A0F4NXW8,A0A142XB92,L8D0R3,B1XJG0,A0A326U7G5,A0A3D8L290,H1KXR6,A0A1Q4R485,K9U8J6,A0A097QRL6,K9RC91,A0A0D8ZUC0,A0A139XGN8,A0A1T4Y3A2,Q5P0R2,B6YTQ5,A0A0B0H9B4,A0YYT3,A0A2T1EFY0,G6FTN0,R6KUL9,A0A433NB65,A0A1Z4L0A1,K9UQR0,A0A2T1G8M7,K9VUN0,B7GJX9,A0A0P6X5X2,K9ZDE3,B0JXD6,A0A2T1LS63,A0A1Z4K1Y3,A0A2Z6E0R7,A0A1N6SSK9,A0A0P4UVI8,A0A0V7ZCG4,A0A1J0AGK2,K9PFF9,A0A2G9DT08,K9UEV4,Q9L1X1,A0A060HNJ0,A0A235B542,R5XQK4,A0A1H3LE92,A0A496APJ8,A0A062U2W9,H0HWQ5,A0A1V9G9U4,A0A1I2ZGP1,A0A317EJY3,A0A1I2BD20,F8ERC7,S7VLM7,A0A1A5X8H4,A0A1I2T6Q1,A0A1R3T9N6,A0A0Q2M2Z1,H8KXJ0,D3S0S6,A0A2D1U4H7,I3TE64,A0A0B7I4Z6,A0LL61,Q8DKB1,A0A139WY18,A0A1J1EK56,A0A2T1E1K4,A0A1Q8ZD62,A0A4Q6XKV6,A0A1Z3HNN4,A0A239JE83,A0A2N4XBY2,Q53W94,R5JEI2,A0A0Q0ZC47,A0A2T0XH18,A0A1V4CHV0,A0A1K1RQP7,A0A2T1EKT1,A0A1N6LUI7,A0A0P0NGR6,A0A1X7IML5,A0A0A2LKJ7,K1L112,A0A0U3AL92,A0A1H3A054,E0UCX3,K9XZC6,B9LVW4,A0A0C1VHB4,Q31N05,A0A0C5JKF3,R5NJJ8,A5D4D9,Q2JI93,A0A142Y7A9,A0A432MEQ5,A0A372DKU2,A0A3R7KLK4,C1F5Q7,A0A4R3EV39,A0A1P8WP90,A0A222F7P0,A0A1C9VH88,A0A2T2YMB1,A0A329TD61,A0A101R2A0,A0A1E3XF49,A0A1U9ND56,A0A4R7BQC4,A0A1H3DGN3,A0A1Q1FPH0,E0TGY3,A0A259TUP4,F6EYI8,A0A2S9Q9J0,A0A4Q2UIU6,A0A1H0LH25,A0A318LG42,H1YCU5,L0JS08,A0A1Q5ZS75,A0A345E7N0,M0AF24,A0A1W2A082,A0A1H3X247,A0A0C1XUA0,M0D2X3,A0A2R5G167,A0A346PK63,R7RTW6,A0A1H2RBI2,A0A1C3ZXN2,B9LVP8,M5RSF0,W0JW77,B7K585,F8D8G0,A0A343TL88,L0AJX6,A0A2A5QS34,A0A343JEE2,A0A3P3RGE5,A0A329TBQ3,A0A285N2A8,A0A0W1S8B8,A0A1V4C8L7,L9VRQ2,E4NRV1,A0A1I6HGN0,A0A1I0NI68,,",366,37
"1158","C.L17.3","C.S11.1",245,180,65,1.22200854700855,"4F1N,4F3T,4KRE,5GUH,5VM9,6KR6,6OON,7KX7,7SWF,A0A163JTZ6,A0A0N4X8S8,A0A196SDB4,J9D5G4,C4LVV2,A0A2P6N8X7,A8BCK6,A2DPV7,A0A0G4H2S4,T1H8B3,R1FDF0,S4RWI0,D2VMG4,A0A074TLL7,A0A0D1ZAJ4,Q1K660,F4PH46,A0A3M7S814,A0A164ZA52,A0A383WDW5,Q54G64,S7WCF7,I0YVB2,R7QGN7,C1DZY0,A0A2C5Z0M1,A0CB11,R9ACY5,D3BMP8,A0A1Z5TVE5,W7XD45,A0A1U7LLR0,A0A4S2MWZ7,K1VVQ6,A0A158P1R9,G7DVX0,V6R0U9,G4N9J3,E3KLI3,B7Q5I1,A0A1E3QC61,D5GGK8,S8ANP9,A0A139AUH8,L2GMR6,U4LBG4,A0A177URI1,O74957,A0A3N4IGK1,A6N7Y9,A0A0E9NDK5,T1KZ60,A0A250WXN5,A0A2G8JLH3,Q5KAT1,L2GUF2,W2T741,A0A1W0E4B5,A0A2J7QB22,A0A2K3CW87,A0A226EFL3,A0A3S3PD82,A0A0L0TEV1,A0A1S3J512,G0QTT2,A0A1J1HRI1,C4V9J2,Q9JMB7,A0A075AN09,Q5TW24,U5HIG6,A0A401PRI6,Q96J94,A0A2B4RHN2,G2QEV0,A0A397UU01,A0A2T7PFL8,K7ISV0,A0A024FT57,H3HCL6,A0A0G4IME3,E9FUN9,A0A1S3CYL5,D7FQK3,A0A1Y1YHC8,T1GSU4,F4S231,A0A1D8PMK0,A0A2G5B1D8,Q5BD61,A0A1C7M8P2,A0A4D8YSQ3,A0A158PJG6,J9JZ66,A0A0C2XG51,A0A158QZT6,A0A165QYQ9,T0SAU8,R7YY92,A0A3S1A0C3,A0A074YJ47,A0A2K1J482,A0A1Q3ENA6,O04379,A0A371I3C8,M8AEW7,A8P0D4,A0A2K3NY65,F4NYW7,A0A409Y6G2,A0A0L0HAB7,D8PZT7,A0A1D1W4K0,A7RQ46,W4YU94,A7BJS5,D8SNM6,A0A1J8PPA3,X1WG39,M5FQK2,Q69VD5,A0A2R6NSC2,A0A0D8XL16,A0A016WPN3,Q9QZ81,G5EES3,A0A0K0EFP6,Q8CJG0,A0A1D5NTU6,V2WTL2,A0A0V0YLH8,A0A139WDH0,A0A0R3W9Q7,H3DS31,A0A1Y1HWP2,G4T5G9,B7QCC4,A0A0B2UV00,M7BCJ9,E9GN30,Q7PZ41,A0A077Z361,R7U9I3,A0A1X7V1N5,A0A0K0JDP1,A0A0N4UKJ1,A0A498N3A3,A0A3M0IQP5,A0A0L8GBV4,Q32KD4,A0A1J1JBJ0,E0W4C3,A0A482XDA9,A0A3P7EJD6,J9K2Z4,A0A2J7Q8V4,T1IBM6,V3ZRX0,A0A210QKF7,A0A423TSS1,K1PT78,A0A267E8R7,A0A1D2N447,A0A226D7A9,F6YK55,T1KTE4,A0A2C9JGZ6,A0A1V9X9F0,K5X5Z7,A0A3Q0KUG5,T1FY40,3DLB,5I4A,6QZK,A0A1I7IXT4,A0A2W1JZ37,A0A2S7WBN3,A0A420DFE6,A0A4V1VDY2,A0A368P5I0,C4L1M1,A0A1M5ZSR3,A0A1I3LMA1,A0A1W6MIP2,A0A2U2J9E0,B1XJG0,A0A0B0H9B4,R6KUL9,B7GJX9,A0A1N6SSK9,A0A060HNJ0,A0A235B542,A0A1H3LE92,Q8DKB1,A0A1J1EK56,Q53W94,A0A2T1EKT1,E0UCX3,K9XZC6,B9LVW4,A0A0C1VHB4,Q31N05,R5NJJ8,Q2JI93,A0A329TD61,A0A1E3XF49,A0A1Q1FPH0,H1YCU5,L0JS08,A0A1Q5ZS75,A0A345E7N0,M0AF24,A0A1W2A082,A0A1H3X247,A0A0C1XUA0,M0D2X3,A0A346PK63,R7RTW6,A0A1H2RBI2,A0A1C3ZXN2,B9LVP8,W0JW77,F8D8G0,A0A343TL88,L0AJX6,A0A2A5QS34,A0A343JEE2,A0A3P3RGE5,A0A329TBQ3,A0A285N2A8,A0A0W1S8B8,A0A1V4C8L7,L9VRQ2,E4NRV1,A0A1I6HGN0,A0A1I0NI68,,",366,37
"1160","C.S11.1","C.S8.2",352,180,172,1.34941860465116,"4F1N,4F3T,4KRE,5GUH,5VM9,6KR6,6OON,7KX7,7SWF,A0A163JTZ6,A0A0N4X8S8,A0A196SDB4,J9D5G4,C4LVV2,A0A2P6N8X7,A8BCK6,A2DPV7,A0A0G4H2S4,T1H8B3,R1FDF0,S4RWI0,D2VMG4,A0A074TLL7,A0A0D1ZAJ4,Q1K660,F4PH46,A0A3M7S814,A0A164ZA52,A0A383WDW5,Q54G64,S7WCF7,I0YVB2,R7QGN7,C1DZY0,A0A2C5Z0M1,A0CB11,R9ACY5,D3BMP8,A0A1Z5TVE5,W7XD45,A0A1U7LLR0,A0A4S2MWZ7,K1VVQ6,A0A158P1R9,G7DVX0,V6R0U9,G4N9J3,E3KLI3,B7Q5I1,A0A1E3QC61,D5GGK8,S8ANP9,A0A139AUH8,L2GMR6,U4LBG4,A0A177URI1,O74957,A0A3N4IGK1,A6N7Y9,A0A0E9NDK5,T1KZ60,A0A250WXN5,A0A2G8JLH3,Q5KAT1,L2GUF2,W2T741,A0A1W0E4B5,A0A2J7QB22,A0A2K3CW87,A0A226EFL3,A0A3S3PD82,A0A0L0TEV1,A0A1S3J512,G0QTT2,A0A1J1HRI1,C4V9J2,Q9JMB7,A0A075AN09,Q5TW24,U5HIG6,A0A401PRI6,Q96J94,A0A2B4RHN2,G2QEV0,A0A397UU01,A0A2T7PFL8,K7ISV0,A0A024FT57,H3HCL6,A0A0G4IME3,E9FUN9,A0A1S3CYL5,D7FQK3,A0A1Y1YHC8,T1GSU4,F4S231,A0A1D8PMK0,A0A2G5B1D8,Q5BD61,A0A1C7M8P2,A0A4D8YSQ3,A0A158PJG6,J9JZ66,A0A0C2XG51,A0A158QZT6,A0A165QYQ9,T0SAU8,R7YY92,A0A3S1A0C3,A0A074YJ47,A0A2K1J482,A0A1Q3ENA6,O04379,A0A371I3C8,M8AEW7,A8P0D4,A0A2K3NY65,F4NYW7,A0A409Y6G2,A0A0L0HAB7,D8PZT7,A0A1D1W4K0,A7RQ46,W4YU94,A7BJS5,D8SNM6,A0A1J8PPA3,X1WG39,M5FQK2,Q69VD5,A0A2R6NSC2,A0A0D8XL16,A0A016WPN3,Q9QZ81,G5EES3,A0A0K0EFP6,Q8CJG0,A0A1D5NTU6,V2WTL2,A0A0V0YLH8,A0A139WDH0,A0A0R3W9Q7,H3DS31,A0A1Y1HWP2,G4T5G9,B7QCC4,A0A0B2UV00,M7BCJ9,E9GN30,Q7PZ41,A0A077Z361,R7U9I3,A0A1X7V1N5,A0A0K0JDP1,A0A0N4UKJ1,A0A498N3A3,A0A3M0IQP5,A0A0L8GBV4,Q32KD4,A0A1J1JBJ0,E0W4C3,A0A482XDA9,A0A3P7EJD6,J9K2Z4,A0A2J7Q8V4,T1IBM6,V3ZRX0,A0A210QKF7,A0A423TSS1,K1PT78,A0A267E8R7,A0A1D2N447,A0A226D7A9,F6YK55,T1KTE4,A0A2C9JGZ6,A0A1V9X9F0,K5X5Z7,A0A3Q0KUG5,T1FY40,1YVU,5AWH,5G5T,5I4A,E8N0K8,A0A1I7IXT4,A0A2W1JZ37,A0A2S7WBN3,A0A328VKE4,A0A420DFE6,E0ST67,A0A4V1VDY2,A0A368P5I0,C4L1M1,Q11QW7,A0A1M5ZSR3,A0A0K8QX04,A0A0M2PXX3,K9TPA9,A0A1W6MIP2,A0A1C0UUC4,A0A2U2J9E0,A0A2Z6E1D5,A0A0F4NXW8,A0A142XB92,L8D0R3,B1XJG0,A0A326U7G5,A0A3D8L290,H1KXR6,A0A1Q4R485,K9U8J6,A0A097QRL6,K9RC91,A0A0D8ZUC0,A0A139XGN8,A0A1T4Y3A2,Q5P0R2,B6YTQ5,A0A0B0H9B4,A0YYT3,A0A2T1EFY0,G6FTN0,R6KUL9,A0A433NB65,A0A1Z4L0A1,K9UQR0,A0A2T1G8M7,K9VUN0,B7GJX9,A0A0P6X5X2,K9ZDE3,B0JXD6,A0A2T1LS63,A0A1Z4K1Y3,A0A2Z6E0R7,A0A1N6SSK9,A0A0P4UVI8,A0A0V7ZCG4,A0A1J0AGK2,K9PFF9,A0A2G9DT08,K9UEV4,Q9L1X1,A0A060HNJ0,A0A235B542,R5XQK4,A0A1H3LE92,A0A496APJ8,A0A062U2W9,H0HWQ5,A0A1V9G9U4,A0A1I2ZGP1,A0A317EJY3,A0A1I2BD20,F8ERC7,S7VLM7,A0A1A5X8H4,A0A1I2T6Q1,A0A1R3T9N6,A0A0Q2M2Z1,H8KXJ0,D3S0S6,A0A2D1U4H7,I3TE64,A0A0B7I4Z6,A0LL61,Q8DKB1,A0A1J1EK56,A0A2T1E1K4,A0A1Q8ZD62,A0A4Q6XKV6,A0A1Z3HNN4,A0A239JE83,A0A2N4XBY2,Q53W94,R5JEI2,A0A0Q0ZC47,A0A2T0XH18,A0A1V4CHV0,A0A1K1RQP7,A0A2T1EKT1,A0A1N6LUI7,A0A0P0NGR6,A0A1X7IML5,A0A0A2LKJ7,K1L112,A0A0U3AL92,A0A1H3A054,E0UCX3,K9XZC6,B9LVW4,A0A0C1VHB4,Q31N05,A0A0C5JKF3,R5NJJ8,A5D4D9,Q2JI93,A0A142Y7A9,A0A432MEQ5,A0A372DKU2,A0A3R7KLK4,C1F5Q7,A0A4R3EV39,A0A1P8WP90,A0A222F7P0,A0A1C9VH88,A0A2T2YMB1,A0A101R2A0,A0A1E3XF49,A0A1U9ND56,A0A4R7BQC4,A0A1H3DGN3,A0A1Q1FPH0,E0TGY3,A0A259TUP4,F6EYI8,A0A2S9Q9J0,A0A4Q2UIU6,A0A1H0LH25,A0A318LG42,H1YCU5,L0JS08,A0A1Q5ZS75,A0A345E7N0,M0AF24,A0A1W2A082,A0A1H3X247,A0A0C1XUA0,M0D2X3,A0A2R5G167,A0A346PK63,R7RTW6,A0A1H2RBI2,A0A1C3ZXN2,B9LVP8,M5RSF0,W0JW77,B7K585,F8D8G0,A0A343TL88,L0AJX6,A0A2A5QS34,A0A343JEE2,A0A3P3RGE5,A0A285N2A8,A0A0W1S8B8,A0A1V4C8L7,L9VRQ2,E4NRV1,A0A1I6HGN0,A0A1I0NI68,,",366,37
"1161","C.S11.3","C.S8.2",363,180,183,1.06047358834244,"4F1N,4F3T,4KRE,5GUH,5VM9,6KR6,6OON,7KX7,7SWF,A0A163JTZ6,A0A0N4X8S8,A0A196SDB4,J9D5G4,C4LVV2,A0A2P6N8X7,A8BCK6,A2DPV7,A0A0G4H2S4,T1H8B3,R1FDF0,S4RWI0,D2VMG4,A0A074TLL7,A0A0D1ZAJ4,Q1K660,F4PH46,A0A3M7S814,A0A164ZA52,A0A383WDW5,Q54G64,S7WCF7,I0YVB2,R7QGN7,C1DZY0,A0A2C5Z0M1,A0CB11,R9ACY5,D3BMP8,A0A1Z5TVE5,W7XD45,A0A1U7LLR0,A0A4S2MWZ7,K1VVQ6,A0A158P1R9,G7DVX0,V6R0U9,G4N9J3,E3KLI3,B7Q5I1,A0A1E3QC61,D5GGK8,S8ANP9,A0A139AUH8,L2GMR6,U4LBG4,A0A177URI1,O74957,A0A3N4IGK1,A6N7Y9,A0A0E9NDK5,T1KZ60,A0A250WXN5,A0A2G8JLH3,Q5KAT1,L2GUF2,W2T741,A0A1W0E4B5,A0A2J7QB22,A0A2K3CW87,A0A226EFL3,A0A3S3PD82,A0A0L0TEV1,A0A1S3J512,G0QTT2,A0A1J1HRI1,C4V9J2,Q9JMB7,A0A075AN09,Q5TW24,U5HIG6,A0A401PRI6,Q96J94,A0A2B4RHN2,G2QEV0,A0A397UU01,A0A2T7PFL8,K7ISV0,A0A024FT57,H3HCL6,A0A0G4IME3,E9FUN9,A0A1S3CYL5,D7FQK3,A0A1Y1YHC8,T1GSU4,F4S231,A0A1D8PMK0,A0A2G5B1D8,Q5BD61,A0A1C7M8P2,A0A4D8YSQ3,A0A158PJG6,J9JZ66,A0A0C2XG51,A0A158QZT6,A0A165QYQ9,T0SAU8,R7YY92,A0A3S1A0C3,A0A074YJ47,A0A2K1J482,A0A1Q3ENA6,O04379,A0A371I3C8,M8AEW7,A8P0D4,A0A2K3NY65,F4NYW7,A0A409Y6G2,A0A0L0HAB7,D8PZT7,A0A1D1W4K0,A7RQ46,W4YU94,A7BJS5,D8SNM6,A0A1J8PPA3,X1WG39,M5FQK2,Q69VD5,A0A2R6NSC2,A0A0D8XL16,A0A016WPN3,Q9QZ81,G5EES3,A0A0K0EFP6,Q8CJG0,A0A1D5NTU6,V2WTL2,A0A0V0YLH8,A0A139WDH0,A0A0R3W9Q7,H3DS31,A0A1Y1HWP2,G4T5G9,B7QCC4,A0A0B2UV00,M7BCJ9,E9GN30,Q7PZ41,A0A077Z361,R7U9I3,A0A1X7V1N5,A0A0K0JDP1,A0A0N4UKJ1,A0A498N3A3,A0A3M0IQP5,A0A0L8GBV4,Q32KD4,A0A1J1JBJ0,E0W4C3,A0A482XDA9,A0A3P7EJD6,J9K2Z4,A0A2J7Q8V4,T1IBM6,V3ZRX0,A0A210QKF7,A0A423TSS1,K1PT78,A0A267E8R7,A0A1D2N447,A0A226D7A9,F6YK55,T1KTE4,A0A2C9JGZ6,A0A1V9X9F0,K5X5Z7,A0A3Q0KUG5,T1FY40,1YVU,1Z26,3DLB,5AWH,5G5T,5I4A,6QZK,7R8K,E8N0K8,A0A1I7IXT4,A0A2W1JZ37,A0A2S7WBN3,A0A328VKE4,A0A420DFE6,E0ST67,A0A4V1VDY2,A0A368P5I0,C4L1M1,A0A4R1RMM2,A0A1Y2RDH8,Q11QW7,A0A1M5ZSR3,A0A0K8QX04,A0A0M2PXX3,A0A1I3LMA1,K9TPA9,A0A1L3JHM3,A0A1W6MIP2,A0A1C0UUC4,A0A2U2J9E0,A0A2Z6E1D5,A0A0F4NXW8,A0A142XB92,L8D0R3,B1XJG0,A0A326U7G5,A0A3D8L290,H1KXR6,A0A1Q4R485,K9U8J6,A0A097QRL6,K9RC91,A0A0D8ZUC0,A0A139XGN8,A0A1T4Y3A2,Q5P0R2,B6YTQ5,A0A0B0H9B4,A0YYT3,A0A2T1EFY0,G6FTN0,R6KUL9,A0A433NB65,A0A1Z4L0A1,K9UQR0,A0A2T1G8M7,K9VUN0,B7GJX9,A0A0P6X5X2,K9ZDE3,B0JXD6,A0A2T1LS63,A0A1Z4K1Y3,A0A2Z6E0R7,A0A1N6SSK9,A0A0P4UVI8,A0A0V7ZCG4,A0A1J0AGK2,K9PFF9,A0A2G9DT08,K9UEV4,Q9L1X1,A0A060HNJ0,A0A235B542,R5XQK4,A0A1H3LE92,A0A496APJ8,A0A062U2W9,H0HWQ5,A0A1V9G9U4,A0A1I2ZGP1,A0A317EJY3,A0A1I2BD20,F8ERC7,S7VLM7,A0A1A5X8H4,A0A1I2T6Q1,A0A1R3T9N6,A0A0Q2M2Z1,H8KXJ0,D3S0S6,A0A2D1U4H7,I3TE64,A0A0B7I4Z6,A0LL61,Q8DKB1,A0A139WY18,A0A1J1EK56,A0A2T1E1K4,A0A1Q8ZD62,A0A4Q6XKV6,A0A1Z3HNN4,A0A239JE83,A0A2N4XBY2,Q53W94,R5JEI2,A0A0Q0ZC47,A0A2T0XH18,A0A1V4CHV0,A0A1K1RQP7,A0A2T1EKT1,A0A1N6LUI7,A0A0P0NGR6,A0A1X7IML5,A0A0A2LKJ7,K1L112,A0A0U3AL92,A0A1H3A054,E0UCX3,K9XZC6,B9LVW4,A0A0C1VHB4,Q31N05,A0A0C5JKF3,R5NJJ8,A5D4D9,Q2JI93,A0A142Y7A9,A0A432MEQ5,A0A372DKU2,A0A3R7KLK4,C1F5Q7,A0A4R3EV39,A0A1P8WP90,A0A222F7P0,A0A1C9VH88,A0A2T2YMB1,A0A329TD61,A0A101R2A0,A0A1E3XF49,A0A1U9ND56,A0A4R7BQC4,A0A1H3DGN3,A0A1Q1FPH0,E0TGY3,A0A259TUP4,F6EYI8,A0A2S9Q9J0,A0A4Q2UIU6,A0A1H0LH25,A0A318LG42,H1YCU5,L0JS08,A0A1Q5ZS75,A0A345E7N0,M0AF24,A0A1W2A082,A0A1H3X247,A0A0C1XUA0,M0D2X3,A0A2R5G167,A0A346PK63,R7RTW6,A0A1H2RBI2,A0A1C3ZXN2,B9LVP8,M5RSF0,W0JW77,B7K585,F8D8G0,A0A343TL88,L0AJX6,A0A2A5QS34,A0A343JEE2,A0A3P3RGE5,A0A329TBQ3,A0A285N2A8,A0A0W1S8B8,A0A1V4C8L7,L9VRQ2,E4NRV1,A0A1I6HGN0,A0A1I0NI68,,",366,37
"1162","C.S11.3","C.S8.3",362,180,182,2.71263736263736,"4F1N,4F3T,4KRE,5GUH,5VM9,6KR6,6OON,7KX7,7SWF,A0A163JTZ6,A0A0N4X8S8,A0A196SDB4,J9D5G4,C4LVV2,A0A2P6N8X7,A8BCK6,A2DPV7,A0A0G4H2S4,T1H8B3,R1FDF0,S4RWI0,D2VMG4,A0A074TLL7,A0A0D1ZAJ4,Q1K660,F4PH46,A0A3M7S814,A0A164ZA52,A0A383WDW5,Q54G64,S7WCF7,I0YVB2,R7QGN7,C1DZY0,A0A2C5Z0M1,A0CB11,R9ACY5,D3BMP8,A0A1Z5TVE5,W7XD45,A0A1U7LLR0,A0A4S2MWZ7,K1VVQ6,A0A158P1R9,G7DVX0,V6R0U9,G4N9J3,E3KLI3,B7Q5I1,A0A1E3QC61,D5GGK8,S8ANP9,A0A139AUH8,L2GMR6,U4LBG4,A0A177URI1,O74957,A0A3N4IGK1,A6N7Y9,A0A0E9NDK5,T1KZ60,A0A250WXN5,A0A2G8JLH3,Q5KAT1,L2GUF2,W2T741,A0A1W0E4B5,A0A2J7QB22,A0A2K3CW87,A0A226EFL3,A0A3S3PD82,A0A0L0TEV1,A0A1S3J512,G0QTT2,A0A1J1HRI1,C4V9J2,Q9JMB7,A0A075AN09,Q5TW24,U5HIG6,A0A401PRI6,Q96J94,A0A2B4RHN2,G2QEV0,A0A397UU01,A0A2T7PFL8,K7ISV0,A0A024FT57,H3HCL6,A0A0G4IME3,E9FUN9,A0A1S3CYL5,D7FQK3,A0A1Y1YHC8,T1GSU4,F4S231,A0A1D8PMK0,A0A2G5B1D8,Q5BD61,A0A1C7M8P2,A0A4D8YSQ3,A0A158PJG6,J9JZ66,A0A0C2XG51,A0A158QZT6,A0A165QYQ9,T0SAU8,R7YY92,A0A3S1A0C3,A0A074YJ47,A0A2K1J482,A0A1Q3ENA6,O04379,A0A371I3C8,M8AEW7,A8P0D4,A0A2K3NY65,F4NYW7,A0A409Y6G2,A0A0L0HAB7,D8PZT7,A0A1D1W4K0,A7RQ46,W4YU94,A7BJS5,D8SNM6,A0A1J8PPA3,X1WG39,M5FQK2,Q69VD5,A0A2R6NSC2,A0A0D8XL16,A0A016WPN3,Q9QZ81,G5EES3,A0A0K0EFP6,Q8CJG0,A0A1D5NTU6,V2WTL2,A0A0V0YLH8,A0A139WDH0,A0A0R3W9Q7,H3DS31,A0A1Y1HWP2,G4T5G9,B7QCC4,A0A0B2UV00,M7BCJ9,E9GN30,Q7PZ41,A0A077Z361,R7U9I3,A0A1X7V1N5,A0A0K0JDP1,A0A0N4UKJ1,A0A498N3A3,A0A3M0IQP5,A0A0L8GBV4,Q32KD4,A0A1J1JBJ0,E0W4C3,A0A482XDA9,A0A3P7EJD6,J9K2Z4,A0A2J7Q8V4,T1IBM6,V3ZRX0,A0A210QKF7,A0A423TSS1,K1PT78,A0A267E8R7,A0A1D2N447,A0A226D7A9,F6YK55,T1KTE4,A0A2C9JGZ6,A0A1V9X9F0,K5X5Z7,A0A3Q0KUG5,T1FY40,1YVU,1Z26,3DLB,5AWH,5G5T,5I4A,6QZK,7R8K,E8N0K8,A0A1I7IXT4,A0A2W1JZ37,A0A2S7WBN3,A0A328VKE4,A0A420DFE6,E0ST67,A0A4V1VDY2,A0A368P5I0,C4L1M1,A0A4R1RMM2,A0A1Y2RDH8,Q11QW7,A0A1M5ZSR3,A0A0K8QX04,A0A0M2PXX3,A0A1I3LMA1,K9TPA9,A0A1L3JHM3,A0A1W6MIP2,A0A1C0UUC4,A0A2U2J9E0,A0A2Z6E1D5,A0A0F4NXW8,A0A142XB92,L8D0R3,B1XJG0,A0A326U7G5,A0A3D8L290,H1KXR6,A0A1Q4R485,K9U8J6,A0A097QRL6,K9RC91,A0A0D8ZUC0,A0A139XGN8,A0A1T4Y3A2,Q5P0R2,B6YTQ5,A0A0B0H9B4,A0YYT3,A0A2T1EFY0,G6FTN0,R6KUL9,A0A433NB65,A0A1Z4L0A1,K9UQR0,A0A2T1G8M7,K9VUN0,B7GJX9,A0A0P6X5X2,K9ZDE3,B0JXD6,A0A2T1LS63,A0A1Z4K1Y3,A0A2Z6E0R7,A0A1N6SSK9,A0A0P4UVI8,A0A0V7ZCG4,A0A1J0AGK2,K9PFF9,A0A2G9DT08,K9UEV4,Q9L1X1,A0A060HNJ0,A0A235B542,R5XQK4,A0A1H3LE92,A0A496APJ8,A0A062U2W9,H0HWQ5,A0A1V9G9U4,A0A1I2ZGP1,A0A317EJY3,A0A1I2BD20,F8ERC7,S7VLM7,A0A1A5X8H4,A0A1I2T6Q1,A0A1R3T9N6,A0A0Q2M2Z1,H8KXJ0,D3S0S6,A0A2D1U4H7,I3TE64,A0A0B7I4Z6,A0LL61,Q8DKB1,A0A139WY18,A0A1J1EK56,A0A2T1E1K4,A0A1Q8ZD62,A0A4Q6XKV6,A0A1Z3HNN4,A0A239JE83,A0A2N4XBY2,Q53W94,R5JEI2,A0A0Q0ZC47,A0A2T0XH18,A0A1V4CHV0,A0A1K1RQP7,A0A2T1EKT1,A0A1N6LUI7,A0A0P0NGR6,A0A1X7IML5,A0A0A2LKJ7,K1L112,A0A0U3AL92,A0A1H3A054,E0UCX3,K9XZC6,A0A0C1VHB4,Q31N05,A0A0C5JKF3,R5NJJ8,A5D4D9,Q2JI93,A0A142Y7A9,A0A432MEQ5,A0A372DKU2,A0A3R7KLK4,C1F5Q7,A0A4R3EV39,A0A1P8WP90,A0A222F7P0,A0A1C9VH88,A0A2T2YMB1,A0A329TD61,A0A101R2A0,A0A1E3XF49,A0A1U9ND56,A0A4R7BQC4,A0A1H3DGN3,A0A1Q1FPH0,E0TGY3,A0A259TUP4,F6EYI8,A0A2S9Q9J0,A0A4Q2UIU6,A0A1H0LH25,A0A318LG42,H1YCU5,L0JS08,A0A1Q5ZS75,A0A345E7N0,M0AF24,A0A1W2A082,A0A1H3X247,A0A0C1XUA0,M0D2X3,A0A2R5G167,A0A346PK63,R7RTW6,A0A1H2RBI2,A0A1C3ZXN2,B9LVP8,M5RSF0,W0JW77,B7K585,F8D8G0,A0A343TL88,L0AJX6,A0A2A5QS34,A0A343JEE2,A0A3P3RGE5,A0A329TBQ3,A0A285N2A8,A0A0W1S8B8,A0A1V4C8L7,L9VRQ2,E4NRV1,A0A1I6HGN0,A0A1I0NI68,,",366,37
"1163","C.S11.3","C.S8.4",362,180,182,2.09282661782662,"4F1N,4F3T,4KRE,5GUH,5VM9,6KR6,6OON,7KX7,7SWF,A0A163JTZ6,A0A0N4X8S8,A0A196SDB4,J9D5G4,C4LVV2,A0A2P6N8X7,A8BCK6,A2DPV7,A0A0G4H2S4,T1H8B3,R1FDF0,S4RWI0,D2VMG4,A0A074TLL7,A0A0D1ZAJ4,Q1K660,F4PH46,A0A3M7S814,A0A164ZA52,A0A383WDW5,Q54G64,S7WCF7,I0YVB2,R7QGN7,C1DZY0,A0A2C5Z0M1,A0CB11,R9ACY5,D3BMP8,A0A1Z5TVE5,W7XD45,A0A1U7LLR0,A0A4S2MWZ7,K1VVQ6,A0A158P1R9,G7DVX0,V6R0U9,G4N9J3,E3KLI3,B7Q5I1,A0A1E3QC61,D5GGK8,S8ANP9,A0A139AUH8,L2GMR6,U4LBG4,A0A177URI1,O74957,A0A3N4IGK1,A6N7Y9,A0A0E9NDK5,T1KZ60,A0A250WXN5,A0A2G8JLH3,Q5KAT1,L2GUF2,W2T741,A0A1W0E4B5,A0A2J7QB22,A0A2K3CW87,A0A226EFL3,A0A3S3PD82,A0A0L0TEV1,A0A1S3J512,G0QTT2,A0A1J1HRI1,C4V9J2,Q9JMB7,A0A075AN09,Q5TW24,U5HIG6,A0A401PRI6,Q96J94,A0A2B4RHN2,G2QEV0,A0A397UU01,A0A2T7PFL8,K7ISV0,A0A024FT57,H3HCL6,A0A0G4IME3,E9FUN9,A0A1S3CYL5,D7FQK3,A0A1Y1YHC8,T1GSU4,F4S231,A0A1D8PMK0,A0A2G5B1D8,Q5BD61,A0A1C7M8P2,A0A4D8YSQ3,A0A158PJG6,J9JZ66,A0A0C2XG51,A0A158QZT6,A0A165QYQ9,T0SAU8,R7YY92,A0A3S1A0C3,A0A074YJ47,A0A2K1J482,A0A1Q3ENA6,O04379,A0A371I3C8,M8AEW7,A8P0D4,A0A2K3NY65,F4NYW7,A0A409Y6G2,A0A0L0HAB7,D8PZT7,A0A1D1W4K0,A7RQ46,W4YU94,A7BJS5,D8SNM6,A0A1J8PPA3,X1WG39,M5FQK2,Q69VD5,A0A2R6NSC2,A0A0D8XL16,A0A016WPN3,Q9QZ81,G5EES3,A0A0K0EFP6,Q8CJG0,A0A1D5NTU6,V2WTL2,A0A0V0YLH8,A0A139WDH0,A0A0R3W9Q7,H3DS31,A0A1Y1HWP2,G4T5G9,B7QCC4,A0A0B2UV00,M7BCJ9,E9GN30,Q7PZ41,A0A077Z361,R7U9I3,A0A1X7V1N5,A0A0K0JDP1,A0A0N4UKJ1,A0A498N3A3,A0A3M0IQP5,A0A0L8GBV4,Q32KD4,A0A1J1JBJ0,E0W4C3,A0A482XDA9,A0A3P7EJD6,J9K2Z4,A0A2J7Q8V4,T1IBM6,V3ZRX0,A0A210QKF7,A0A423TSS1,K1PT78,A0A267E8R7,A0A1D2N447,A0A226D7A9,F6YK55,T1KTE4,A0A2C9JGZ6,A0A1V9X9F0,K5X5Z7,A0A3Q0KUG5,T1FY40,1YVU,1Z26,3DLB,5AWH,5G5T,5I4A,6QZK,7R8K,E8N0K8,A0A1I7IXT4,A0A2W1JZ37,A0A2S7WBN3,A0A328VKE4,A0A420DFE6,E0ST67,A0A4V1VDY2,A0A368P5I0,C4L1M1,A0A4R1RMM2,A0A1Y2RDH8,Q11QW7,A0A1M5ZSR3,A0A0K8QX04,A0A0M2PXX3,A0A1I3LMA1,K9TPA9,A0A1L3JHM3,A0A1W6MIP2,A0A1C0UUC4,A0A2U2J9E0,A0A2Z6E1D5,A0A0F4NXW8,A0A142XB92,L8D0R3,B1XJG0,A0A326U7G5,A0A3D8L290,H1KXR6,A0A1Q4R485,K9U8J6,A0A097QRL6,K9RC91,A0A0D8ZUC0,A0A139XGN8,A0A1T4Y3A2,Q5P0R2,B6YTQ5,A0A0B0H9B4,A0YYT3,A0A2T1EFY0,G6FTN0,R6KUL9,A0A433NB65,A0A1Z4L0A1,K9UQR0,A0A2T1G8M7,K9VUN0,B7GJX9,A0A0P6X5X2,K9ZDE3,B0JXD6,A0A2T1LS63,A0A1Z4K1Y3,A0A2Z6E0R7,A0A1N6SSK9,A0A0P4UVI8,A0A0V7ZCG4,A0A1J0AGK2,K9PFF9,A0A2G9DT08,K9UEV4,Q9L1X1,A0A060HNJ0,A0A235B542,R5XQK4,A0A1H3LE92,A0A496APJ8,A0A062U2W9,H0HWQ5,A0A1V9G9U4,A0A1I2ZGP1,A0A317EJY3,A0A1I2BD20,F8ERC7,S7VLM7,A0A1A5X8H4,A0A1I2T6Q1,A0A1R3T9N6,A0A0Q2M2Z1,H8KXJ0,D3S0S6,A0A2D1U4H7,I3TE64,A0A0B7I4Z6,A0LL61,Q8DKB1,A0A139WY18,A0A1J1EK56,A0A2T1E1K4,A0A1Q8ZD62,A0A4Q6XKV6,A0A1Z3HNN4,A0A239JE83,A0A2N4XBY2,Q53W94,R5JEI2,A0A0Q0ZC47,A0A2T0XH18,A0A1V4CHV0,A0A1K1RQP7,A0A2T1EKT1,A0A1N6LUI7,A0A0P0NGR6,A0A1X7IML5,A0A0A2LKJ7,K1L112,A0A0U3AL92,A0A1H3A054,E0UCX3,K9XZC6,A0A0C1VHB4,Q31N05,A0A0C5JKF3,R5NJJ8,A5D4D9,Q2JI93,A0A142Y7A9,A0A432MEQ5,A0A372DKU2,A0A3R7KLK4,C1F5Q7,A0A4R3EV39,A0A1P8WP90,A0A222F7P0,A0A1C9VH88,A0A2T2YMB1,A0A329TD61,A0A101R2A0,A0A1E3XF49,A0A1U9ND56,A0A4R7BQC4,A0A1H3DGN3,A0A1Q1FPH0,E0TGY3,A0A259TUP4,F6EYI8,A0A2S9Q9J0,A0A4Q2UIU6,A0A1H0LH25,A0A318LG42,H1YCU5,L0JS08,A0A1Q5ZS75,A0A345E7N0,M0AF24,A0A1W2A082,A0A1H3X247,A0A0C1XUA0,M0D2X3,A0A2R5G167,A0A346PK63,R7RTW6,A0A1H2RBI2,A0A1C3ZXN2,B9LVP8,M5RSF0,W0JW77,B7K585,F8D8G0,A0A343TL88,L0AJX6,A0A2A5QS34,A0A343JEE2,A0A3P3RGE5,A0A329TBQ3,A0A285N2A8,A0A0W1S8B8,A0A1V4C8L7,L9VRQ2,E4NRV1,A0A1I6HGN0,A0A1I0NI68,,",366,37
"1165","C.S11.5","C.S8.4",362,180,182,2.03177655677656,"4F1N,4F3T,4KRE,5GUH,5VM9,6KR6,6OON,7KX7,7SWF,A0A163JTZ6,A0A0N4X8S8,A0A196SDB4,J9D5G4,C4LVV2,A0A2P6N8X7,A8BCK6,A2DPV7,A0A0G4H2S4,T1H8B3,R1FDF0,S4RWI0,D2VMG4,A0A074TLL7,A0A0D1ZAJ4,Q1K660,F4PH46,A0A3M7S814,A0A164ZA52,A0A383WDW5,Q54G64,S7WCF7,I0YVB2,R7QGN7,C1DZY0,A0A2C5Z0M1,A0CB11,R9ACY5,D3BMP8,A0A1Z5TVE5,W7XD45,A0A1U7LLR0,A0A4S2MWZ7,K1VVQ6,A0A158P1R9,G7DVX0,V6R0U9,G4N9J3,E3KLI3,B7Q5I1,A0A1E3QC61,D5GGK8,S8ANP9,A0A139AUH8,L2GMR6,U4LBG4,A0A177URI1,O74957,A0A3N4IGK1,A6N7Y9,A0A0E9NDK5,T1KZ60,A0A250WXN5,A0A2G8JLH3,Q5KAT1,L2GUF2,W2T741,A0A1W0E4B5,A0A2J7QB22,A0A2K3CW87,A0A226EFL3,A0A3S3PD82,A0A0L0TEV1,A0A1S3J512,G0QTT2,A0A1J1HRI1,C4V9J2,Q9JMB7,A0A075AN09,Q5TW24,U5HIG6,A0A401PRI6,Q96J94,A0A2B4RHN2,G2QEV0,A0A397UU01,A0A2T7PFL8,K7ISV0,A0A024FT57,H3HCL6,A0A0G4IME3,E9FUN9,A0A1S3CYL5,D7FQK3,A0A1Y1YHC8,T1GSU4,F4S231,A0A1D8PMK0,A0A2G5B1D8,Q5BD61,A0A1C7M8P2,A0A4D8YSQ3,A0A158PJG6,J9JZ66,A0A0C2XG51,A0A158QZT6,A0A165QYQ9,T0SAU8,R7YY92,A0A3S1A0C3,A0A074YJ47,A0A2K1J482,A0A1Q3ENA6,O04379,A0A371I3C8,M8AEW7,A8P0D4,A0A2K3NY65,F4NYW7,A0A409Y6G2,A0A0L0HAB7,D8PZT7,A0A1D1W4K0,A7RQ46,W4YU94,A7BJS5,D8SNM6,A0A1J8PPA3,X1WG39,M5FQK2,Q69VD5,A0A2R6NSC2,A0A0D8XL16,A0A016WPN3,Q9QZ81,G5EES3,A0A0K0EFP6,Q8CJG0,A0A1D5NTU6,V2WTL2,A0A0V0YLH8,A0A139WDH0,A0A0R3W9Q7,H3DS31,A0A1Y1HWP2,G4T5G9,B7QCC4,A0A0B2UV00,M7BCJ9,E9GN30,Q7PZ41,A0A077Z361,R7U9I3,A0A1X7V1N5,A0A0K0JDP1,A0A0N4UKJ1,A0A498N3A3,A0A3M0IQP5,A0A0L8GBV4,Q32KD4,A0A1J1JBJ0,E0W4C3,A0A482XDA9,A0A3P7EJD6,J9K2Z4,A0A2J7Q8V4,T1IBM6,V3ZRX0,A0A210QKF7,A0A423TSS1,K1PT78,A0A267E8R7,A0A1D2N447,A0A226D7A9,F6YK55,T1KTE4,A0A2C9JGZ6,A0A1V9X9F0,K5X5Z7,A0A3Q0KUG5,T1FY40,1YVU,1Z26,3DLB,5AWH,5G5T,5I4A,6QZK,7R8K,E8N0K8,A0A1I7IXT4,A0A2W1JZ37,A0A2S7WBN3,A0A328VKE4,A0A420DFE6,E0ST67,A0A4V1VDY2,A0A368P5I0,C4L1M1,A0A4R1RMM2,A0A1Y2RDH8,Q11QW7,A0A1M5ZSR3,A0A0K8QX04,A0A0M2PXX3,A0A1I3LMA1,K9TPA9,A0A1L3JHM3,A0A1W6MIP2,A0A1C0UUC4,A0A2U2J9E0,A0A2Z6E1D5,A0A0F4NXW8,A0A142XB92,L8D0R3,B1XJG0,A0A326U7G5,A0A3D8L290,H1KXR6,A0A1Q4R485,K9U8J6,A0A097QRL6,K9RC91,A0A0D8ZUC0,A0A139XGN8,A0A1T4Y3A2,Q5P0R2,B6YTQ5,A0A0B0H9B4,A0YYT3,A0A2T1EFY0,G6FTN0,R6KUL9,A0A433NB65,A0A1Z4L0A1,K9UQR0,A0A2T1G8M7,K9VUN0,B7GJX9,A0A0P6X5X2,K9ZDE3,B0JXD6,A0A2T1LS63,A0A1Z4K1Y3,A0A2Z6E0R7,A0A1N6SSK9,A0A0P4UVI8,A0A0V7ZCG4,A0A1J0AGK2,K9PFF9,A0A2G9DT08,K9UEV4,Q9L1X1,A0A060HNJ0,A0A235B542,R5XQK4,A0A1H3LE92,A0A496APJ8,A0A062U2W9,H0HWQ5,A0A1V9G9U4,A0A1I2ZGP1,A0A317EJY3,A0A1I2BD20,F8ERC7,S7VLM7,A0A1A5X8H4,A0A1I2T6Q1,A0A1R3T9N6,A0A0Q2M2Z1,H8KXJ0,D3S0S6,A0A2D1U4H7,I3TE64,A0A0B7I4Z6,A0LL61,Q8DKB1,A0A139WY18,A0A1J1EK56,A0A2T1E1K4,A0A1Q8ZD62,A0A4Q6XKV6,A0A1Z3HNN4,A0A239JE83,A0A2N4XBY2,Q53W94,R5JEI2,A0A0Q0ZC47,A0A2T0XH18,A0A1V4CHV0,A0A1K1RQP7,A0A2T1EKT1,A0A1N6LUI7,A0A0P0NGR6,A0A1X7IML5,A0A0A2LKJ7,K1L112,A0A0U3AL92,A0A1H3A054,E0UCX3,K9XZC6,A0A0C1VHB4,Q31N05,A0A0C5JKF3,R5NJJ8,A5D4D9,Q2JI93,A0A142Y7A9,A0A432MEQ5,A0A372DKU2,A0A3R7KLK4,C1F5Q7,A0A4R3EV39,A0A1P8WP90,A0A222F7P0,A0A1C9VH88,A0A2T2YMB1,A0A329TD61,A0A101R2A0,A0A1E3XF49,A0A1U9ND56,A0A4R7BQC4,A0A1H3DGN3,A0A1Q1FPH0,E0TGY3,A0A259TUP4,F6EYI8,A0A2S9Q9J0,A0A4Q2UIU6,A0A1H0LH25,A0A318LG42,H1YCU5,L0JS08,A0A1Q5ZS75,A0A345E7N0,M0AF24,A0A1W2A082,A0A1H3X247,A0A0C1XUA0,M0D2X3,A0A2R5G167,A0A346PK63,R7RTW6,A0A1H2RBI2,A0A1C3ZXN2,B9LVP8,M5RSF0,W0JW77,B7K585,F8D8G0,A0A343TL88,L0AJX6,A0A2A5QS34,A0A343JEE2,A0A3P3RGE5,A0A329TBQ3,A0A285N2A8,A0A0W1S8B8,A0A1V4C8L7,L9VRQ2,E4NRV1,A0A1I6HGN0,A0A1I0NI68,,",366,37
"1166","C.S11.6","C.S12.6",320,180,140,2.55357142857143,"4F1N,4F3T,4KRE,5GUH,5VM9,6KR6,6OON,7KX7,7SWF,A0A163JTZ6,A0A0N4X8S8,A0A196SDB4,J9D5G4,Q389P5,C4LVV2,A0A2P6N8X7,A8BCK6,A2DPV7,A0A0G4H2S4,T1H8B3,R1FDF0,S4RWI0,D2VMG4,A0A074TLL7,A0A0D1ZAJ4,Q1K660,F4PH46,A0A3M7S814,A0A164ZA52,A0A383WDW5,Q54G64,S7WCF7,I0YVB2,R7QGN7,C1DZY0,A0A2C5Z0M1,A0CB11,R9ACY5,D3BMP8,A0A1Z5TVE5,W7XD45,A0A1U7LLR0,A0A4S2MWZ7,K1VVQ6,A0A158P1R9,G7DVX0,V6R0U9,G4N9J3,E3KLI3,B7Q5I1,A0A1E3QC61,D5GGK8,S8ANP9,A0A139AUH8,L2GMR6,U4LBG4,A0A177URI1,O74957,A0A3N4IGK1,A6N7Y9,A0A0E9NDK5,T1KZ60,A0A250WXN5,A0A2G8JLH3,Q5KAT1,L2GUF2,W2T741,A0A1W0E4B5,A0A2J7QB22,A0A2K3CW87,A0A226EFL3,A0A3S3PD82,A0A0L0TEV1,A0A1S3J512,G0QTT2,A0A1J1HRI1,C4V9J2,Q9JMB7,A0A075AN09,Q5TW24,U5HIG6,A0A401PRI6,Q96J94,A0A2B4RHN2,G2QEV0,A0A397UU01,A0A2T7PFL8,K7ISV0,A0A024FT57,H3HCL6,A0A0G4IME3,E9FUN9,A0A1S3CYL5,D7FQK3,A0A1Y1YHC8,T1GSU4,F4S231,A0A1D8PMK0,A0A2G5B1D8,Q5BD61,A0A1C7M8P2,A0A4D8YSQ3,A0A158PJG6,J9JZ66,A0A0C2XG51,A0A158QZT6,A0A165QYQ9,T0SAU8,R7YY92,A0A3S1A0C3,A0A074YJ47,A0A2K1J482,A0A1Q3ENA6,O04379,A0A371I3C8,A8P0D4,A0A2K3NY65,F4NYW7,A0A409Y6G2,A0A0L0HAB7,D8PZT7,A0A1D1W4K0,A7RQ46,W4YU94,A7BJS5,D8SNM6,A0A1J8PPA3,X1WG39,M5FQK2,Q69VD5,A0A2R6NSC2,A0A0D8XL16,A0A016WPN3,Q9QZ81,G5EES3,A0A0K0EFP6,Q8CJG0,A0A1D5NTU6,V2WTL2,A0A0V0YLH8,A0A139WDH0,A0A0R3W9Q7,H3DS31,A0A1Y1HWP2,G4T5G9,B7QCC4,A0A0B2UV00,M7BCJ9,E9GN30,Q7PZ41,A0A077Z361,R7U9I3,A0A1X7V1N5,A0A0K0JDP1,A0A0N4UKJ1,A0A498N3A3,A0A3M0IQP5,A0A0L8GBV4,Q32KD4,A0A1J1JBJ0,E0W4C3,A0A482XDA9,A0A3P7EJD6,J9K2Z4,A0A2J7Q8V4,T1IBM6,V3ZRX0,A0A210QKF7,A0A423TSS1,K1PT78,A0A267E8R7,A0A1D2N447,A0A226D7A9,F6YK55,T1KTE4,A0A2C9JGZ6,A0A1V9X9F0,K5X5Z7,A0A3Q0KUG5,T1FY40,1YVU,3DLB,5AWH,5G5T,6QZK,7R8K,A0A1I7IXT4,A0A2W1JZ37,A0A2S7WBN3,A0A420DFE6,E0ST67,A0A4V1VDY2,A0A368P5I0,A0A4R1RMM2,A0A1Y2RDH8,A0A0M2PXX3,A0A1I3LMA1,A0A1L3JHM3,A0A1W6MIP2,A0A1C0UUC4,A0A2U2J9E0,A0A2Z6E1D5,A0A0F4NXW8,A0A142XB92,L8D0R3,B1XJG0,A0A3D8L290,A0A1T4Y3A2,Q5P0R2,A0A433NB65,B7GJX9,A0A0P6X5X2,A0A2Z6E0R7,A0A2G9DT08,Q9L1X1,A0A060HNJ0,A0A235B542,R5XQK4,A0A1H3LE92,A0A496APJ8,A0A062U2W9,H0HWQ5,A0A1V9G9U4,A0A1I2ZGP1,A0A317EJY3,A0A1I2BD20,F8ERC7,S7VLM7,A0A1A5X8H4,A0A1I2T6Q1,A0A1R3T9N6,H8KXJ0,A0A2D1U4H7,I3TE64,A0A0B7I4Z6,A0LL61,Q8DKB1,A0A139WY18,A0A1J1EK56,A0A2T1E1K4,A0A1Q8ZD62,A0A4Q6XKV6,A0A1Z3HNN4,A0A239JE83,A0A2N4XBY2,Q53W94,R5JEI2,A0A0Q0ZC47,A0A2T0XH18,A0A1V4CHV0,A0A1K1RQP7,A0A2T1EKT1,A0A1N6LUI7,A0A0P0NGR6,A0A1X7IML5,A0A0A2LKJ7,K1L112,A0A0U3AL92,A0A1H3A054,E0UCX3,K9XZC6,B9LVW4,A0A0C1VHB4,Q31N05,A0A0C5JKF3,R5NJJ8,A5D4D9,Q2JI93,A0A142Y7A9,A0A432MEQ5,A0A372DKU2,A0A3R7KLK4,C1F5Q7,A0A4R3EV39,A0A1P8WP90,A0A222F7P0,A0A1C9VH88,A0A2T2YMB1,A0A101R2A0,A0A1E3XF49,A0A1U9ND56,A0A4R7BQC4,A0A1H3DGN3,A0A1Q1FPH0,E0TGY3,A0A259TUP4,F6EYI8,A0A2S9Q9J0,A0A4Q2UIU6,A0A1H0LH25,A0A318LG42,H1YCU5,L0JS08,A0A1Q5ZS75,M0AF24,A0A1H3X247,A0A0C1XUA0,M0D2X3,A0A2R5G167,A0A346PK63,R7RTW6,A0A1H2RBI2,B9LVP8,M5RSF0,W0JW77,B7K585,F8D8G0,A0A343TL88,L0AJX6,A0A2A5QS34,A0A343JEE2,A0A3P3RGE5,A0A329TBQ3,A0A285N2A8,A0A0W1S8B8,A0A1V4C8L7,L9VRQ2,E4NRV1,A0A1I6HGN0,A0A1I0NI68,,",366,37
"1167","C.S11.6","C.S12.7",347,180,167,1.73451430472389,"4F1N,4F3T,4KRE,5GUH,5VM9,6KR6,6OON,7KX7,7SWF,A0A163JTZ6,A0A0N4X8S8,A0A196SDB4,J9D5G4,Q389P5,C4LVV2,A0A2P6N8X7,A8BCK6,A2DPV7,A0A0G4H2S4,T1H8B3,R1FDF0,S4RWI0,D2VMG4,A0A074TLL7,A0A0D1ZAJ4,Q1K660,F4PH46,A0A3M7S814,A0A164ZA52,A0A383WDW5,Q54G64,S7WCF7,I0YVB2,R7QGN7,C1DZY0,A0A2C5Z0M1,A0CB11,R9ACY5,D3BMP8,A0A1Z5TVE5,W7XD45,A0A1U7LLR0,A0A4S2MWZ7,K1VVQ6,A0A158P1R9,G7DVX0,V6R0U9,G4N9J3,E3KLI3,B7Q5I1,A0A1E3QC61,D5GGK8,S8ANP9,A0A139AUH8,L2GMR6,U4LBG4,A0A177URI1,O74957,A0A3N4IGK1,A6N7Y9,A0A0E9NDK5,T1KZ60,A0A250WXN5,A0A2G8JLH3,Q5KAT1,L2GUF2,W2T741,A0A1W0E4B5,A0A2J7QB22,A0A2K3CW87,A0A226EFL3,A0A3S3PD82,A0A0L0TEV1,A0A1S3J512,G0QTT2,A0A1J1HRI1,C4V9J2,Q9JMB7,A0A075AN09,Q5TW24,U5HIG6,A0A401PRI6,Q96J94,A0A2B4RHN2,G2QEV0,A0A397UU01,A0A2T7PFL8,K7ISV0,A0A024FT57,H3HCL6,A0A0G4IME3,E9FUN9,A0A1S3CYL5,D7FQK3,A0A1Y1YHC8,T1GSU4,F4S231,A0A1D8PMK0,A0A2G5B1D8,Q5BD61,A0A1C7M8P2,A0A4D8YSQ3,A0A158PJG6,J9JZ66,A0A0C2XG51,A0A158QZT6,A0A165QYQ9,T0SAU8,R7YY92,A0A3S1A0C3,A0A074YJ47,A0A2K1J482,A0A1Q3ENA6,O04379,A0A371I3C8,A8P0D4,A0A2K3NY65,F4NYW7,A0A409Y6G2,A0A0L0HAB7,D8PZT7,A0A1D1W4K0,A7RQ46,W4YU94,A7BJS5,D8SNM6,A0A1J8PPA3,X1WG39,M5FQK2,Q69VD5,A0A2R6NSC2,A0A0D8XL16,A0A016WPN3,Q9QZ81,G5EES3,A0A0K0EFP6,Q8CJG0,A0A1D5NTU6,V2WTL2,A0A0V0YLH8,A0A139WDH0,A0A0R3W9Q7,H3DS31,A0A1Y1HWP2,G4T5G9,B7QCC4,A0A0B2UV00,M7BCJ9,E9GN30,Q7PZ41,A0A077Z361,R7U9I3,A0A1X7V1N5,A0A0K0JDP1,A0A0N4UKJ1,A0A498N3A3,A0A3M0IQP5,A0A0L8GBV4,Q32KD4,A0A1J1JBJ0,E0W4C3,A0A482XDA9,A0A3P7EJD6,J9K2Z4,A0A2J7Q8V4,T1IBM6,V3ZRX0,A0A210QKF7,A0A423TSS1,K1PT78,A0A267E8R7,A0A1D2N447,A0A226D7A9,F6YK55,T1KTE4,A0A2C9JGZ6,A0A1V9X9F0,K5X5Z7,A0A3Q0KUG5,T1FY40,1YVU,1Z26,3DLB,5AWH,5G5T,5I4A,6QZK,7R8K,E8N0K8,A0A328VKE4,E0ST67,C4L1M1,A0A0M2PXX3,A0A1I3LMA1,K9TPA9,A0A1C0UUC4,A0A2Z6E1D5,A0A0F4NXW8,A0A142XB92,L8D0R3,B1XJG0,A0A326U7G5,H1KXR6,A0A1Q4R485,K9U8J6,A0A097QRL6,K9RC91,A0A0D8ZUC0,A0A139XGN8,A0A1T4Y3A2,Q5P0R2,B6YTQ5,A0A0B0H9B4,A0YYT3,A0A2T1EFY0,G6FTN0,R6KUL9,A0A433NB65,A0A1Z4L0A1,K9UQR0,A0A2T1G8M7,K9VUN0,B7GJX9,A0A0P6X5X2,K9ZDE3,B0JXD6,A0A2T1LS63,A0A1Z4K1Y3,A0A2Z6E0R7,A0A1N6SSK9,A0A0P4UVI8,A0A0V7ZCG4,A0A1J0AGK2,K9PFF9,A0A2G9DT08,K9UEV4,Q9L1X1,A0A060HNJ0,A0A235B542,R5XQK4,A0A1H3LE92,A0A496APJ8,A0A062U2W9,H0HWQ5,A0A1V9G9U4,A0A1I2ZGP1,A0A317EJY3,A0A1I2BD20,F8ERC7,A0A1A5X8H4,A0A1I2T6Q1,A0A1R3T9N6,A0A0Q2M2Z1,H8KXJ0,D3S0S6,A0A2D1U4H7,I3TE64,A0A0B7I4Z6,A0LL61,Q8DKB1,A0A139WY18,A0A1J1EK56,A0A2T1E1K4,A0A1Q8ZD62,A0A4Q6XKV6,A0A1Z3HNN4,A0A239JE83,A0A2N4XBY2,Q53W94,R5JEI2,A0A0Q0ZC47,A0A2T0XH18,A0A1V4CHV0,A0A1K1RQP7,A0A2T1EKT1,A0A1N6LUI7,A0A0P0NGR6,A0A1X7IML5,A0A0A2LKJ7,K1L112,A0A0U3AL92,A0A1H3A054,E0UCX3,K9XZC6,B9LVW4,A0A0C1VHB4,Q31N05,A0A0C5JKF3,R5NJJ8,A5D4D9,Q2JI93,A0A142Y7A9,A0A432MEQ5,A0A372DKU2,A0A3R7KLK4,C1F5Q7,A0A4R3EV39,A0A1P8WP90,A0A222F7P0,A0A1C9VH88,A0A2T2YMB1,A0A329TD61,A0A101R2A0,A0A1E3XF49,A0A1U9ND56,A0A4R7BQC4,A0A1H3DGN3,A0A1Q1FPH0,E0TGY3,A0A259TUP4,F6EYI8,A0A2S9Q9J0,A0A4Q2UIU6,A0A1H0LH25,A0A318LG42,H1YCU5,L0JS08,A0A1Q5ZS75,A0A345E7N0,M0AF24,A0A1W2A082,A0A1H3X247,A0A0C1XUA0,M0D2X3,A0A2R5G167,A0A346PK63,R7RTW6,A0A1H2RBI2,A0A1C3ZXN2,B9LVP8,M5RSF0,W0JW77,B7K585,F8D8G0,A0A343TL88,L0AJX6,A0A2A5QS34,A0A343JEE2,A0A3P3RGE5,A0A329TBQ3,A0A285N2A8,A0A0W1S8B8,A0A1V4C8L7,L9VRQ2,E4NRV1,A0A1I6HGN0,A0A1I0NI68,,",366,37
"1168","C.S15.1","C.S16.3",348,180,168,2.80337301587302,"4F1N,4F3T,4KRE,5GUH,5VM9,6KR6,6OON,7KX7,7SWF,A0A163JTZ6,A0A0N4X8S8,A0A196SDB4,J9D5G4,Q389P5,C4LVV2,A0A2P6N8X7,A8BCK6,A2DPV7,A0A0G4H2S4,R1FDF0,D2VMG4,A0A074TLL7,A0A0D1ZAJ4,Q1K660,F4PH46,A0A3M7S814,A0A164ZA52,A0A383WDW5,Q54G64,S7WCF7,I0YVB2,R7QGN7,C1DZY0,A0A2C5Z0M1,A0CB11,R9ACY5,D3BMP8,A0A1Z5TVE5,W7XD45,A0A1U7LLR0,A0A4S2MWZ7,K1VVQ6,A0A158P1R9,G7DVX0,V6R0U9,G4N9J3,E3KLI3,A0A1E3QC61,D5GGK8,S8ANP9,A0A139AUH8,L2GMR6,U4LBG4,A0A177URI1,O74957,A0A3N4IGK1,A6N7Y9,A0A0E9NDK5,T1KZ60,A0A250WXN5,A0A2G8JLH3,Q5KAT1,L2GUF2,W2T741,A0A1W0E4B5,A0A2J7QB22,S4RYE2,A0A2K3CW87,A0A388KES6,A0A226EFL3,A0A3S3PD82,A0A0L0TEV1,A0A1S3J512,G0QTT2,A0A1J1HRI1,C4V9J2,Q9JMB7,A0A075AN09,Q5TW24,U5HIG6,A0A401PRI6,Q96J94,A0A2B4RHN2,G2QEV0,A0A397UU01,A0A2T7PFL8,K7ISV0,A0A024FT57,H3HCL6,A0A0G4IME3,E9FUN9,A0A1S3CYL5,D7FQK3,A0A1Y1YHC8,T1GSU4,F4S231,A0A1D8PMK0,A0A2G5B1D8,Q5BD61,A0A1C7M8P2,A0A4D8YSQ3,A0A158PJG6,J9JZ66,A0A0C2XG51,A0A158QZT6,A0A165QYQ9,T0SAU8,R7YY92,A0A3S1A0C3,A0A074YJ47,A0A2K1J482,A0A1Q3ENA6,O04379,A0A371I3C8,M8AEW7,A8P0D4,A0A2K3NY65,F4NYW7,A0A409Y6G2,A0A0L0HAB7,D8PZT7,A0A1D1W4K0,A7RQ46,W4YU94,A7BJS5,D8SNM6,A0A1J8PPA3,X1WG39,M5FQK2,Q69VD5,A0A2R6NSC2,A0A0D8XL16,A0A016WPN3,Q9QZ81,G5EES3,A0A0K0EFP6,Q8CJG0,A0A1D5NTU6,V2WTL2,A0A0V0YLH8,A0A139WDH0,A0A0R3W9Q7,H3DS31,A0A1Y1HWP2,G4T5G9,B7QCC4,A0A0B2UV00,M7BCJ9,E9GN30,Q7PZ41,A0A077Z361,R7U9I3,A0A1X7V1N5,A0A0K0JDP1,A0A0N4UKJ1,A0A498N3A3,A0A3M0IQP5,A0A0L8GBV4,Q32KD4,A0A1J1JBJ0,E0W4C3,A0A482XDA9,A0A3P7EJD6,J9K2Z4,A0A2J7Q8V4,T1IBM6,V3ZRX0,A0A210QKF7,A0A423TSS1,K1PT78,A0A267E8R7,A0A1D2N447,A0A226D7A9,F6YK55,T1KTE4,A0A2C9JGZ6,A0A1V9X9F0,K5X5Z7,A0A3Q0KUG5,T1FY40,1YVU,1Z26,3DLB,5AWH,5G5T,5I4A,6QZK,A0A1I7IXT4,A0A2W1JZ37,A0A2S7WBN3,A0A328VKE4,A0A420DFE6,E0ST67,A0A4V1VDY2,A0A368P5I0,C4L1M1,A0A4R1RMM2,A0A1Y2RDH8,A0A1M5ZSR3,A0A0K8QX04,A0A0M2PXX3,K9TPA9,A0A1L3JHM3,A0A1W6MIP2,A0A1C0UUC4,A0A2U2J9E0,A0A142XB92,B1XJG0,A0A326U7G5,A0A3D8L290,A0A1Q4R485,K9U8J6,A0A097QRL6,K9RC91,A0A0D8ZUC0,A0A139XGN8,A0A1T4Y3A2,A0A0B0H9B4,A0YYT3,A0A2T1EFY0,G6FTN0,R6KUL9,A0A433NB65,A0A1Z4L0A1,K9UQR0,A0A2T1G8M7,K9VUN0,B7GJX9,A0A0P6X5X2,K9ZDE3,B0JXD6,A0A2T1LS63,A0A1Z4K1Y3,A0A1N6SSK9,A0A0P4UVI8,A0A0V7ZCG4,A0A1J0AGK2,K9PFF9,A0A2G9DT08,K9UEV4,Q9L1X1,A0A060HNJ0,A0A235B542,R5XQK4,A0A1H3LE92,A0A496APJ8,H0HWQ5,A0A1V9G9U4,A0A1I2ZGP1,A0A317EJY3,A0A1I2BD20,F8ERC7,S7VLM7,A0A1A5X8H4,A0A1I2T6Q1,A0A1R3T9N6,A0A0Q2M2Z1,H8KXJ0,D3S0S6,A0A2D1U4H7,I3TE64,A0A0B7I4Z6,A0LL61,Q8DKB1,A0A139WY18,A0A1J1EK56,A0A2T1E1K4,A0A1Q8ZD62,A0A4Q6XKV6,A0A1Z3HNN4,A0A239JE83,A0A2N4XBY2,Q53W94,R5JEI2,A0A0Q0ZC47,A0A2T0XH18,A0A1V4CHV0,A0A1K1RQP7,A0A2T1EKT1,A0A1N6LUI7,A0A0P0NGR6,A0A1X7IML5,A0A0A2LKJ7,K1L112,A0A0U3AL92,A0A1H3A054,E0UCX3,K9XZC6,A0A0C1VHB4,Q31N05,A0A0C5JKF3,R5NJJ8,A5D4D9,Q2JI93,A0A142Y7A9,A0A432MEQ5,A0A372DKU2,C1F5Q7,A0A4R3EV39,A0A1P8WP90,A0A222F7P0,A0A1C9VH88,A0A2T2YMB1,A0A329TD61,A0A101R2A0,A0A1E3XF49,A0A1U9ND56,A0A4R7BQC4,A0A1Q1FPH0,E0TGY3,A0A259TUP4,F6EYI8,A0A2S9Q9J0,A0A4Q2UIU6,A0A1H0LH25,A0A318LG42,H1YCU5,L0JS08,A0A1Q5ZS75,A0A345E7N0,M0AF24,A0A1W2A082,A0A1H3X247,A0A0C1XUA0,M0D2X3,A0A2R5G167,A0A346PK63,R7RTW6,A0A1H2RBI2,A0A1C3ZXN2,B9LVP8,M5RSF0,W0JW77,B7K585,F8D8G0,A0A343TL88,L0AJX6,A0A2A5QS34,A0A343JEE2,A0A3P3RGE5,A0A329TBQ3,A0A285N2A8,A0A0W1S8B8,A0A1V4C8L7,L9VRQ2,E4NRV1,A0A1I6HGN0,A0A1I0NI68,,",366,37
"1171","C.S15.4","C.S16.1",358,180,178,2.8085518102372,"4F1N,4F3T,4KRE,5GUH,5VM9,6KR6,6OON,7KX7,7SWF,A0A163JTZ6,A0A0N4X8S8,A0A196SDB4,J9D5G4,Q389P5,C4LVV2,A0A2P6N8X7,A8BCK6,A2DPV7,A0A0G4H2S4,R1FDF0,D2VMG4,A0A074TLL7,A0A0D1ZAJ4,Q1K660,F4PH46,A0A3M7S814,A0A164ZA52,A0A383WDW5,Q54G64,S7WCF7,I0YVB2,R7QGN7,C1DZY0,A0A2C5Z0M1,A0CB11,R9ACY5,D3BMP8,A0A1Z5TVE5,W7XD45,A0A1U7LLR0,A0A4S2MWZ7,K1VVQ6,A0A158P1R9,G7DVX0,V6R0U9,G4N9J3,E3KLI3,A0A1E3QC61,D5GGK8,S8ANP9,A0A139AUH8,L2GMR6,U4LBG4,A0A177URI1,O74957,A0A3N4IGK1,A6N7Y9,A0A0E9NDK5,T1KZ60,A0A250WXN5,A0A2G8JLH3,Q5KAT1,L2GUF2,W2T741,A0A1W0E4B5,A0A2J7QB22,S4RYE2,A0A2K3CW87,A0A388KES6,A0A226EFL3,A0A3S3PD82,A0A0L0TEV1,A0A1S3J512,G0QTT2,A0A1J1HRI1,C4V9J2,Q9JMB7,A0A075AN09,Q5TW24,U5HIG6,A0A401PRI6,Q96J94,A0A2B4RHN2,G2QEV0,A0A397UU01,A0A2T7PFL8,K7ISV0,A0A024FT57,H3HCL6,A0A0G4IME3,E9FUN9,A0A1S3CYL5,D7FQK3,A0A1Y1YHC8,T1GSU4,F4S231,A0A1D8PMK0,A0A2G5B1D8,Q5BD61,A0A1C7M8P2,A0A4D8YSQ3,A0A158PJG6,J9JZ66,A0A0C2XG51,A0A158QZT6,A0A165QYQ9,T0SAU8,R7YY92,A0A3S1A0C3,A0A074YJ47,A0A2K1J482,A0A1Q3ENA6,O04379,A0A371I3C8,M8AEW7,A8P0D4,A0A2K3NY65,F4NYW7,A0A409Y6G2,A0A0L0HAB7,D8PZT7,A0A1D1W4K0,A7RQ46,W4YU94,A7BJS5,D8SNM6,A0A1J8PPA3,X1WG39,M5FQK2,Q69VD5,A0A2R6NSC2,A0A0D8XL16,A0A016WPN3,Q9QZ81,G5EES3,A0A0K0EFP6,Q8CJG0,A0A1D5NTU6,V2WTL2,A0A0V0YLH8,A0A139WDH0,A0A0R3W9Q7,H3DS31,A0A1Y1HWP2,G4T5G9,B7QCC4,A0A0B2UV00,M7BCJ9,E9GN30,Q7PZ41,A0A077Z361,R7U9I3,A0A1X7V1N5,A0A0K0JDP1,A0A0N4UKJ1,A0A498N3A3,A0A3M0IQP5,A0A0L8GBV4,Q32KD4,A0A1J1JBJ0,E0W4C3,A0A482XDA9,A0A3P7EJD6,J9K2Z4,A0A2J7Q8V4,T1IBM6,V3ZRX0,A0A210QKF7,A0A423TSS1,K1PT78,A0A267E8R7,A0A1D2N447,A0A226D7A9,F6YK55,T1KTE4,A0A2C9JGZ6,A0A1V9X9F0,K5X5Z7,A0A3Q0KUG5,T1FY40,1YVU,1Z26,3DLB,5AWH,5G5T,5I4A,6QZK,7R8K,A0A1I7IXT4,A0A2W1JZ37,A0A2S7WBN3,A0A328VKE4,A0A420DFE6,E0ST67,A0A4V1VDY2,A0A368P5I0,C4L1M1,A0A4R1RMM2,A0A1Y2RDH8,Q11QW7,A0A1M5ZSR3,A0A0K8QX04,K9TPA9,A0A1L3JHM3,A0A1W6MIP2,A0A2U2J9E0,A0A2Z6E1D5,A0A0F4NXW8,A0A142XB92,L8D0R3,B1XJG0,A0A326U7G5,A0A3D8L290,H1KXR6,A0A1Q4R485,K9U8J6,A0A097QRL6,K9RC91,A0A0D8ZUC0,A0A139XGN8,A0A1T4Y3A2,Q5P0R2,B6YTQ5,A0A0B0H9B4,A0YYT3,A0A2T1EFY0,G6FTN0,R6KUL9,A0A433NB65,A0A1Z4L0A1,K9UQR0,A0A2T1G8M7,K9VUN0,B7GJX9,A0A0P6X5X2,K9ZDE3,B0JXD6,A0A2T1LS63,A0A1Z4K1Y3,A0A2Z6E0R7,A0A1N6SSK9,A0A0P4UVI8,A0A0V7ZCG4,A0A1J0AGK2,K9PFF9,A0A2G9DT08,K9UEV4,Q9L1X1,A0A060HNJ0,A0A235B542,R5XQK4,A0A1H3LE92,A0A496APJ8,A0A062U2W9,H0HWQ5,A0A1V9G9U4,A0A1I2ZGP1,A0A317EJY3,A0A1I2BD20,F8ERC7,S7VLM7,A0A1A5X8H4,A0A1I2T6Q1,A0A1R3T9N6,A0A0Q2M2Z1,H8KXJ0,D3S0S6,A0A2D1U4H7,I3TE64,A0A0B7I4Z6,A0LL61,Q8DKB1,A0A139WY18,A0A1J1EK56,A0A2T1E1K4,A0A1Q8ZD62,A0A4Q6XKV6,A0A1Z3HNN4,A0A239JE83,A0A2N4XBY2,Q53W94,R5JEI2,A0A0Q0ZC47,A0A2T0XH18,A0A1V4CHV0,A0A1K1RQP7,A0A2T1EKT1,A0A1N6LUI7,A0A0P0NGR6,A0A1X7IML5,A0A0A2LKJ7,K1L112,A0A0U3AL92,A0A1H3A054,E0UCX3,K9XZC6,A0A0C1VHB4,Q31N05,A0A0C5JKF3,R5NJJ8,A5D4D9,Q2JI93,A0A142Y7A9,A0A432MEQ5,A0A372DKU2,A0A3R7KLK4,C1F5Q7,A0A4R3EV39,A0A1P8WP90,A0A222F7P0,A0A1C9VH88,A0A2T2YMB1,A0A329TD61,A0A101R2A0,A0A1E3XF49,A0A1U9ND56,A0A4R7BQC4,A0A1H3DGN3,A0A1Q1FPH0,E0TGY3,A0A259TUP4,F6EYI8,A0A2S9Q9J0,A0A4Q2UIU6,A0A1H0LH25,A0A318LG42,H1YCU5,L0JS08,A0A1Q5ZS75,A0A345E7N0,M0AF24,A0A1W2A082,A0A1H3X247,A0A0C1XUA0,M0D2X3,A0A2R5G167,A0A346PK63,R7RTW6,A0A1H2RBI2,A0A1C3ZXN2,B9LVP8,M5RSF0,W0JW77,B7K585,F8D8G0,A0A343TL88,L0AJX6,A0A2A5QS34,A0A343JEE2,A0A3P3RGE5,A0A329TBQ3,A0A285N2A8,A0A0W1S8B8,A0A1V4C8L7,L9VRQ2,E4NRV1,A0A1I6HGN0,A0A1I0NI68,,",366,37
"1175","C.S5.2","C.S6.3",351,180,171,1.22163742690058,"4F1N,4F3T,4KRE,5GUH,5VM9,6KR6,6OON,7KX7,7SWF,A0A163JTZ6,A0A0N4X8S8,A0A196SDB4,J9D5G4,Q389P5,C4LVV2,A0A2P6N8X7,A8BCK6,A2DPV7,T1H8B3,S4RWI0,D2VMG4,A0A074TLL7,A0A0D1ZAJ4,Q1K660,F4PH46,A0A3M7S814,A0A164ZA52,A0A383WDW5,Q54G64,S7WCF7,I0YVB2,R7QGN7,C1DZY0,A0A2C5Z0M1,A0CB11,R9ACY5,D3BMP8,A0A1Z5TVE5,W7XD45,A0A1U7LLR0,A0A4S2MWZ7,K1VVQ6,A0A158P1R9,G7DVX0,V6R0U9,G4N9J3,E3KLI3,B7Q5I1,A0A1E3QC61,D5GGK8,S8ANP9,A0A139AUH8,L2GMR6,U4LBG4,A0A177URI1,O74957,A0A3N4IGK1,A6N7Y9,A0A0E9NDK5,T1KZ60,A0A250WXN5,A0A2G8JLH3,Q5KAT1,L2GUF2,W2T741,A0A1W0E4B5,A0A2J7QB22,S4RYE2,A0A2K3CW87,A0A388KES6,A0A226EFL3,A0A3S3PD82,A0A0L0TEV1,A0A1S3J512,G0QTT2,A0A1J1HRI1,C4V9J2,Q9JMB7,A0A075AN09,Q5TW24,U5HIG6,A0A401PRI6,Q96J94,A0A2B4RHN2,G2QEV0,A0A397UU01,A0A2T7PFL8,K7ISV0,A0A024FT57,H3HCL6,A0A0G4IME3,E9FUN9,A0A1S3CYL5,D7FQK3,A0A1Y1YHC8,F4S231,A0A1D8PMK0,A0A2G5B1D8,Q5BD61,A0A1C7M8P2,A0A4D8YSQ3,A0A158PJG6,J9JZ66,A0A0C2XG51,A0A158QZT6,A0A165QYQ9,T0SAU8,R7YY92,A0A3S1A0C3,A0A074YJ47,A0A2K1J482,A0A1Q3ENA6,O04379,A0A371I3C8,M8AEW7,A8P0D4,A0A2K3NY65,F4NYW7,A0A409Y6G2,A0A0L0HAB7,D8PZT7,A0A1D1W4K0,A7RQ46,W4YU94,A7BJS5,D8SNM6,A0A1J8PPA3,X1WG39,M5FQK2,Q69VD5,A0A2R6NSC2,A0A0D8XL16,A0A016WPN3,Q9QZ81,G5EES3,A0A0K0EFP6,Q8CJG0,A0A1D5NTU6,V2WTL2,A0A0V0YLH8,A0A139WDH0,A0A0R3W9Q7,H3DS31,A0A1Y1HWP2,G4T5G9,B7QCC4,A0A0B2UV00,M7BCJ9,E9GN30,Q7PZ41,A0A077Z361,R7U9I3,A0A1X7V1N5,A0A0K0JDP1,A0A0N4UKJ1,A0A498N3A3,A0A3M0IQP5,A0A0L8GBV4,Q32KD4,A0A1J1JBJ0,E0W4C3,A0A482XDA9,A0A3P7EJD6,J9K2Z4,A0A2J7Q8V4,T1IBM6,V3ZRX0,A0A210QKF7,A0A423TSS1,K1PT78,A0A267E8R7,A0A1D2N447,A0A226D7A9,F6YK55,T1KTE4,A0A2C9JGZ6,A0A1V9X9F0,K5X5Z7,A0A3Q0KUG5,T1FY40,1YVU,1Z26,3DLB,5AWH,5G5T,5I4A,6QZK,7R8K,E8N0K8,A0A328VKE4,E0ST67,C4L1M1,Q11QW7,A0A1M5ZSR3,A0A0M2PXX3,A0A1I3LMA1,K9TPA9,A0A1C0UUC4,A0A2Z6E1D5,A0A0F4NXW8,A0A142XB92,L8D0R3,B1XJG0,A0A326U7G5,A0A3D8L290,H1KXR6,A0A1Q4R485,K9U8J6,A0A097QRL6,K9RC91,A0A0D8ZUC0,A0A139XGN8,A0A1T4Y3A2,Q5P0R2,B6YTQ5,A0A0B0H9B4,A0YYT3,A0A2T1EFY0,G6FTN0,R6KUL9,A0A433NB65,A0A1Z4L0A1,K9UQR0,A0A2T1G8M7,K9VUN0,B7GJX9,A0A0P6X5X2,K9ZDE3,B0JXD6,A0A2T1LS63,A0A1Z4K1Y3,A0A2Z6E0R7,A0A1N6SSK9,A0A0P4UVI8,A0A0V7ZCG4,A0A1J0AGK2,K9PFF9,A0A2G9DT08,K9UEV4,Q9L1X1,A0A060HNJ0,A0A235B542,R5XQK4,A0A1H3LE92,A0A496APJ8,A0A062U2W9,H0HWQ5,A0A1V9G9U4,A0A1I2ZGP1,A0A317EJY3,A0A1I2BD20,F8ERC7,S7VLM7,A0A1A5X8H4,A0A1I2T6Q1,A0A1R3T9N6,A0A0Q2M2Z1,H8KXJ0,D3S0S6,A0A2D1U4H7,I3TE64,A0A0B7I4Z6,A0LL61,Q8DKB1,A0A139WY18,A0A1J1EK56,A0A2T1E1K4,A0A1Q8ZD62,A0A4Q6XKV6,A0A1Z3HNN4,A0A239JE83,A0A2N4XBY2,Q53W94,R5JEI2,A0A0Q0ZC47,A0A2T0XH18,A0A1V4CHV0,A0A1K1RQP7,A0A2T1EKT1,A0A1N6LUI7,A0A0P0NGR6,A0A1X7IML5,A0A0A2LKJ7,K1L112,A0A0U3AL92,A0A1H3A054,E0UCX3,K9XZC6,B9LVW4,A0A0C1VHB4,Q31N05,A0A0C5JKF3,R5NJJ8,A5D4D9,Q2JI93,A0A142Y7A9,A0A432MEQ5,A0A372DKU2,A0A3R7KLK4,C1F5Q7,A0A4R3EV39,A0A1P8WP90,A0A222F7P0,A0A1C9VH88,A0A2T2YMB1,A0A329TD61,A0A101R2A0,A0A1E3XF49,A0A1U9ND56,A0A4R7BQC4,A0A1H3DGN3,A0A1Q1FPH0,E0TGY3,A0A259TUP4,F6EYI8,A0A2S9Q9J0,A0A4Q2UIU6,A0A1H0LH25,A0A318LG42,H1YCU5,L0JS08,A0A1Q5ZS75,A0A345E7N0,M0AF24,A0A1W2A082,A0A1H3X247,A0A0C1XUA0,M0D2X3,A0A2R5G167,A0A346PK63,R7RTW6,A0A1H2RBI2,A0A1C3ZXN2,B9LVP8,M5RSF0,W0JW77,B7K585,F8D8G0,A0A343TL88,L0AJX6,A0A2A5QS34,A0A343JEE2,A0A3P3RGE5,A0A329TBQ3,A0A285N2A8,A0A0W1S8B8,A0A1V4C8L7,L9VRQ2,E4NRV1,A0A1I6HGN0,A0A1I0NI68,,",366,37
"1176","C.S5.3","C.S6.3",359,180,179,2.81848230912477,"4F1N,4F3T,4KRE,5GUH,5VM9,6KR6,6OON,7KX7,7SWF,A0A163JTZ6,A0A0N4X8S8,A0A196SDB4,J9D5G4,Q389P5,C4LVV2,A0A2P6N8X7,A8BCK6,A2DPV7,A0A0G4H2S4,T1H8B3,S4RWI0,D2VMG4,A0A074TLL7,A0A0D1ZAJ4,Q1K660,F4PH46,A0A3M7S814,A0A164ZA52,A0A383WDW5,Q54G64,S7WCF7,I0YVB2,R7QGN7,C1DZY0,A0A2C5Z0M1,A0CB11,R9ACY5,D3BMP8,A0A1Z5TVE5,W7XD45,A0A1U7LLR0,A0A4S2MWZ7,K1VVQ6,A0A158P1R9,G7DVX0,V6R0U9,G4N9J3,E3KLI3,B7Q5I1,A0A1E3QC61,D5GGK8,S8ANP9,A0A139AUH8,L2GMR6,U4LBG4,A0A177URI1,O74957,A0A3N4IGK1,A6N7Y9,A0A0E9NDK5,T1KZ60,A0A250WXN5,A0A2G8JLH3,Q5KAT1,L2GUF2,W2T741,A0A1W0E4B5,A0A2J7QB22,S4RYE2,A0A2K3CW87,A0A388KES6,A0A226EFL3,A0A3S3PD82,A0A0L0TEV1,A0A1S3J512,G0QTT2,A0A1J1HRI1,C4V9J2,Q9JMB7,A0A075AN09,Q5TW24,U5HIG6,A0A401PRI6,Q96J94,A0A2B4RHN2,G2QEV0,A0A397UU01,A0A2T7PFL8,K7ISV0,A0A024FT57,H3HCL6,A0A0G4IME3,E9FUN9,A0A1S3CYL5,D7FQK3,A0A1Y1YHC8,F4S231,A0A1D8PMK0,A0A2G5B1D8,Q5BD61,A0A1C7M8P2,A0A4D8YSQ3,A0A158PJG6,J9JZ66,A0A0C2XG51,A0A158QZT6,A0A165QYQ9,T0SAU8,R7YY92,A0A3S1A0C3,A0A074YJ47,A0A2K1J482,A0A1Q3ENA6,O04379,A0A371I3C8,M8AEW7,A8P0D4,A0A2K3NY65,F4NYW7,A0A409Y6G2,A0A0L0HAB7,D8PZT7,A0A1D1W4K0,A7RQ46,W4YU94,A7BJS5,D8SNM6,A0A1J8PPA3,X1WG39,M5FQK2,Q69VD5,A0A2R6NSC2,A0A0D8XL16,A0A016WPN3,Q9QZ81,G5EES3,A0A0K0EFP6,Q8CJG0,A0A1D5NTU6,A0A0V0YLH8,A0A139WDH0,A0A0R3W9Q7,H3DS31,A0A1Y1HWP2,G4T5G9,B7QCC4,A0A0B2UV00,M7BCJ9,E9GN30,Q7PZ41,A0A077Z361,R7U9I3,A0A1X7V1N5,A0A0K0JDP1,A0A0N4UKJ1,A0A498N3A3,A0A3M0IQP5,A0A0L8GBV4,Q32KD4,A0A1J1JBJ0,E0W4C3,A0A482XDA9,A0A3P7EJD6,J9K2Z4,A0A2J7Q8V4,T1IBM6,V3ZRX0,A0A210QKF7,A0A423TSS1,K1PT78,A0A267E8R7,A0A1D2N447,A0A226D7A9,F6YK55,T1KTE4,A0A2C9JGZ6,A0A1V9X9F0,K5X5Z7,A0A3Q0KUG5,T1FY40,1YVU,1Z26,5AWH,5G5T,5I4A,7R8K,E8N0K8,A0A1I7IXT4,A0A2W1JZ37,A0A2S7WBN3,A0A328VKE4,A0A420DFE6,E0ST67,A0A4V1VDY2,A0A368P5I0,C4L1M1,A0A4R1RMM2,A0A1Y2RDH8,Q11QW7,A0A1M5ZSR3,A0A0K8QX04,A0A0M2PXX3,A0A1I3LMA1,K9TPA9,A0A1L3JHM3,A0A1W6MIP2,A0A1C0UUC4,A0A2U2J9E0,A0A2Z6E1D5,A0A0F4NXW8,A0A142XB92,L8D0R3,B1XJG0,A0A326U7G5,A0A3D8L290,H1KXR6,A0A1Q4R485,K9U8J6,K9RC91,A0A0D8ZUC0,A0A139XGN8,A0A1T4Y3A2,Q5P0R2,A0A0B0H9B4,A0YYT3,A0A2T1EFY0,G6FTN0,R6KUL9,A0A433NB65,A0A1Z4L0A1,K9UQR0,A0A2T1G8M7,K9VUN0,B7GJX9,A0A0P6X5X2,K9ZDE3,B0JXD6,A0A2T1LS63,A0A1Z4K1Y3,A0A2Z6E0R7,A0A1N6SSK9,A0A0P4UVI8,A0A0V7ZCG4,A0A1J0AGK2,K9PFF9,A0A2G9DT08,K9UEV4,Q9L1X1,A0A060HNJ0,A0A235B542,R5XQK4,A0A1H3LE92,A0A496APJ8,A0A062U2W9,H0HWQ5,A0A1V9G9U4,A0A1I2ZGP1,A0A317EJY3,A0A1I2BD20,F8ERC7,S7VLM7,A0A1A5X8H4,A0A1I2T6Q1,A0A1R3T9N6,A0A0Q2M2Z1,H8KXJ0,D3S0S6,A0A2D1U4H7,I3TE64,A0A0B7I4Z6,A0LL61,Q8DKB1,A0A139WY18,A0A1J1EK56,A0A2T1E1K4,A0A1Q8ZD62,A0A4Q6XKV6,A0A1Z3HNN4,A0A239JE83,A0A2N4XBY2,Q53W94,R5JEI2,A0A0Q0ZC47,A0A2T0XH18,A0A1V4CHV0,A0A1K1RQP7,A0A2T1EKT1,A0A1N6LUI7,A0A0P0NGR6,A0A1X7IML5,A0A0A2LKJ7,K1L112,A0A0U3AL92,A0A1H3A054,E0UCX3,K9XZC6,B9LVW4,A0A0C1VHB4,Q31N05,A0A0C5JKF3,R5NJJ8,A5D4D9,Q2JI93,A0A142Y7A9,A0A432MEQ5,A0A372DKU2,A0A3R7KLK4,C1F5Q7,A0A4R3EV39,A0A1P8WP90,A0A222F7P0,A0A1C9VH88,A0A2T2YMB1,A0A329TD61,A0A101R2A0,A0A1E3XF49,A0A1U9ND56,A0A4R7BQC4,A0A1H3DGN3,A0A1Q1FPH0,E0TGY3,A0A259TUP4,F6EYI8,A0A2S9Q9J0,A0A4Q2UIU6,A0A1H0LH25,A0A318LG42,H1YCU5,L0JS08,A0A1Q5ZS75,A0A345E7N0,M0AF24,A0A1W2A082,A0A1H3X247,A0A0C1XUA0,M0D2X3,A0A2R5G167,A0A346PK63,R7RTW6,A0A1H2RBI2,A0A1C3ZXN2,B9LVP8,M5RSF0,W0JW77,B7K585,F8D8G0,A0A343TL88,L0AJX6,A0A2A5QS34,A0A343JEE2,A0A3P3RGE5,A0A329TBQ3,A0A285N2A8,A0A0W1S8B8,A0A1V4C8L7,L9VRQ2,E4NRV1,A0A1I6HGN0,A0A1I0NI68,,",366,37
"1178","C.S8.5","C.S9.5",299,180,119,2.32712418300654,"4F1N,4F3T,4KRE,5GUH,5VM9,6KR6,6OON,7SWF,A0A163JTZ6,A0A0N4X8S8,A0A196SDB4,J9D5G4,C4LVV2,A8BCK6,A2DPV7,A0A0G4H2S4,T1H8B3,R1FDF0,S4RWI0,D2VMG4,A0A074TLL7,A0A0D1ZAJ4,Q1K660,F4PH46,A0A3M7S814,A0A164ZA52,A0A383WDW5,Q54G64,S7WCF7,I0YVB2,R7QGN7,C1DZY0,A0A2C5Z0M1,A0CB11,R9ACY5,D3BMP8,A0A1Z5TVE5,W7XD45,A0A1U7LLR0,A0A4S2MWZ7,K1VVQ6,A0A158P1R9,G7DVX0,V6R0U9,G4N9J3,E3KLI3,B7Q5I1,A0A1E3QC61,D5GGK8,S8ANP9,A0A139AUH8,L2GMR6,U4LBG4,A0A177URI1,O74957,A0A3N4IGK1,A6N7Y9,A0A0E9NDK5,T1KZ60,A0A250WXN5,A0A2G8JLH3,Q5KAT1,L2GUF2,W2T741,A0A1W0E4B5,A0A2J7QB22,S4RYE2,A0A2K3CW87,A0A388KES6,A0A226EFL3,A0A3S3PD82,A0A0L0TEV1,A0A1S3J512,G0QTT2,A0A1J1HRI1,C4V9J2,Q9JMB7,A0A075AN09,Q5TW24,U5HIG6,A0A401PRI6,Q96J94,A0A2B4RHN2,G2QEV0,A0A397UU01,A0A2T7PFL8,K7ISV0,A0A024FT57,H3HCL6,A0A0G4IME3,E9FUN9,A0A1S3CYL5,D7FQK3,A0A1Y1YHC8,T1GSU4,F4S231,A0A1D8PMK0,A0A2G5B1D8,Q5BD61,A0A1C7M8P2,A0A4D8YSQ3,A0A158PJG6,J9JZ66,A0A0C2XG51,A0A158QZT6,A0A165QYQ9,T0SAU8,R7YY92,A0A3S1A0C3,A0A074YJ47,A0A2K1J482,A0A1Q3ENA6,O04379,A0A371I3C8,M8AEW7,A8P0D4,A0A2K3NY65,F4NYW7,A0A409Y6G2,A0A0L0HAB7,D8PZT7,A0A1D1W4K0,A7RQ46,W4YU94,A7BJS5,D8SNM6,A0A1J8PPA3,X1WG39,M5FQK2,Q69VD5,A0A2R6NSC2,A0A0D8XL16,A0A016WPN3,Q9QZ81,G5EES3,A0A0K0EFP6,Q8CJG0,A0A1D5NTU6,V2WTL2,A0A0V0YLH8,A0A139WDH0,A0A0R3W9Q7,H3DS31,A0A1Y1HWP2,G4T5G9,B7QCC4,A0A0B2UV00,M7BCJ9,E9GN30,Q7PZ41,A0A077Z361,R7U9I3,A0A1X7V1N5,A0A0K0JDP1,A0A0N4UKJ1,A0A498N3A3,A0A3M0IQP5,A0A0L8GBV4,Q32KD4,A0A1J1JBJ0,E0W4C3,A0A482XDA9,A0A3P7EJD6,J9K2Z4,A0A2J7Q8V4,T1IBM6,V3ZRX0,A0A210QKF7,A0A423TSS1,K1PT78,A0A267E8R7,A0A1D2N447,A0A226D7A9,F6YK55,T1KTE4,A0A2C9JGZ6,A0A1V9X9F0,K5X5Z7,A0A3Q0KUG5,T1FY40,1YVU,1Z26,3DLB,5AWH,5G5T,5I4A,6QZK,7R8K,E8N0K8,A0A2W1JZ37,A0A2S7WBN3,A0A328VKE4,A0A420DFE6,A0A4R1RMM2,Q11QW7,A0A1M5ZSR3,A0A0K8QX04,K9TPA9,A0A1L3JHM3,A0A1W6MIP2,A0A1C0UUC4,A0A2U2J9E0,B1XJG0,A0A326U7G5,A0A3D8L290,A0A1Q4R485,K9U8J6,A0A097QRL6,K9RC91,A0A0D8ZUC0,A0A139XGN8,A0A1T4Y3A2,B6YTQ5,A0YYT3,A0A2T1EFY0,G6FTN0,A0A1Z4L0A1,K9UQR0,A0A2T1G8M7,K9VUN0,K9ZDE3,A0A2T1LS63,A0A1Z4K1Y3,A0A0P4UVI8,A0A0V7ZCG4,A0A1J0AGK2,K9PFF9,A0A2G9DT08,K9UEV4,A0A1H3LE92,A0A496APJ8,A0A062U2W9,H0HWQ5,A0A1V9G9U4,A0A1I2ZGP1,A0A317EJY3,A0A1I2BD20,F8ERC7,A0A1I2T6Q1,A0A0Q2M2Z1,D3S0S6,A0A2D1U4H7,I3TE64,A0A0B7I4Z6,Q8DKB1,A0A139WY18,A0A1J1EK56,A0A2T1E1K4,A0A1Q8ZD62,A0A1Z3HNN4,A0A2N4XBY2,Q53W94,A0A1K1RQP7,A0A2T1EKT1,A0A1N6LUI7,A0A0A2LKJ7,K1L112,E0UCX3,K9XZC6,A0A0C1VHB4,Q31N05,A5D4D9,Q2JI93,A0A142Y7A9,A0A2T2YMB1,A0A329TD61,A0A101R2A0,A0A1E3XF49,A0A1U9ND56,A0A4R7BQC4,A0A1Q1FPH0,A0A4Q2UIU6,A0A318LG42,H1YCU5,L0JS08,A0A1Q5ZS75,A0A345E7N0,M0AF24,A0A1W2A082,A0A1H3X247,A0A0C1XUA0,M0D2X3,A0A346PK63,A0A1H2RBI2,A0A1C3ZXN2,B9LVP8,M5RSF0,B7K585,F8D8G0,A0A343TL88,L0AJX6,A0A3P3RGE5,A0A329TBQ3,A0A285N2A8,A0A0W1S8B8,A0A1V4C8L7,L9VRQ2,E4NRV1,A0A1I6HGN0,,",366,37
"1179","N.H4.4","N.H4.6",327,180,147,1.93849206349206,"4F1N,4F3T,4KRE,5GUH,5VM9,6KR6,6OON,7KX7,7SWF,A0A163JTZ6,A0A0N4X8S8,A0A196SDB4,J9D5G4,C4LVV2,A0A2P6N8X7,A8BCK6,A2DPV7,A0A0G4H2S4,T1H8B3,S4RWI0,D2VMG4,A0A074TLL7,A0A0D1ZAJ4,Q1K660,F4PH46,A0A3M7S814,A0A164ZA52,A0A383WDW5,Q54G64,S7WCF7,I0YVB2,R7QGN7,C1DZY0,A0A2C5Z0M1,A0CB11,R9ACY5,D3BMP8,A0A1Z5TVE5,W7XD45,A0A1U7LLR0,A0A4S2MWZ7,K1VVQ6,A0A158P1R9,G7DVX0,V6R0U9,G4N9J3,E3KLI3,B7Q5I1,A0A1E3QC61,D5GGK8,S8ANP9,A0A139AUH8,L2GMR6,U4LBG4,A0A177URI1,O74957,A0A3N4IGK1,A6N7Y9,A0A0E9NDK5,T1KZ60,A0A250WXN5,A0A2G8JLH3,Q5KAT1,L2GUF2,W2T741,A0A1W0E4B5,A0A2J7QB22,S4RYE2,A0A2K3CW87,A0A388KES6,A0A226EFL3,A0A3S3PD82,A0A0L0TEV1,A0A1S3J512,G0QTT2,A0A1J1HRI1,C4V9J2,Q9JMB7,A0A075AN09,Q5TW24,U5HIG6,A0A401PRI6,Q96J94,A0A2B4RHN2,G2QEV0,A0A397UU01,A0A2T7PFL8,K7ISV0,A0A024FT57,H3HCL6,E9FUN9,A0A1S3CYL5,D7FQK3,A0A1Y1YHC8,T1GSU4,F4S231,A0A1D8PMK0,A0A2G5B1D8,Q5BD61,A0A1C7M8P2,A0A4D8YSQ3,A0A158PJG6,J9JZ66,A0A0C2XG51,A0A158QZT6,A0A165QYQ9,T0SAU8,R7YY92,A0A3S1A0C3,A0A074YJ47,A0A2K1J482,A0A1Q3ENA6,O04379,A0A371I3C8,M8AEW7,A8P0D4,A0A2K3NY65,F4NYW7,A0A409Y6G2,A0A0L0HAB7,D8PZT7,A0A1D1W4K0,A7RQ46,W4YU94,A7BJS5,D8SNM6,A0A1J8PPA3,X1WG39,M5FQK2,Q69VD5,A0A2R6NSC2,A0A0D8XL16,A0A016WPN3,Q9QZ81,G5EES3,A0A0K0EFP6,Q8CJG0,A0A1D5NTU6,V2WTL2,A0A0V0YLH8,A0A139WDH0,A0A0R3W9Q7,H3DS31,A0A1Y1HWP2,G4T5G9,B7QCC4,A0A0B2UV00,M7BCJ9,E9GN30,Q7PZ41,A0A077Z361,R7U9I3,A0A1X7V1N5,A0A0K0JDP1,A0A0N4UKJ1,A0A498N3A3,A0A3M0IQP5,A0A0L8GBV4,Q32KD4,A0A1J1JBJ0,E0W4C3,A0A482XDA9,A0A3P7EJD6,J9K2Z4,A0A2J7Q8V4,T1IBM6,V3ZRX0,A0A210QKF7,A0A423TSS1,K1PT78,A0A267E8R7,A0A1D2N447,A0A226D7A9,F6YK55,T1KTE4,A0A2C9JGZ6,A0A1V9X9F0,K5X5Z7,A0A3Q0KUG5,T1FY40,1YVU,1Z26,3DLB,5AWH,5G5T,6QZK,7R8K,E8N0K8,A0A328VKE4,C4L1M1,A0A0M2PXX3,A0A1I3LMA1,K9TPA9,A0A142XB92,B1XJG0,H1KXR6,A0A1Q4R485,K9U8J6,A0A097QRL6,K9RC91,A0A0D8ZUC0,A0A139XGN8,A0A1T4Y3A2,B6YTQ5,A0A0B0H9B4,A0YYT3,A0A2T1EFY0,G6FTN0,R6KUL9,A0A433NB65,A0A1Z4L0A1,K9UQR0,A0A2T1G8M7,K9VUN0,B7GJX9,K9ZDE3,B0JXD6,A0A2T1LS63,A0A1Z4K1Y3,A0A1N6SSK9,A0A0P4UVI8,A0A0V7ZCG4,A0A1J0AGK2,K9PFF9,A0A2G9DT08,K9UEV4,Q9L1X1,A0A060HNJ0,A0A235B542,R5XQK4,A0A496APJ8,A0A062U2W9,H0HWQ5,A0A1V9G9U4,A0A1I2ZGP1,A0A317EJY3,A0A1I2BD20,S7VLM7,A0A1A5X8H4,A0A1I2T6Q1,A0A1R3T9N6,A0A0Q2M2Z1,H8KXJ0,D3S0S6,A0A2D1U4H7,A0A0B7I4Z6,A0LL61,Q8DKB1,A0A139WY18,A0A1J1EK56,A0A2T1E1K4,A0A1Q8ZD62,A0A4Q6XKV6,A0A1Z3HNN4,A0A239JE83,A0A2N4XBY2,Q53W94,R5JEI2,A0A0Q0ZC47,A0A2T0XH18,A0A1V4CHV0,A0A1K1RQP7,A0A2T1EKT1,A0A1N6LUI7,A0A0P0NGR6,A0A1X7IML5,A0A0A2LKJ7,K1L112,A0A0U3AL92,A0A1H3A054,E0UCX3,K9XZC6,A0A0C1VHB4,Q31N05,A0A0C5JKF3,R5NJJ8,A5D4D9,Q2JI93,A0A142Y7A9,A0A432MEQ5,A0A372DKU2,A0A3R7KLK4,C1F5Q7,A0A4R3EV39,A0A1P8WP90,A0A222F7P0,A0A1C9VH88,A0A2T2YMB1,A0A329TD61,A0A101R2A0,A0A1E3XF49,A0A1U9ND56,A0A4R7BQC4,A0A1H3DGN3,A0A1Q1FPH0,E0TGY3,A0A259TUP4,F6EYI8,A0A2S9Q9J0,A0A4Q2UIU6,A0A1H0LH25,A0A318LG42,H1YCU5,A0A1Q5ZS75,A0A345E7N0,M0AF24,A0A1W2A082,A0A1H3X247,A0A0C1XUA0,M0D2X3,A0A2R5G167,A0A346PK63,R7RTW6,A0A1H2RBI2,B9LVP8,M5RSF0,B7K585,A0A343TL88,A0A343JEE2,A0A3P3RGE5,A0A329TBQ3,A0A0W1S8B8,A0A1V4C8L7,L9VRQ2,E4NRV1,A0A1I6HGN0,A0A1I0NI68,,",366,37
"1188","C.H3.10","C.H3.6",361,181,180,3.22025782688766,"4F1N,4F3T,4KRE,5GUH,5VM9,6KR6,6OON,7KX7,7SWF,A0A163JTZ6,A0A196SDB4,J9D5G4,Q389P5,C4LVV2,A0A2P6N8X7,A8BCK6,A2DPV7,A0A0G4H2S4,T1H8B3,S4RWI0,D2VMG4,A0A074TLL7,A0A0D1ZAJ4,Q1K660,F4PH46,A0A3M7S814,A0A164ZA52,A0A383WDW5,Q54G64,S7WCF7,I0YVB2,R7QGN7,C1DZY0,A0A2C5Z0M1,A0CB11,R9ACY5,D3BMP8,A0A1Z5TVE5,W7XD45,A0A1U7LLR0,A0A4S2MWZ7,K1VVQ6,A0A158P1R9,G7DVX0,V6R0U9,G4N9J3,E3KLI3,B7Q5I1,A0A1E3QC61,D5GGK8,S8ANP9,A0A139AUH8,L2GMR6,U4LBG4,A0A177URI1,O74957,A0A3N4IGK1,A6N7Y9,A0A0E9NDK5,T1KZ60,A0A250WXN5,A0A2G8JLH3,Q5KAT1,L2GUF2,W2T741,A0A1W0E4B5,A0A2J7QB22,S4RYE2,A0A2K3CW87,A0A388KES6,A0A226EFL3,A0A3S3PD82,A0A0L0TEV1,A0A1S3J512,G0QTT2,A0A1J1HRI1,C4V9J2,Q9JMB7,A0A075AN09,Q5TW24,U5HIG6,A0A401PRI6,Q96J94,A0A2B4RHN2,G2QEV0,A0A397UU01,A0A2T7PFL8,K7ISV0,A0A024FT57,H3HCL6,A0A0G4IME3,E9FUN9,A0A1S3CYL5,D7FQK3,A0A1Y1YHC8,T1GSU4,F4S231,A0A1D8PMK0,A0A2G5B1D8,Q5BD61,A0A1C7M8P2,A0A4D8YSQ3,A0A158PJG6,J9JZ66,A0A0C2XG51,A0A158QZT6,A0A165QYQ9,T0SAU8,R7YY92,A0A3S1A0C3,A0A074YJ47,A0A2K1J482,A0A1Q3ENA6,O04379,A0A371I3C8,M8AEW7,A8P0D4,A0A2K3NY65,F4NYW7,A0A409Y6G2,A0A0L0HAB7,D8PZT7,A0A1D1W4K0,A7RQ46,W4YU94,A7BJS5,D8SNM6,A0A1J8PPA3,X1WG39,M5FQK2,Q69VD5,A0A2R6NSC2,A0A0D8XL16,A0A016WPN3,Q9QZ81,G5EES3,A0A0K0EFP6,Q8CJG0,A0A1D5NTU6,V2WTL2,A0A0V0YLH8,A0A139WDH0,A0A0R3W9Q7,H3DS31,A0A1Y1HWP2,G4T5G9,B7QCC4,A0A0B2UV00,M7BCJ9,E9GN30,Q7PZ41,A0A077Z361,R7U9I3,A0A1X7V1N5,A0A0K0JDP1,A0A0N4UKJ1,A0A498N3A3,A0A3M0IQP5,A0A0L8GBV4,Q32KD4,A0A1J1JBJ0,E0W4C3,A0A482XDA9,A0A3P7EJD6,J9K2Z4,A0A2J7Q8V4,T1IBM6,V3ZRX0,A0A210QKF7,A0A423TSS1,K1PT78,A0A267E8R7,A0A1D2N447,A0A226D7A9,F6YK55,T1KTE4,A0A2C9JGZ6,A0A1V9X9F0,K5X5Z7,A0A3Q0KUG5,T1FY40,1YVU,1Z26,3DLB,5AWH,5G5T,5I4A,6QZK,7R8K,E8N0K8,A0A1I7IXT4,A0A2W1JZ37,A0A2S7WBN3,A0A328VKE4,A0A420DFE6,E0ST67,A0A4V1VDY2,A0A368P5I0,C4L1M1,A0A4R1RMM2,A0A1Y2RDH8,Q11QW7,A0A1M5ZSR3,A0A0K8QX04,A0A0M2PXX3,A0A1I3LMA1,K9TPA9,A0A1L3JHM3,A0A1W6MIP2,A0A1C0UUC4,A0A2U2J9E0,A0A2Z6E1D5,A0A0F4NXW8,A0A142XB92,L8D0R3,B1XJG0,A0A326U7G5,A0A3D8L290,H1KXR6,A0A1Q4R485,K9U8J6,A0A097QRL6,K9RC91,A0A0D8ZUC0,A0A139XGN8,A0A1T4Y3A2,Q5P0R2,B6YTQ5,A0A0B0H9B4,A0YYT3,A0A2T1EFY0,G6FTN0,R6KUL9,A0A433NB65,A0A1Z4L0A1,K9UQR0,A0A2T1G8M7,K9VUN0,B7GJX9,A0A0P6X5X2,K9ZDE3,B0JXD6,A0A2T1LS63,A0A1Z4K1Y3,A0A2Z6E0R7,A0A1N6SSK9,A0A0P4UVI8,A0A0V7ZCG4,A0A1J0AGK2,K9PFF9,A0A2G9DT08,K9UEV4,Q9L1X1,A0A060HNJ0,A0A235B542,R5XQK4,A0A1H3LE92,A0A496APJ8,A0A062U2W9,H0HWQ5,A0A1V9G9U4,A0A1I2ZGP1,A0A317EJY3,A0A1I2BD20,F8ERC7,S7VLM7,A0A1A5X8H4,A0A1I2T6Q1,A0A1R3T9N6,A0A0Q2M2Z1,H8KXJ0,D3S0S6,A0A2D1U4H7,I3TE64,A0A0B7I4Z6,A0LL61,Q8DKB1,A0A139WY18,A0A1J1EK56,A0A2T1E1K4,A0A1Q8ZD62,A0A4Q6XKV6,A0A1Z3HNN4,A0A239JE83,A0A2N4XBY2,Q53W94,R5JEI2,A0A0Q0ZC47,A0A2T0XH18,A0A1V4CHV0,A0A1K1RQP7,A0A2T1EKT1,A0A1N6LUI7,A0A0P0NGR6,A0A1X7IML5,A0A0A2LKJ7,K1L112,A0A0U3AL92,A0A1H3A054,E0UCX3,K9XZC6,A0A0C1VHB4,Q31N05,A0A0C5JKF3,R5NJJ8,A5D4D9,Q2JI93,A0A142Y7A9,A0A432MEQ5,A0A372DKU2,C1F5Q7,A0A4R3EV39,A0A1P8WP90,A0A222F7P0,A0A1C9VH88,A0A2T2YMB1,A0A329TD61,A0A101R2A0,A0A1E3XF49,A0A1U9ND56,A0A4R7BQC4,A0A1Q1FPH0,E0TGY3,A0A259TUP4,F6EYI8,A0A2S9Q9J0,A0A4Q2UIU6,A0A1H0LH25,A0A318LG42,H1YCU5,L0JS08,A0A1Q5ZS75,A0A345E7N0,M0AF24,A0A1W2A082,A0A1H3X247,A0A0C1XUA0,M0D2X3,A0A2R5G167,A0A346PK63,R7RTW6,A0A1H2RBI2,A0A1C3ZXN2,B9LVP8,M5RSF0,W0JW77,B7K585,F8D8G0,A0A343TL88,L0AJX6,A0A2A5QS34,A0A343JEE2,A0A3P3RGE5,A0A329TBQ3,A0A285N2A8,A0A0W1S8B8,A0A1V4C8L7,L9VRQ2,E4NRV1,A0A1I6HGN0,A0A1I0NI68,,",366,37
"1189","C.H3.10","C.L9.4",351,181,170,4.08235294117647,"4F1N,4F3T,4KRE,5GUH,5VM9,6KR6,6OON,7KX7,7SWF,A0A163JTZ6,A0A196SDB4,J9D5G4,Q389P5,C4LVV2,A0A2P6N8X7,A8BCK6,A2DPV7,A0A0G4H2S4,T1H8B3,S4RWI0,D2VMG4,A0A074TLL7,A0A0D1ZAJ4,Q1K660,F4PH46,A0A3M7S814,A0A164ZA52,A0A383WDW5,Q54G64,S7WCF7,I0YVB2,R7QGN7,C1DZY0,A0A2C5Z0M1,A0CB11,R9ACY5,D3BMP8,A0A1Z5TVE5,W7XD45,A0A1U7LLR0,A0A4S2MWZ7,K1VVQ6,A0A158P1R9,G7DVX0,V6R0U9,G4N9J3,E3KLI3,B7Q5I1,A0A1E3QC61,D5GGK8,S8ANP9,A0A139AUH8,L2GMR6,U4LBG4,A0A177URI1,O74957,A0A3N4IGK1,A6N7Y9,A0A0E9NDK5,T1KZ60,A0A250WXN5,A0A2G8JLH3,Q5KAT1,L2GUF2,W2T741,A0A1W0E4B5,A0A2J7QB22,S4RYE2,A0A2K3CW87,A0A388KES6,A0A226EFL3,A0A3S3PD82,A0A0L0TEV1,A0A1S3J512,G0QTT2,A0A1J1HRI1,C4V9J2,Q9JMB7,A0A075AN09,Q5TW24,U5HIG6,A0A401PRI6,Q96J94,A0A2B4RHN2,G2QEV0,A0A397UU01,A0A2T7PFL8,K7ISV0,A0A024FT57,H3HCL6,A0A0G4IME3,E9FUN9,A0A1S3CYL5,D7FQK3,A0A1Y1YHC8,T1GSU4,F4S231,A0A1D8PMK0,A0A2G5B1D8,Q5BD61,A0A1C7M8P2,A0A4D8YSQ3,A0A158PJG6,J9JZ66,A0A0C2XG51,A0A158QZT6,A0A165QYQ9,T0SAU8,R7YY92,A0A3S1A0C3,A0A074YJ47,A0A2K1J482,A0A1Q3ENA6,O04379,A0A371I3C8,M8AEW7,A8P0D4,A0A2K3NY65,F4NYW7,A0A409Y6G2,A0A0L0HAB7,D8PZT7,A0A1D1W4K0,A7RQ46,W4YU94,A7BJS5,D8SNM6,A0A1J8PPA3,X1WG39,M5FQK2,Q69VD5,A0A2R6NSC2,A0A0D8XL16,A0A016WPN3,Q9QZ81,G5EES3,A0A0K0EFP6,Q8CJG0,A0A1D5NTU6,V2WTL2,A0A0V0YLH8,A0A139WDH0,A0A0R3W9Q7,H3DS31,A0A1Y1HWP2,G4T5G9,B7QCC4,A0A0B2UV00,M7BCJ9,E9GN30,Q7PZ41,A0A077Z361,R7U9I3,A0A1X7V1N5,A0A0K0JDP1,A0A0N4UKJ1,A0A498N3A3,A0A3M0IQP5,A0A0L8GBV4,Q32KD4,A0A1J1JBJ0,E0W4C3,A0A482XDA9,A0A3P7EJD6,J9K2Z4,A0A2J7Q8V4,T1IBM6,V3ZRX0,A0A210QKF7,A0A423TSS1,K1PT78,A0A267E8R7,A0A1D2N447,A0A226D7A9,F6YK55,T1KTE4,A0A2C9JGZ6,A0A1V9X9F0,K5X5Z7,A0A3Q0KUG5,T1FY40,1YVU,1Z26,3DLB,5AWH,5G5T,6QZK,7R8K,E8N0K8,A0A1I7IXT4,A0A2W1JZ37,A0A2S7WBN3,A0A328VKE4,A0A420DFE6,E0ST67,A0A4V1VDY2,A0A368P5I0,C4L1M1,A0A4R1RMM2,A0A1Y2RDH8,Q11QW7,A0A1M5ZSR3,A0A0K8QX04,A0A0M2PXX3,A0A1I3LMA1,K9TPA9,A0A1L3JHM3,A0A1W6MIP2,A0A1C0UUC4,A0A2U2J9E0,A0A2Z6E1D5,A0A0F4NXW8,A0A142XB92,L8D0R3,B1XJG0,A0A326U7G5,A0A3D8L290,A0A1Q4R485,K9U8J6,A0A097QRL6,K9RC91,A0A0D8ZUC0,A0A139XGN8,A0A1T4Y3A2,Q5P0R2,B6YTQ5,A0A0B0H9B4,A0YYT3,A0A2T1EFY0,G6FTN0,R6KUL9,A0A433NB65,A0A1Z4L0A1,K9UQR0,A0A2T1G8M7,K9VUN0,B7GJX9,A0A0P6X5X2,K9ZDE3,B0JXD6,A0A2T1LS63,A0A1Z4K1Y3,A0A2Z6E0R7,A0A1N6SSK9,A0A0P4UVI8,A0A0V7ZCG4,A0A1J0AGK2,K9PFF9,A0A2G9DT08,K9UEV4,Q9L1X1,A0A060HNJ0,A0A235B542,R5XQK4,A0A1H3LE92,A0A496APJ8,A0A062U2W9,H0HWQ5,A0A1V9G9U4,A0A1I2ZGP1,A0A317EJY3,A0A1I2BD20,S7VLM7,A0A1A5X8H4,A0A1I2T6Q1,A0A1R3T9N6,A0A0Q2M2Z1,H8KXJ0,D3S0S6,A0A2D1U4H7,I3TE64,A0A0B7I4Z6,A0LL61,Q8DKB1,A0A139WY18,A0A1J1EK56,A0A2T1E1K4,A0A1Q8ZD62,A0A4Q6XKV6,A0A1Z3HNN4,A0A239JE83,A0A2N4XBY2,Q53W94,R5JEI2,A0A0Q0ZC47,A0A2T0XH18,A0A1V4CHV0,A0A1K1RQP7,A0A2T1EKT1,A0A1N6LUI7,A0A0P0NGR6,A0A1X7IML5,A0A0A2LKJ7,K1L112,A0A0U3AL92,A0A1H3A054,E0UCX3,K9XZC6,A0A0C1VHB4,Q31N05,A0A0C5JKF3,R5NJJ8,A5D4D9,Q2JI93,A0A142Y7A9,A0A432MEQ5,A0A372DKU2,C1F5Q7,A0A4R3EV39,A0A1P8WP90,A0A222F7P0,A0A1C9VH88,A0A2T2YMB1,A0A329TD61,A0A101R2A0,A0A1U9ND56,A0A4R7BQC4,A0A1Q1FPH0,E0TGY3,A0A259TUP4,F6EYI8,A0A2S9Q9J0,A0A4Q2UIU6,A0A1H0LH25,A0A318LG42,L0JS08,A0A345E7N0,M0AF24,A0A1H3X247,M0D2X3,A0A2R5G167,A0A346PK63,R7RTW6,B9LVP8,M5RSF0,W0JW77,B7K585,F8D8G0,A0A343TL88,L0AJX6,A0A2A5QS34,A0A343JEE2,A0A3P3RGE5,A0A329TBQ3,A0A285N2A8,A0A0W1S8B8,A0A1V4C8L7,L9VRQ2,E4NRV1,A0A1I6HGN0,A0A1I0NI68,,",366,37
"1190","C.H3.11","C.H3.7",357,181,176,4.4858582370668,"4F1N,4F3T,4KRE,5GUH,5VM9,6KR6,6OON,7KX7,7SWF,A0A163JTZ6,A0A0N4X8S8,A0A196SDB4,J9D5G4,Q389P5,C4LVV2,A0A2P6N8X7,A8BCK6,A2DPV7,A0A0G4H2S4,T1H8B3,S4RWI0,D2VMG4,A0A074TLL7,A0A0D1ZAJ4,Q1K660,F4PH46,A0A3M7S814,A0A164ZA52,Q54G64,S7WCF7,I0YVB2,R7QGN7,C1DZY0,A0A2C5Z0M1,A0CB11,R9ACY5,D3BMP8,A0A1Z5TVE5,W7XD45,A0A1U7LLR0,A0A4S2MWZ7,K1VVQ6,A0A158P1R9,G7DVX0,V6R0U9,G4N9J3,E3KLI3,B7Q5I1,A0A1E3QC61,D5GGK8,S8ANP9,A0A139AUH8,L2GMR6,U4LBG4,A0A177URI1,O74957,A0A3N4IGK1,A6N7Y9,A0A0E9NDK5,T1KZ60,A0A250WXN5,A0A2G8JLH3,Q5KAT1,L2GUF2,W2T741,A0A1W0E4B5,A0A2J7QB22,S4RYE2,A0A2K3CW87,A0A388KES6,A0A226EFL3,A0A3S3PD82,A0A0L0TEV1,A0A1S3J512,G0QTT2,A0A1J1HRI1,C4V9J2,Q9JMB7,A0A075AN09,Q5TW24,U5HIG6,A0A401PRI6,Q96J94,A0A2B4RHN2,G2QEV0,A0A397UU01,A0A2T7PFL8,K7ISV0,A0A024FT57,H3HCL6,A0A0G4IME3,E9FUN9,A0A1S3CYL5,D7FQK3,A0A1Y1YHC8,T1GSU4,F4S231,A0A1D8PMK0,A0A2G5B1D8,Q5BD61,A0A1C7M8P2,A0A4D8YSQ3,A0A158PJG6,J9JZ66,A0A0C2XG51,A0A158QZT6,A0A165QYQ9,T0SAU8,R7YY92,A0A3S1A0C3,A0A074YJ47,A0A2K1J482,A0A1Q3ENA6,O04379,A0A371I3C8,M8AEW7,A8P0D4,A0A2K3NY65,F4NYW7,A0A409Y6G2,A0A0L0HAB7,D8PZT7,A0A1D1W4K0,A7RQ46,W4YU94,A7BJS5,D8SNM6,A0A1J8PPA3,X1WG39,M5FQK2,Q69VD5,A0A2R6NSC2,A0A0D8XL16,A0A016WPN3,Q9QZ81,G5EES3,A0A0K0EFP6,Q8CJG0,A0A1D5NTU6,V2WTL2,A0A0V0YLH8,A0A139WDH0,A0A0R3W9Q7,H3DS31,A0A1Y1HWP2,G4T5G9,B7QCC4,A0A0B2UV00,M7BCJ9,E9GN30,Q7PZ41,A0A077Z361,R7U9I3,A0A1X7V1N5,A0A0K0JDP1,A0A0N4UKJ1,A0A498N3A3,A0A3M0IQP5,A0A0L8GBV4,Q32KD4,A0A1J1JBJ0,E0W4C3,A0A482XDA9,A0A3P7EJD6,J9K2Z4,A0A2J7Q8V4,T1IBM6,V3ZRX0,A0A210QKF7,A0A423TSS1,K1PT78,A0A267E8R7,A0A1D2N447,A0A226D7A9,F6YK55,T1KTE4,A0A2C9JGZ6,A0A1V9X9F0,K5X5Z7,A0A3Q0KUG5,T1FY40,1YVU,1Z26,3DLB,5AWH,5G5T,6QZK,7R8K,E8N0K8,A0A1I7IXT4,A0A2W1JZ37,A0A2S7WBN3,A0A328VKE4,A0A420DFE6,E0ST67,A0A4V1VDY2,A0A368P5I0,C4L1M1,A0A4R1RMM2,A0A1Y2RDH8,Q11QW7,A0A1M5ZSR3,A0A0K8QX04,A0A0M2PXX3,A0A1I3LMA1,K9TPA9,A0A1L3JHM3,A0A1W6MIP2,A0A1C0UUC4,A0A2U2J9E0,A0A2Z6E1D5,A0A0F4NXW8,L8D0R3,B1XJG0,A0A326U7G5,A0A3D8L290,H1KXR6,A0A1Q4R485,K9U8J6,A0A097QRL6,K9RC91,A0A0D8ZUC0,A0A139XGN8,A0A1T4Y3A2,Q5P0R2,B6YTQ5,A0A0B0H9B4,A0YYT3,A0A2T1EFY0,G6FTN0,R6KUL9,A0A433NB65,A0A1Z4L0A1,K9UQR0,A0A2T1G8M7,K9VUN0,B7GJX9,A0A0P6X5X2,K9ZDE3,B0JXD6,A0A2T1LS63,A0A1Z4K1Y3,A0A2Z6E0R7,A0A1N6SSK9,A0A0P4UVI8,A0A0V7ZCG4,A0A1J0AGK2,K9PFF9,A0A2G9DT08,K9UEV4,Q9L1X1,A0A060HNJ0,A0A235B542,A0A1H3LE92,A0A496APJ8,A0A062U2W9,A0A1V9G9U4,A0A1I2ZGP1,A0A317EJY3,A0A1I2BD20,F8ERC7,S7VLM7,A0A1A5X8H4,A0A1I2T6Q1,A0A1R3T9N6,A0A0Q2M2Z1,H8KXJ0,D3S0S6,A0A2D1U4H7,I3TE64,A0A0B7I4Z6,A0LL61,Q8DKB1,A0A139WY18,A0A1J1EK56,A0A2T1E1K4,A0A1Q8ZD62,A0A4Q6XKV6,A0A1Z3HNN4,A0A239JE83,A0A2N4XBY2,Q53W94,R5JEI2,A0A0Q0ZC47,A0A2T0XH18,A0A1V4CHV0,A0A1K1RQP7,A0A2T1EKT1,A0A1N6LUI7,A0A0P0NGR6,A0A1X7IML5,A0A0A2LKJ7,K1L112,A0A0U3AL92,A0A1H3A054,E0UCX3,K9XZC6,A0A0C1VHB4,Q31N05,A0A0C5JKF3,R5NJJ8,A5D4D9,Q2JI93,A0A142Y7A9,A0A432MEQ5,A0A372DKU2,C1F5Q7,A0A4R3EV39,A0A1P8WP90,A0A222F7P0,A0A1C9VH88,A0A2T2YMB1,A0A329TD61,A0A101R2A0,A0A1E3XF49,A0A1U9ND56,A0A4R7BQC4,A0A1Q1FPH0,E0TGY3,A0A259TUP4,F6EYI8,A0A2S9Q9J0,A0A4Q2UIU6,A0A1H0LH25,A0A318LG42,H1YCU5,L0JS08,A0A1Q5ZS75,A0A345E7N0,M0AF24,A0A1W2A082,A0A1H3X247,A0A0C1XUA0,M0D2X3,A0A2R5G167,A0A346PK63,R7RTW6,A0A1H2RBI2,A0A1C3ZXN2,B9LVP8,M5RSF0,W0JW77,B7K585,F8D8G0,A0A343TL88,L0AJX6,A0A2A5QS34,A0A343JEE2,A0A3P3RGE5,A0A329TBQ3,A0A285N2A8,A0A0W1S8B8,A0A1V4C8L7,L9VRQ2,E4NRV1,A0A1I6HGN0,A0A1I0NI68,,",366,37
"1191","C.H3.3","C.H3.6",300,181,119,1.92348762709504,"4F1N,4F3T,4KRE,5GUH,5VM9,6KR6,6OON,7KX7,7SWF,A0A163JTZ6,A0A0N4X8S8,A0A196SDB4,J9D5G4,Q389P5,C4LVV2,A0A2P6N8X7,A8BCK6,A2DPV7,A0A0G4H2S4,T1H8B3,S4RWI0,D2VMG4,A0A074TLL7,A0A0D1ZAJ4,Q1K660,F4PH46,A0A3M7S814,A0A164ZA52,A0A383WDW5,Q54G64,S7WCF7,I0YVB2,R7QGN7,C1DZY0,A0A2C5Z0M1,A0CB11,R9ACY5,D3BMP8,A0A1Z5TVE5,W7XD45,A0A1U7LLR0,A0A4S2MWZ7,K1VVQ6,A0A158P1R9,G7DVX0,V6R0U9,G4N9J3,E3KLI3,B7Q5I1,A0A1E3QC61,D5GGK8,S8ANP9,A0A139AUH8,L2GMR6,U4LBG4,A0A177URI1,O74957,A0A3N4IGK1,A6N7Y9,A0A0E9NDK5,T1KZ60,A0A250WXN5,A0A2G8JLH3,Q5KAT1,L2GUF2,W2T741,A0A1W0E4B5,A0A2J7QB22,S4RYE2,A0A2K3CW87,A0A388KES6,A0A226EFL3,A0A3S3PD82,A0A0L0TEV1,A0A1S3J512,G0QTT2,A0A1J1HRI1,C4V9J2,Q9JMB7,A0A075AN09,Q5TW24,U5HIG6,A0A401PRI6,Q96J94,A0A2B4RHN2,G2QEV0,A0A397UU01,A0A2T7PFL8,K7ISV0,A0A024FT57,H3HCL6,A0A0G4IME3,E9FUN9,A0A1S3CYL5,D7FQK3,A0A1Y1YHC8,F4S231,A0A1D8PMK0,A0A2G5B1D8,Q5BD61,A0A1C7M8P2,A0A4D8YSQ3,A0A158PJG6,J9JZ66,A0A0C2XG51,A0A158QZT6,A0A165QYQ9,T0SAU8,R7YY92,A0A3S1A0C3,A0A074YJ47,A0A2K1J482,A0A1Q3ENA6,O04379,A0A371I3C8,M8AEW7,A8P0D4,A0A2K3NY65,F4NYW7,A0A409Y6G2,A0A0L0HAB7,D8PZT7,A0A1D1W4K0,A7RQ46,W4YU94,A7BJS5,D8SNM6,A0A1J8PPA3,X1WG39,M5FQK2,Q69VD5,A0A2R6NSC2,A0A0D8XL16,A0A016WPN3,Q9QZ81,G5EES3,A0A0K0EFP6,Q8CJG0,A0A1D5NTU6,V2WTL2,A0A0V0YLH8,A0A139WDH0,A0A0R3W9Q7,H3DS31,A0A1Y1HWP2,G4T5G9,B7QCC4,A0A0B2UV00,M7BCJ9,E9GN30,Q7PZ41,A0A077Z361,R7U9I3,A0A1X7V1N5,A0A0K0JDP1,A0A0N4UKJ1,A0A498N3A3,A0A3M0IQP5,A0A0L8GBV4,Q32KD4,A0A1J1JBJ0,E0W4C3,A0A482XDA9,A0A3P7EJD6,J9K2Z4,A0A2J7Q8V4,T1IBM6,V3ZRX0,A0A210QKF7,A0A423TSS1,K1PT78,A0A267E8R7,A0A1D2N447,A0A226D7A9,F6YK55,T1KTE4,A0A2C9JGZ6,A0A1V9X9F0,K5X5Z7,A0A3Q0KUG5,T1FY40,1YVU,1Z26,5AWH,5G5T,5I4A,E8N0K8,A0A328VKE4,E0ST67,C4L1M1,A0A4R1RMM2,A0A0K8QX04,A0A0M2PXX3,A0A1I3LMA1,K9TPA9,A0A1L3JHM3,A0A2U2J9E0,A0A142XB92,B1XJG0,A0A326U7G5,H1KXR6,A0A1Q4R485,K9U8J6,A0A097QRL6,K9RC91,A0A0D8ZUC0,A0A139XGN8,A0A1T4Y3A2,B6YTQ5,A0A0B0H9B4,A0YYT3,A0A2T1EFY0,G6FTN0,R6KUL9,A0A433NB65,A0A1Z4L0A1,K9UQR0,A0A2T1G8M7,K9VUN0,B7GJX9,A0A0P6X5X2,K9ZDE3,A0A2T1LS63,A0A1Z4K1Y3,A0A1N6SSK9,A0A0P4UVI8,A0A0V7ZCG4,A0A1J0AGK2,K9PFF9,K9UEV4,A0A235B542,R5XQK4,S7VLM7,A0A1A5X8H4,A0A1R3T9N6,D3S0S6,A0A2D1U4H7,I3TE64,A0A0B7I4Z6,A0LL61,Q8DKB1,A0A1J1EK56,A0A4Q6XKV6,A0A239JE83,A0A2N4XBY2,Q53W94,R5JEI2,A0A2T0XH18,A0A1V4CHV0,A0A2T1EKT1,A0A1N6LUI7,A0A1X7IML5,A0A0A2LKJ7,E0UCX3,K9XZC6,A0A0C1VHB4,Q31N05,A0A0C5JKF3,R5NJJ8,A5D4D9,Q2JI93,A0A142Y7A9,A0A432MEQ5,A0A372DKU2,A0A4R3EV39,A0A222F7P0,A0A329TD61,A0A1U9ND56,A0A4R7BQC4,A0A1Q1FPH0,E0TGY3,A0A259TUP4,F6EYI8,A0A2S9Q9J0,A0A4Q2UIU6,A0A1H0LH25,L0JS08,A0A345E7N0,M0AF24,A0A1W2A082,A0A1H3X247,M0D2X3,A0A2R5G167,A0A346PK63,R7RTW6,A0A1H2RBI2,B9LVP8,M5RSF0,W0JW77,B7K585,A0A343TL88,L0AJX6,A0A2A5QS34,A0A343JEE2,A0A3P3RGE5,A0A329TBQ3,A0A0W1S8B8,L9VRQ2,E4NRV1,A0A1I6HGN0,,",366,37
"1192","C.H3.3","C.H3.7",341,181,160,6.62042472375691,"4F1N,4F3T,4KRE,5GUH,5VM9,6KR6,6OON,7KX7,7SWF,A0A163JTZ6,A0A0N4X8S8,A0A196SDB4,J9D5G4,Q389P5,C4LVV2,A0A2P6N8X7,A8BCK6,A2DPV7,A0A0G4H2S4,T1H8B3,S4RWI0,D2VMG4,A0A074TLL7,A0A0D1ZAJ4,Q1K660,F4PH46,A0A3M7S814,A0A164ZA52,A0A383WDW5,Q54G64,S7WCF7,I0YVB2,R7QGN7,C1DZY0,A0A2C5Z0M1,A0CB11,R9ACY5,D3BMP8,A0A1Z5TVE5,W7XD45,A0A1U7LLR0,A0A4S2MWZ7,K1VVQ6,A0A158P1R9,G7DVX0,V6R0U9,G4N9J3,E3KLI3,B7Q5I1,A0A1E3QC61,D5GGK8,S8ANP9,A0A139AUH8,L2GMR6,U4LBG4,A0A177URI1,O74957,A0A3N4IGK1,A6N7Y9,A0A0E9NDK5,T1KZ60,A0A250WXN5,A0A2G8JLH3,Q5KAT1,L2GUF2,W2T741,A0A1W0E4B5,A0A2J7QB22,S4RYE2,A0A2K3CW87,A0A388KES6,A0A226EFL3,A0A3S3PD82,A0A0L0TEV1,A0A1S3J512,G0QTT2,A0A1J1HRI1,C4V9J2,Q9JMB7,A0A075AN09,Q5TW24,U5HIG6,A0A401PRI6,Q96J94,A0A2B4RHN2,G2QEV0,A0A397UU01,A0A2T7PFL8,K7ISV0,A0A024FT57,H3HCL6,A0A0G4IME3,E9FUN9,A0A1S3CYL5,D7FQK3,A0A1Y1YHC8,F4S231,A0A1D8PMK0,A0A2G5B1D8,Q5BD61,A0A1C7M8P2,A0A4D8YSQ3,A0A158PJG6,J9JZ66,A0A0C2XG51,A0A158QZT6,A0A165QYQ9,T0SAU8,R7YY92,A0A3S1A0C3,A0A074YJ47,A0A2K1J482,A0A1Q3ENA6,O04379,A0A371I3C8,M8AEW7,A8P0D4,A0A2K3NY65,F4NYW7,A0A409Y6G2,A0A0L0HAB7,D8PZT7,A0A1D1W4K0,A7RQ46,W4YU94,A7BJS5,D8SNM6,A0A1J8PPA3,X1WG39,M5FQK2,Q69VD5,A0A2R6NSC2,A0A0D8XL16,A0A016WPN3,Q9QZ81,G5EES3,A0A0K0EFP6,Q8CJG0,A0A1D5NTU6,V2WTL2,A0A0V0YLH8,A0A139WDH0,A0A0R3W9Q7,H3DS31,A0A1Y1HWP2,G4T5G9,B7QCC4,A0A0B2UV00,M7BCJ9,E9GN30,Q7PZ41,A0A077Z361,R7U9I3,A0A1X7V1N5,A0A0K0JDP1,A0A0N4UKJ1,A0A498N3A3,A0A3M0IQP5,A0A0L8GBV4,Q32KD4,A0A1J1JBJ0,E0W4C3,A0A482XDA9,A0A3P7EJD6,J9K2Z4,A0A2J7Q8V4,T1IBM6,V3ZRX0,A0A210QKF7,A0A423TSS1,K1PT78,A0A267E8R7,A0A1D2N447,A0A226D7A9,F6YK55,T1KTE4,A0A2C9JGZ6,A0A1V9X9F0,K5X5Z7,A0A3Q0KUG5,T1FY40,1YVU,1Z26,3DLB,5AWH,5G5T,5I4A,6QZK,E8N0K8,A0A1I7IXT4,A0A2W1JZ37,A0A2S7WBN3,A0A328VKE4,A0A420DFE6,E0ST67,A0A4V1VDY2,A0A368P5I0,C4L1M1,A0A4R1RMM2,A0A1Y2RDH8,Q11QW7,A0A1M5ZSR3,A0A0K8QX04,A0A0M2PXX3,A0A1I3LMA1,K9TPA9,A0A1L3JHM3,A0A1W6MIP2,A0A1C0UUC4,A0A2U2J9E0,A0A142XB92,B1XJG0,A0A326U7G5,H1KXR6,A0A1Q4R485,K9U8J6,A0A097QRL6,K9RC91,A0A0D8ZUC0,A0A139XGN8,A0A1T4Y3A2,B6YTQ5,A0A0B0H9B4,A0YYT3,A0A2T1EFY0,G6FTN0,R6KUL9,A0A433NB65,A0A1Z4L0A1,K9UQR0,A0A2T1G8M7,K9VUN0,B7GJX9,A0A0P6X5X2,K9ZDE3,B0JXD6,A0A2T1LS63,A0A1Z4K1Y3,A0A1N6SSK9,A0A0P4UVI8,A0A0V7ZCG4,A0A1J0AGK2,K9PFF9,A0A2G9DT08,K9UEV4,Q9L1X1,A0A235B542,R5XQK4,A0A1H3LE92,A0A496APJ8,A0A1V9G9U4,S7VLM7,A0A1A5X8H4,A0A1I2T6Q1,A0A1R3T9N6,H8KXJ0,D3S0S6,A0A2D1U4H7,I3TE64,A0A0B7I4Z6,A0LL61,Q8DKB1,A0A139WY18,A0A1J1EK56,A0A2T1E1K4,A0A1Q8ZD62,A0A4Q6XKV6,A0A1Z3HNN4,A0A239JE83,A0A2N4XBY2,Q53W94,R5JEI2,A0A0Q0ZC47,A0A2T0XH18,A0A1V4CHV0,A0A1K1RQP7,A0A2T1EKT1,A0A1N6LUI7,A0A0P0NGR6,A0A1X7IML5,A0A0A2LKJ7,K1L112,A0A0U3AL92,A0A1H3A054,E0UCX3,K9XZC6,A0A0C1VHB4,Q31N05,A0A0C5JKF3,R5NJJ8,A5D4D9,Q2JI93,A0A142Y7A9,A0A432MEQ5,A0A372DKU2,C1F5Q7,A0A4R3EV39,A0A1P8WP90,A0A222F7P0,A0A1C9VH88,A0A2T2YMB1,A0A329TD61,A0A101R2A0,A0A1U9ND56,A0A4R7BQC4,A0A1Q1FPH0,E0TGY3,A0A259TUP4,F6EYI8,A0A2S9Q9J0,A0A4Q2UIU6,A0A1H0LH25,A0A318LG42,L0JS08,A0A345E7N0,M0AF24,A0A1W2A082,A0A1H3X247,M0D2X3,A0A2R5G167,A0A346PK63,R7RTW6,A0A1H2RBI2,B9LVP8,M5RSF0,W0JW77,B7K585,F8D8G0,A0A343TL88,L0AJX6,A0A2A5QS34,A0A343JEE2,A0A3P3RGE5,A0A329TBQ3,A0A285N2A8,A0A0W1S8B8,A0A1V4C8L7,L9VRQ2,E4NRV1,A0A1I6HGN0,A0A1I0NI68,,",366,37
"1193","C.H3.4","C.H3.6",354,181,173,1.88804969182129,"4F1N,4F3T,4KRE,5GUH,5VM9,6KR6,6OON,7KX7,7SWF,A0A163JTZ6,A0A0N4X8S8,A0A196SDB4,J9D5G4,Q389P5,C4LVV2,A0A2P6N8X7,A8BCK6,A2DPV7,A0A0G4H2S4,T1H8B3,S4RWI0,D2VMG4,A0A074TLL7,A0A0D1ZAJ4,Q1K660,F4PH46,A0A3M7S814,A0A164ZA52,A0A383WDW5,Q54G64,S7WCF7,I0YVB2,R7QGN7,C1DZY0,A0A2C5Z0M1,A0CB11,R9ACY5,D3BMP8,A0A1Z5TVE5,W7XD45,A0A1U7LLR0,A0A4S2MWZ7,K1VVQ6,A0A158P1R9,G7DVX0,V6R0U9,G4N9J3,E3KLI3,B7Q5I1,A0A1E3QC61,D5GGK8,S8ANP9,A0A139AUH8,L2GMR6,U4LBG4,A0A177URI1,O74957,A0A3N4IGK1,A6N7Y9,A0A0E9NDK5,T1KZ60,A0A250WXN5,A0A2G8JLH3,Q5KAT1,L2GUF2,W2T741,A0A1W0E4B5,A0A2J7QB22,S4RYE2,A0A2K3CW87,A0A388KES6,A0A226EFL3,A0A3S3PD82,A0A0L0TEV1,A0A1S3J512,G0QTT2,A0A1J1HRI1,C4V9J2,Q9JMB7,A0A075AN09,Q5TW24,U5HIG6,A0A401PRI6,Q96J94,A0A2B4RHN2,G2QEV0,A0A397UU01,A0A2T7PFL8,K7ISV0,A0A024FT57,H3HCL6,A0A0G4IME3,E9FUN9,A0A1S3CYL5,D7FQK3,A0A1Y1YHC8,T1GSU4,A0A1D8PMK0,A0A2G5B1D8,Q5BD61,A0A1C7M8P2,A0A4D8YSQ3,A0A158PJG6,J9JZ66,A0A0C2XG51,A0A158QZT6,A0A165QYQ9,T0SAU8,R7YY92,A0A3S1A0C3,A0A074YJ47,A0A2K1J482,A0A1Q3ENA6,O04379,A0A371I3C8,M8AEW7,A8P0D4,A0A2K3NY65,F4NYW7,A0A409Y6G2,A0A0L0HAB7,D8PZT7,A0A1D1W4K0,A7RQ46,W4YU94,A7BJS5,D8SNM6,A0A1J8PPA3,X1WG39,M5FQK2,Q69VD5,A0A2R6NSC2,A0A0D8XL16,A0A016WPN3,Q9QZ81,G5EES3,A0A0K0EFP6,Q8CJG0,A0A1D5NTU6,V2WTL2,A0A0V0YLH8,A0A139WDH0,A0A0R3W9Q7,H3DS31,A0A1Y1HWP2,G4T5G9,B7QCC4,A0A0B2UV00,M7BCJ9,E9GN30,Q7PZ41,A0A077Z361,R7U9I3,A0A1X7V1N5,A0A0K0JDP1,A0A0N4UKJ1,A0A498N3A3,A0A3M0IQP5,A0A0L8GBV4,Q32KD4,A0A1J1JBJ0,E0W4C3,A0A482XDA9,A0A3P7EJD6,J9K2Z4,A0A2J7Q8V4,T1IBM6,V3ZRX0,A0A210QKF7,A0A423TSS1,K1PT78,A0A267E8R7,A0A1D2N447,A0A226D7A9,F6YK55,T1KTE4,A0A2C9JGZ6,A0A1V9X9F0,K5X5Z7,A0A3Q0KUG5,T1FY40,1YVU,1Z26,3DLB,5AWH,5G5T,5I4A,6QZK,7R8K,E8N0K8,A0A1I7IXT4,A0A2W1JZ37,A0A2S7WBN3,A0A328VKE4,A0A420DFE6,E0ST67,A0A4V1VDY2,A0A368P5I0,C4L1M1,A0A4R1RMM2,A0A1Y2RDH8,Q11QW7,A0A1M5ZSR3,A0A0K8QX04,A0A0M2PXX3,A0A1I3LMA1,K9TPA9,A0A1L3JHM3,A0A1W6MIP2,A0A1C0UUC4,A0A2U2J9E0,A0A2Z6E1D5,A0A0F4NXW8,A0A142XB92,L8D0R3,B1XJG0,A0A326U7G5,H1KXR6,A0A1Q4R485,K9U8J6,A0A097QRL6,K9RC91,A0A0D8ZUC0,A0A139XGN8,A0A1T4Y3A2,Q5P0R2,B6YTQ5,A0A0B0H9B4,A0YYT3,A0A2T1EFY0,G6FTN0,R6KUL9,A0A433NB65,A0A1Z4L0A1,K9UQR0,A0A2T1G8M7,K9VUN0,B7GJX9,K9ZDE3,B0JXD6,A0A2T1LS63,A0A1Z4K1Y3,A0A2Z6E0R7,A0A1N6SSK9,A0A0P4UVI8,A0A0V7ZCG4,A0A1J0AGK2,K9PFF9,A0A2G9DT08,K9UEV4,Q9L1X1,A0A235B542,R5XQK4,A0A1H3LE92,A0A496APJ8,A0A062U2W9,H0HWQ5,A0A1V9G9U4,A0A1I2ZGP1,A0A317EJY3,A0A1I2BD20,F8ERC7,S7VLM7,A0A1A5X8H4,A0A1I2T6Q1,A0A1R3T9N6,A0A0Q2M2Z1,H8KXJ0,A0A2D1U4H7,I3TE64,A0A0B7I4Z6,A0LL61,Q8DKB1,A0A139WY18,A0A1J1EK56,A0A2T1E1K4,A0A1Q8ZD62,A0A4Q6XKV6,A0A1Z3HNN4,A0A239JE83,A0A2N4XBY2,Q53W94,R5JEI2,A0A0Q0ZC47,A0A2T0XH18,A0A1V4CHV0,A0A1K1RQP7,A0A2T1EKT1,A0A1N6LUI7,A0A0P0NGR6,A0A1X7IML5,A0A0A2LKJ7,K1L112,A0A0U3AL92,A0A1H3A054,E0UCX3,K9XZC6,A0A0C1VHB4,Q31N05,A0A0C5JKF3,R5NJJ8,A5D4D9,Q2JI93,A0A142Y7A9,A0A432MEQ5,A0A372DKU2,C1F5Q7,A0A4R3EV39,A0A1P8WP90,A0A222F7P0,A0A1C9VH88,A0A2T2YMB1,A0A329TD61,A0A101R2A0,A0A1U9ND56,A0A4R7BQC4,A0A1Q1FPH0,E0TGY3,A0A259TUP4,F6EYI8,A0A2S9Q9J0,A0A4Q2UIU6,A0A1H0LH25,A0A318LG42,L0JS08,A0A1Q5ZS75,A0A345E7N0,M0AF24,A0A1W2A082,A0A1H3X247,M0D2X3,A0A2R5G167,A0A346PK63,R7RTW6,A0A1H2RBI2,A0A1C3ZXN2,B9LVP8,M5RSF0,W0JW77,B7K585,F8D8G0,A0A343TL88,L0AJX6,A0A2A5QS34,A0A343JEE2,A0A3P3RGE5,A0A329TBQ3,A0A285N2A8,A0A0W1S8B8,A0A1V4C8L7,L9VRQ2,E4NRV1,A0A1I6HGN0,A0A1I0NI68,,",366,37
"1194","C.H3.5","C.H3.7",358,181,177,1.77557199488092,"4F1N,4F3T,4KRE,5GUH,5VM9,6KR6,6OON,7KX7,7SWF,A0A163JTZ6,A0A0N4X8S8,A0A196SDB4,J9D5G4,Q389P5,C4LVV2,A0A2P6N8X7,A8BCK6,A2DPV7,A0A0G4H2S4,T1H8B3,S4RWI0,D2VMG4,A0A074TLL7,A0A0D1ZAJ4,Q1K660,F4PH46,A0A3M7S814,A0A164ZA52,A0A383WDW5,Q54G64,S7WCF7,I0YVB2,R7QGN7,C1DZY0,A0A2C5Z0M1,A0CB11,R9ACY5,D3BMP8,A0A1Z5TVE5,W7XD45,A0A1U7LLR0,A0A4S2MWZ7,K1VVQ6,A0A158P1R9,G7DVX0,V6R0U9,G4N9J3,E3KLI3,B7Q5I1,A0A1E3QC61,D5GGK8,S8ANP9,A0A139AUH8,L2GMR6,U4LBG4,A0A177URI1,O74957,A0A3N4IGK1,A6N7Y9,A0A0E9NDK5,T1KZ60,A0A250WXN5,A0A2G8JLH3,Q5KAT1,L2GUF2,W2T741,A0A1W0E4B5,A0A2J7QB22,S4RYE2,A0A2K3CW87,A0A388KES6,A0A226EFL3,A0A3S3PD82,A0A0L0TEV1,A0A1S3J512,G0QTT2,A0A1J1HRI1,C4V9J2,Q9JMB7,A0A075AN09,Q5TW24,U5HIG6,A0A401PRI6,Q96J94,A0A2B4RHN2,G2QEV0,A0A397UU01,A0A2T7PFL8,K7ISV0,A0A024FT57,H3HCL6,A0A0G4IME3,E9FUN9,A0A1S3CYL5,D7FQK3,A0A1Y1YHC8,T1GSU4,A0A1D8PMK0,A0A2G5B1D8,Q5BD61,A0A1C7M8P2,A0A4D8YSQ3,A0A158PJG6,J9JZ66,A0A0C2XG51,A0A158QZT6,A0A165QYQ9,T0SAU8,R7YY92,A0A3S1A0C3,A0A074YJ47,A0A2K1J482,A0A1Q3ENA6,O04379,A0A371I3C8,M8AEW7,A8P0D4,A0A2K3NY65,F4NYW7,A0A409Y6G2,A0A0L0HAB7,D8PZT7,A0A1D1W4K0,A7RQ46,W4YU94,A7BJS5,D8SNM6,A0A1J8PPA3,X1WG39,M5FQK2,Q69VD5,A0A2R6NSC2,A0A0D8XL16,A0A016WPN3,Q9QZ81,G5EES3,A0A0K0EFP6,Q8CJG0,A0A1D5NTU6,V2WTL2,A0A0V0YLH8,A0A139WDH0,A0A0R3W9Q7,H3DS31,A0A1Y1HWP2,G4T5G9,B7QCC4,A0A0B2UV00,M7BCJ9,E9GN30,Q7PZ41,A0A077Z361,R7U9I3,A0A1X7V1N5,A0A0K0JDP1,A0A0N4UKJ1,A0A498N3A3,A0A3M0IQP5,A0A0L8GBV4,Q32KD4,A0A1J1JBJ0,E0W4C3,A0A482XDA9,A0A3P7EJD6,J9K2Z4,A0A2J7Q8V4,T1IBM6,V3ZRX0,A0A210QKF7,A0A423TSS1,K1PT78,A0A267E8R7,A0A1D2N447,A0A226D7A9,F6YK55,T1KTE4,A0A2C9JGZ6,A0A1V9X9F0,K5X5Z7,A0A3Q0KUG5,T1FY40,1YVU,1Z26,3DLB,5AWH,5G5T,5I4A,6QZK,7R8K,E8N0K8,A0A1I7IXT4,A0A2W1JZ37,A0A2S7WBN3,A0A328VKE4,A0A420DFE6,E0ST67,A0A4V1VDY2,A0A368P5I0,C4L1M1,A0A4R1RMM2,A0A1Y2RDH8,Q11QW7,A0A1M5ZSR3,A0A0K8QX04,A0A0M2PXX3,A0A1I3LMA1,K9TPA9,A0A1L3JHM3,A0A1W6MIP2,A0A1C0UUC4,A0A2U2J9E0,A0A2Z6E1D5,A0A0F4NXW8,A0A142XB92,L8D0R3,B1XJG0,A0A326U7G5,A0A3D8L290,H1KXR6,A0A1Q4R485,K9U8J6,A0A097QRL6,K9RC91,A0A0D8ZUC0,A0A139XGN8,A0A1T4Y3A2,Q5P0R2,B6YTQ5,A0A0B0H9B4,A0YYT3,A0A2T1EFY0,G6FTN0,R6KUL9,A0A433NB65,A0A1Z4L0A1,K9UQR0,A0A2T1G8M7,K9VUN0,B7GJX9,A0A0P6X5X2,K9ZDE3,B0JXD6,A0A2T1LS63,A0A1Z4K1Y3,A0A2Z6E0R7,A0A1N6SSK9,A0A0P4UVI8,A0A0V7ZCG4,A0A1J0AGK2,K9PFF9,A0A2G9DT08,K9UEV4,Q9L1X1,A0A060HNJ0,A0A235B542,R5XQK4,A0A1H3LE92,A0A496APJ8,A0A062U2W9,H0HWQ5,A0A1V9G9U4,A0A1I2ZGP1,A0A317EJY3,A0A1I2BD20,F8ERC7,S7VLM7,A0A1A5X8H4,A0A1I2T6Q1,A0A1R3T9N6,A0A0Q2M2Z1,H8KXJ0,A0A2D1U4H7,I3TE64,A0A0B7I4Z6,A0LL61,Q8DKB1,A0A139WY18,A0A1J1EK56,A0A2T1E1K4,A0A1Q8ZD62,A0A4Q6XKV6,A0A1Z3HNN4,A0A239JE83,A0A2N4XBY2,Q53W94,R5JEI2,A0A0Q0ZC47,A0A2T0XH18,A0A1V4CHV0,A0A1K1RQP7,A0A2T1EKT1,A0A1N6LUI7,A0A0P0NGR6,A0A1X7IML5,A0A0A2LKJ7,K1L112,A0A0U3AL92,A0A1H3A054,E0UCX3,K9XZC6,A0A0C1VHB4,Q31N05,A0A0C5JKF3,R5NJJ8,A5D4D9,Q2JI93,A0A142Y7A9,A0A432MEQ5,A0A372DKU2,C1F5Q7,A0A4R3EV39,A0A1P8WP90,A0A222F7P0,A0A1C9VH88,A0A2T2YMB1,A0A329TD61,A0A101R2A0,A0A1U9ND56,A0A4R7BQC4,A0A1Q1FPH0,E0TGY3,A0A259TUP4,F6EYI8,A0A2S9Q9J0,A0A4Q2UIU6,A0A1H0LH25,A0A318LG42,H1YCU5,L0JS08,A0A1Q5ZS75,A0A345E7N0,M0AF24,A0A1W2A082,A0A1H3X247,M0D2X3,A0A2R5G167,A0A346PK63,R7RTW6,A0A1H2RBI2,A0A1C3ZXN2,B9LVP8,M5RSF0,W0JW77,B7K585,F8D8G0,A0A343TL88,L0AJX6,A0A2A5QS34,A0A343JEE2,A0A3P3RGE5,A0A329TBQ3,A0A285N2A8,A0A0W1S8B8,A0A1V4C8L7,L9VRQ2,E4NRV1,A0A1I6HGN0,A0A1I0NI68,,",366,37
"1195","C.H3.6","C.H3.8",360,181,179,1.93910305873638,"4F1N,4F3T,4KRE,5GUH,5VM9,6KR6,6OON,7KX7,7SWF,A0A163JTZ6,A0A0N4X8S8,A0A196SDB4,J9D5G4,Q389P5,C4LVV2,A0A2P6N8X7,A8BCK6,A2DPV7,A0A0G4H2S4,T1H8B3,S4RWI0,D2VMG4,A0A074TLL7,A0A0D1ZAJ4,Q1K660,F4PH46,A0A3M7S814,A0A164ZA52,Q54G64,S7WCF7,I0YVB2,R7QGN7,C1DZY0,A0A2C5Z0M1,A0CB11,R9ACY5,D3BMP8,A0A1Z5TVE5,W7XD45,A0A1U7LLR0,A0A4S2MWZ7,K1VVQ6,A0A158P1R9,G7DVX0,V6R0U9,G4N9J3,E3KLI3,B7Q5I1,A0A1E3QC61,D5GGK8,S8ANP9,A0A139AUH8,L2GMR6,U4LBG4,A0A177URI1,O74957,A0A3N4IGK1,A6N7Y9,A0A0E9NDK5,T1KZ60,A0A250WXN5,A0A2G8JLH3,Q5KAT1,L2GUF2,W2T741,A0A1W0E4B5,A0A2J7QB22,S4RYE2,A0A2K3CW87,A0A388KES6,A0A226EFL3,A0A3S3PD82,A0A0L0TEV1,A0A1S3J512,G0QTT2,A0A1J1HRI1,C4V9J2,Q9JMB7,A0A075AN09,Q5TW24,U5HIG6,A0A401PRI6,Q96J94,A0A2B4RHN2,G2QEV0,A0A397UU01,A0A2T7PFL8,K7ISV0,A0A024FT57,H3HCL6,A0A0G4IME3,E9FUN9,A0A1S3CYL5,D7FQK3,A0A1Y1YHC8,T1GSU4,F4S231,A0A1D8PMK0,A0A2G5B1D8,Q5BD61,A0A1C7M8P2,A0A4D8YSQ3,A0A158PJG6,J9JZ66,A0A0C2XG51,A0A158QZT6,A0A165QYQ9,T0SAU8,R7YY92,A0A3S1A0C3,A0A074YJ47,A0A2K1J482,A0A1Q3ENA6,O04379,A0A371I3C8,M8AEW7,A8P0D4,A0A2K3NY65,F4NYW7,A0A409Y6G2,A0A0L0HAB7,D8PZT7,A0A1D1W4K0,A7RQ46,W4YU94,A7BJS5,D8SNM6,A0A1J8PPA3,X1WG39,M5FQK2,Q69VD5,A0A2R6NSC2,A0A0D8XL16,A0A016WPN3,Q9QZ81,G5EES3,A0A0K0EFP6,Q8CJG0,A0A1D5NTU6,V2WTL2,A0A0V0YLH8,A0A139WDH0,A0A0R3W9Q7,H3DS31,A0A1Y1HWP2,G4T5G9,B7QCC4,A0A0B2UV00,M7BCJ9,E9GN30,Q7PZ41,A0A077Z361,R7U9I3,A0A1X7V1N5,A0A0K0JDP1,A0A0N4UKJ1,A0A498N3A3,A0A3M0IQP5,A0A0L8GBV4,Q32KD4,A0A1J1JBJ0,E0W4C3,A0A482XDA9,A0A3P7EJD6,J9K2Z4,A0A2J7Q8V4,T1IBM6,V3ZRX0,A0A210QKF7,A0A423TSS1,K1PT78,A0A267E8R7,A0A1D2N447,A0A226D7A9,F6YK55,T1KTE4,A0A2C9JGZ6,A0A1V9X9F0,K5X5Z7,A0A3Q0KUG5,T1FY40,1YVU,1Z26,3DLB,5AWH,5G5T,5I4A,6QZK,7R8K,E8N0K8,A0A1I7IXT4,A0A2W1JZ37,A0A2S7WBN3,A0A328VKE4,A0A420DFE6,E0ST67,A0A4V1VDY2,A0A368P5I0,C4L1M1,A0A4R1RMM2,A0A1Y2RDH8,Q11QW7,A0A1M5ZSR3,A0A0K8QX04,A0A0M2PXX3,A0A1I3LMA1,K9TPA9,A0A1L3JHM3,A0A1W6MIP2,A0A1C0UUC4,A0A2U2J9E0,A0A2Z6E1D5,A0A0F4NXW8,A0A142XB92,L8D0R3,B1XJG0,A0A326U7G5,A0A3D8L290,H1KXR6,A0A1Q4R485,K9U8J6,A0A097QRL6,K9RC91,A0A0D8ZUC0,A0A139XGN8,A0A1T4Y3A2,Q5P0R2,B6YTQ5,A0A0B0H9B4,A0YYT3,A0A2T1EFY0,G6FTN0,R6KUL9,A0A433NB65,A0A1Z4L0A1,K9UQR0,A0A2T1G8M7,K9VUN0,B7GJX9,A0A0P6X5X2,K9ZDE3,B0JXD6,A0A2T1LS63,A0A1Z4K1Y3,A0A2Z6E0R7,A0A1N6SSK9,A0A0P4UVI8,A0A0V7ZCG4,A0A1J0AGK2,K9PFF9,A0A2G9DT08,K9UEV4,Q9L1X1,A0A060HNJ0,A0A235B542,R5XQK4,A0A1H3LE92,A0A496APJ8,A0A062U2W9,H0HWQ5,A0A1V9G9U4,A0A1I2ZGP1,A0A317EJY3,A0A1I2BD20,F8ERC7,S7VLM7,A0A1A5X8H4,A0A1I2T6Q1,A0A1R3T9N6,A0A0Q2M2Z1,H8KXJ0,A0A2D1U4H7,I3TE64,A0A0B7I4Z6,A0LL61,Q8DKB1,A0A139WY18,A0A1J1EK56,A0A2T1E1K4,A0A1Q8ZD62,A0A4Q6XKV6,A0A1Z3HNN4,A0A239JE83,A0A2N4XBY2,Q53W94,R5JEI2,A0A0Q0ZC47,A0A2T0XH18,A0A1V4CHV0,A0A1K1RQP7,A0A2T1EKT1,A0A1N6LUI7,A0A0P0NGR6,A0A1X7IML5,A0A0A2LKJ7,K1L112,A0A0U3AL92,A0A1H3A054,E0UCX3,K9XZC6,A0A0C1VHB4,Q31N05,A0A0C5JKF3,R5NJJ8,A5D4D9,Q2JI93,A0A142Y7A9,A0A432MEQ5,A0A372DKU2,C1F5Q7,A0A4R3EV39,A0A1P8WP90,A0A222F7P0,A0A1C9VH88,A0A2T2YMB1,A0A329TD61,A0A101R2A0,A0A1E3XF49,A0A1U9ND56,A0A4R7BQC4,A0A1Q1FPH0,E0TGY3,A0A259TUP4,F6EYI8,A0A2S9Q9J0,A0A4Q2UIU6,A0A1H0LH25,A0A318LG42,H1YCU5,L0JS08,A0A1Q5ZS75,A0A345E7N0,M0AF24,A0A1W2A082,A0A1H3X247,A0A0C1XUA0,M0D2X3,A0A2R5G167,A0A346PK63,R7RTW6,A0A1H2RBI2,A0A1C3ZXN2,B9LVP8,M5RSF0,W0JW77,B7K585,F8D8G0,A0A343TL88,L0AJX6,A0A2A5QS34,A0A343JEE2,A0A3P3RGE5,A0A329TBQ3,A0A285N2A8,A0A0W1S8B8,A0A1V4C8L7,L9VRQ2,E4NRV1,A0A1I6HGN0,A0A1I0NI68,,",366,37
"1196","C.H3.7","C.S6.2",278,181,97,2.87500711966737,"4F1N,4F3T,4KRE,5GUH,5VM9,6KR6,6OON,7KX7,7SWF,A0A163JTZ6,A0A0N4X8S8,A0A196SDB4,J9D5G4,Q389P5,C4LVV2,A0A2P6N8X7,A8BCK6,A2DPV7,A0A0G4H2S4,T1H8B3,S4RWI0,D2VMG4,A0A074TLL7,A0A0D1ZAJ4,Q1K660,F4PH46,A0A3M7S814,A0A164ZA52,A0A383WDW5,Q54G64,S7WCF7,I0YVB2,R7QGN7,C1DZY0,A0A2C5Z0M1,A0CB11,R9ACY5,D3BMP8,A0A1Z5TVE5,W7XD45,A0A1U7LLR0,A0A4S2MWZ7,K1VVQ6,A0A158P1R9,G7DVX0,V6R0U9,G4N9J3,E3KLI3,B7Q5I1,A0A1E3QC61,D5GGK8,S8ANP9,A0A139AUH8,L2GMR6,U4LBG4,A0A177URI1,O74957,A0A3N4IGK1,A6N7Y9,A0A0E9NDK5,T1KZ60,A0A250WXN5,A0A2G8JLH3,Q5KAT1,L2GUF2,W2T741,A0A1W0E4B5,A0A2J7QB22,S4RYE2,A0A2K3CW87,A0A388KES6,A0A226EFL3,A0A0L0TEV1,A0A1S3J512,G0QTT2,A0A1J1HRI1,C4V9J2,Q9JMB7,A0A075AN09,Q5TW24,U5HIG6,A0A401PRI6,Q96J94,A0A2B4RHN2,G2QEV0,A0A397UU01,A0A2T7PFL8,K7ISV0,A0A024FT57,H3HCL6,A0A0G4IME3,E9FUN9,A0A1S3CYL5,D7FQK3,A0A1Y1YHC8,T1GSU4,F4S231,A0A1D8PMK0,A0A2G5B1D8,Q5BD61,A0A1C7M8P2,A0A4D8YSQ3,A0A158PJG6,J9JZ66,A0A0C2XG51,A0A158QZT6,A0A165QYQ9,T0SAU8,R7YY92,A0A3S1A0C3,A0A074YJ47,A0A2K1J482,A0A1Q3ENA6,O04379,A0A371I3C8,M8AEW7,A8P0D4,A0A2K3NY65,F4NYW7,A0A409Y6G2,A0A0L0HAB7,D8PZT7,A0A1D1W4K0,A7RQ46,W4YU94,A7BJS5,D8SNM6,A0A1J8PPA3,X1WG39,M5FQK2,Q69VD5,A0A2R6NSC2,A0A0D8XL16,A0A016WPN3,Q9QZ81,G5EES3,A0A0K0EFP6,Q8CJG0,A0A1D5NTU6,V2WTL2,A0A0V0YLH8,A0A139WDH0,A0A0R3W9Q7,H3DS31,A0A1Y1HWP2,G4T5G9,B7QCC4,A0A0B2UV00,M7BCJ9,E9GN30,Q7PZ41,A0A077Z361,R7U9I3,A0A1X7V1N5,A0A0K0JDP1,A0A0N4UKJ1,A0A498N3A3,A0A3M0IQP5,A0A0L8GBV4,Q32KD4,A0A1J1JBJ0,E0W4C3,A0A482XDA9,A0A3P7EJD6,J9K2Z4,A0A2J7Q8V4,T1IBM6,V3ZRX0,A0A210QKF7,A0A423TSS1,K1PT78,A0A267E8R7,A0A1D2N447,A0A226D7A9,F6YK55,T1KTE4,A0A2C9JGZ6,A0A1V9X9F0,K5X5Z7,A0A3Q0KUG5,T1FY40,1YVU,3DLB,5AWH,5G5T,5I4A,E8N0K8,A0A1I7IXT4,A0A2W1JZ37,A0A2S7WBN3,A0A420DFE6,E0ST67,A0A4V1VDY2,A0A368P5I0,C4L1M1,Q11QW7,A0A0K8QX04,A0A0M2PXX3,A0A1I3LMA1,A0A1C0UUC4,H1KXR6,A0A1Q4R485,K9U8J6,A0A097QRL6,K9RC91,A0A0D8ZUC0,A0A139XGN8,B6YTQ5,A0A0B0H9B4,A0A2T1EFY0,G6FTN0,R6KUL9,A0A433NB65,A0A1Z4L0A1,K9UQR0,A0A2T1G8M7,K9VUN0,B7GJX9,A0A0P6X5X2,K9ZDE3,B0JXD6,A0A2T1LS63,A0A1Z4K1Y3,A0A1N6SSK9,A0A0P4UVI8,A0A1J0AGK2,K9PFF9,A0A2G9DT08,K9UEV4,Q9L1X1,A0A060HNJ0,A0A235B542,R5XQK4,A0A1H3LE92,A0A1V9G9U4,A0A0Q2M2Z1,H8KXJ0,D3S0S6,I3TE64,A0A139WY18,A0A2T1E1K4,A0A1Q8ZD62,R5JEI2,A0A0Q0ZC47,A0A2T0XH18,A0A2T1EKT1,A0A1N6LUI7,E0UCX3,K9XZC6,R5NJJ8,A0A432MEQ5,A0A222F7P0,A0A101R2A0,A0A1Q1FPH0,A0A2S9Q9J0,A0A1H0LH25,A0A318LG42,L0JS08,A0A345E7N0,M0AF24,A0A1H3X247,M0D2X3,A0A346PK63,R7RTW6,W0JW77,F8D8G0,A0A343TL88,L0AJX6,A0A2A5QS34,A0A343JEE2,A0A3P3RGE5,A0A329TBQ3,A0A285N2A8,A0A0W1S8B8,A0A1V4C8L7,L9VRQ2,E4NRV1,A0A1I6HGN0,,",366,37
"1197","C.H5.10","C.H5.12",360,181,179,1.59889194110929,"4F1N,4F3T,4KRE,5GUH,5VM9,6KR6,6OON,7KX7,7SWF,A0A163JTZ6,A0A196SDB4,J9D5G4,Q389P5,C4LVV2,A0A2P6N8X7,A8BCK6,A2DPV7,A0A0G4H2S4,T1H8B3,R1FDF0,S4RWI0,D2VMG4,A0A074TLL7,A0A0D1ZAJ4,Q1K660,F4PH46,A0A3M7S814,A0A164ZA52,A0A383WDW5,Q54G64,S7WCF7,I0YVB2,R7QGN7,C1DZY0,A0A2C5Z0M1,A0CB11,R9ACY5,D3BMP8,A0A1Z5TVE5,W7XD45,A0A1U7LLR0,A0A4S2MWZ7,K1VVQ6,A0A158P1R9,G7DVX0,V6R0U9,G4N9J3,E3KLI3,B7Q5I1,A0A1E3QC61,D5GGK8,S8ANP9,A0A139AUH8,L2GMR6,U4LBG4,A0A177URI1,O74957,A0A3N4IGK1,A6N7Y9,A0A0E9NDK5,T1KZ60,A0A250WXN5,A0A2G8JLH3,Q5KAT1,L2GUF2,W2T741,A0A1W0E4B5,A0A2J7QB22,S4RYE2,A0A2K3CW87,A0A388KES6,A0A226EFL3,A0A3S3PD82,A0A0L0TEV1,A0A1S3J512,G0QTT2,A0A1J1HRI1,C4V9J2,Q9JMB7,A0A075AN09,Q5TW24,U5HIG6,A0A401PRI6,Q96J94,A0A2B4RHN2,G2QEV0,A0A397UU01,A0A2T7PFL8,K7ISV0,A0A024FT57,H3HCL6,A0A0G4IME3,E9FUN9,A0A1S3CYL5,D7FQK3,A0A1Y1YHC8,T1GSU4,F4S231,A0A1D8PMK0,A0A2G5B1D8,Q5BD61,A0A1C7M8P2,A0A4D8YSQ3,A0A158PJG6,J9JZ66,A0A0C2XG51,A0A158QZT6,T0SAU8,R7YY92,A0A3S1A0C3,A0A074YJ47,A0A2K1J482,A0A1Q3ENA6,O04379,A0A371I3C8,M8AEW7,A8P0D4,A0A2K3NY65,F4NYW7,A0A409Y6G2,A0A0L0HAB7,D8PZT7,A0A1D1W4K0,A7RQ46,W4YU94,A7BJS5,D8SNM6,A0A1J8PPA3,X1WG39,M5FQK2,Q69VD5,A0A2R6NSC2,A0A0D8XL16,A0A016WPN3,Q9QZ81,G5EES3,A0A0K0EFP6,Q8CJG0,A0A1D5NTU6,V2WTL2,A0A0V0YLH8,A0A139WDH0,A0A0R3W9Q7,H3DS31,A0A1Y1HWP2,G4T5G9,B7QCC4,A0A0B2UV00,M7BCJ9,E9GN30,Q7PZ41,A0A077Z361,R7U9I3,A0A1X7V1N5,A0A0K0JDP1,A0A0N4UKJ1,A0A498N3A3,A0A3M0IQP5,A0A0L8GBV4,Q32KD4,A0A1J1JBJ0,E0W4C3,A0A482XDA9,A0A3P7EJD6,J9K2Z4,A0A2J7Q8V4,T1IBM6,V3ZRX0,A0A210QKF7,A0A423TSS1,K1PT78,A0A267E8R7,A0A1D2N447,A0A226D7A9,F6YK55,T1KTE4,A0A2C9JGZ6,A0A1V9X9F0,K5X5Z7,A0A3Q0KUG5,T1FY40,1YVU,1Z26,3DLB,5AWH,5G5T,5I4A,6QZK,7R8K,E8N0K8,A0A1I7IXT4,A0A2W1JZ37,A0A2S7WBN3,A0A328VKE4,A0A420DFE6,E0ST67,A0A4V1VDY2,A0A368P5I0,C4L1M1,A0A4R1RMM2,A0A1Y2RDH8,Q11QW7,A0A1M5ZSR3,A0A0K8QX04,A0A0M2PXX3,A0A1I3LMA1,K9TPA9,A0A1L3JHM3,A0A1W6MIP2,A0A1C0UUC4,A0A2U2J9E0,A0A2Z6E1D5,A0A0F4NXW8,B1XJG0,A0A326U7G5,A0A3D8L290,H1KXR6,A0A1Q4R485,K9U8J6,A0A097QRL6,K9RC91,A0A0D8ZUC0,A0A139XGN8,A0A1T4Y3A2,Q5P0R2,B6YTQ5,A0A0B0H9B4,A0YYT3,A0A2T1EFY0,G6FTN0,R6KUL9,A0A433NB65,A0A1Z4L0A1,K9UQR0,A0A2T1G8M7,K9VUN0,B7GJX9,K9ZDE3,B0JXD6,A0A2T1LS63,A0A1Z4K1Y3,A0A2Z6E0R7,A0A1N6SSK9,A0A0P4UVI8,A0A0V7ZCG4,A0A1J0AGK2,K9PFF9,A0A2G9DT08,K9UEV4,Q9L1X1,A0A060HNJ0,A0A235B542,R5XQK4,A0A1H3LE92,A0A496APJ8,A0A062U2W9,H0HWQ5,A0A1V9G9U4,A0A1I2ZGP1,A0A317EJY3,A0A1I2BD20,F8ERC7,S7VLM7,A0A1A5X8H4,A0A1I2T6Q1,A0A1R3T9N6,A0A0Q2M2Z1,H8KXJ0,D3S0S6,A0A2D1U4H7,I3TE64,A0A0B7I4Z6,A0LL61,Q8DKB1,A0A139WY18,A0A1J1EK56,A0A2T1E1K4,A0A1Q8ZD62,A0A4Q6XKV6,A0A1Z3HNN4,A0A239JE83,A0A2N4XBY2,Q53W94,R5JEI2,A0A0Q0ZC47,A0A2T0XH18,A0A1V4CHV0,A0A1K1RQP7,A0A2T1EKT1,A0A1N6LUI7,A0A0P0NGR6,A0A1X7IML5,A0A0A2LKJ7,K1L112,A0A0U3AL92,A0A1H3A054,E0UCX3,K9XZC6,A0A0C1VHB4,Q31N05,A0A0C5JKF3,R5NJJ8,A5D4D9,Q2JI93,A0A142Y7A9,A0A432MEQ5,A0A372DKU2,A0A3R7KLK4,C1F5Q7,A0A4R3EV39,A0A1P8WP90,A0A222F7P0,A0A1C9VH88,A0A2T2YMB1,A0A329TD61,A0A101R2A0,A0A1E3XF49,A0A1U9ND56,A0A4R7BQC4,A0A1H3DGN3,A0A1Q1FPH0,E0TGY3,A0A259TUP4,F6EYI8,A0A2S9Q9J0,A0A4Q2UIU6,A0A1H0LH25,A0A318LG42,H1YCU5,L0JS08,A0A1Q5ZS75,A0A345E7N0,M0AF24,A0A1W2A082,A0A1H3X247,A0A0C1XUA0,M0D2X3,A0A2R5G167,A0A346PK63,R7RTW6,A0A1H2RBI2,A0A1C3ZXN2,B9LVP8,M5RSF0,W0JW77,B7K585,F8D8G0,A0A343TL88,L0AJX6,A0A2A5QS34,A0A343JEE2,A0A3P3RGE5,A0A329TBQ3,A0A285N2A8,A0A0W1S8B8,A0A1V4C8L7,L9VRQ2,E4NRV1,A0A1I6HGN0,A0A1I0NI68,,",366,37
"1202","C.H5.12","C.H5.15",348,181,167,2.77389420054918,"4F1N,4F3T,4KRE,5GUH,5VM9,6KR6,6OON,7KX7,7SWF,A0A163JTZ6,A0A196SDB4,J9D5G4,Q389P5,C4LVV2,A0A2P6N8X7,A8BCK6,A2DPV7,A0A0G4H2S4,T1H8B3,R1FDF0,S4RWI0,D2VMG4,A0A074TLL7,A0A0D1ZAJ4,Q1K660,F4PH46,A0A3M7S814,A0A164ZA52,A0A383WDW5,Q54G64,S7WCF7,I0YVB2,R7QGN7,C1DZY0,A0A2C5Z0M1,A0CB11,R9ACY5,D3BMP8,A0A1Z5TVE5,W7XD45,A0A1U7LLR0,A0A4S2MWZ7,K1VVQ6,A0A158P1R9,G7DVX0,V6R0U9,G4N9J3,E3KLI3,B7Q5I1,A0A1E3QC61,D5GGK8,S8ANP9,A0A139AUH8,L2GMR6,U4LBG4,A0A177URI1,O74957,A0A3N4IGK1,A6N7Y9,A0A0E9NDK5,T1KZ60,A0A250WXN5,A0A2G8JLH3,Q5KAT1,L2GUF2,W2T741,A0A1W0E4B5,A0A2J7QB22,S4RYE2,A0A2K3CW87,A0A388KES6,A0A226EFL3,A0A3S3PD82,A0A0L0TEV1,A0A1S3J512,G0QTT2,A0A1J1HRI1,C4V9J2,Q9JMB7,A0A075AN09,Q5TW24,U5HIG6,A0A401PRI6,Q96J94,A0A2B4RHN2,G2QEV0,A0A397UU01,A0A2T7PFL8,K7ISV0,A0A024FT57,H3HCL6,A0A0G4IME3,E9FUN9,A0A1S3CYL5,D7FQK3,A0A1Y1YHC8,T1GSU4,F4S231,A0A1D8PMK0,A0A2G5B1D8,Q5BD61,A0A1C7M8P2,A0A4D8YSQ3,A0A158PJG6,J9JZ66,A0A0C2XG51,A0A158QZT6,T0SAU8,R7YY92,A0A3S1A0C3,A0A074YJ47,A0A2K1J482,A0A1Q3ENA6,O04379,A0A371I3C8,M8AEW7,A8P0D4,A0A2K3NY65,F4NYW7,A0A409Y6G2,A0A0L0HAB7,D8PZT7,A0A1D1W4K0,A7RQ46,W4YU94,A7BJS5,D8SNM6,A0A1J8PPA3,X1WG39,M5FQK2,Q69VD5,A0A2R6NSC2,A0A0D8XL16,A0A016WPN3,Q9QZ81,G5EES3,A0A0K0EFP6,Q8CJG0,A0A1D5NTU6,V2WTL2,A0A0V0YLH8,A0A139WDH0,A0A0R3W9Q7,H3DS31,A0A1Y1HWP2,G4T5G9,B7QCC4,A0A0B2UV00,M7BCJ9,E9GN30,Q7PZ41,A0A077Z361,R7U9I3,A0A1X7V1N5,A0A0K0JDP1,A0A0N4UKJ1,A0A498N3A3,A0A3M0IQP5,A0A0L8GBV4,Q32KD4,A0A1J1JBJ0,E0W4C3,A0A482XDA9,A0A3P7EJD6,J9K2Z4,A0A2J7Q8V4,T1IBM6,V3ZRX0,A0A210QKF7,A0A423TSS1,K1PT78,A0A267E8R7,A0A1D2N447,A0A226D7A9,F6YK55,T1KTE4,A0A2C9JGZ6,A0A1V9X9F0,K5X5Z7,A0A3Q0KUG5,T1FY40,1Z26,3DLB,5AWH,5G5T,5I4A,6QZK,E8N0K8,A0A1I7IXT4,A0A2W1JZ37,A0A2S7WBN3,A0A328VKE4,A0A420DFE6,A0A4V1VDY2,A0A368P5I0,C4L1M1,A0A4R1RMM2,A0A1Y2RDH8,Q11QW7,A0A1M5ZSR3,A0A0K8QX04,A0A0M2PXX3,A0A1I3LMA1,K9TPA9,A0A1L3JHM3,A0A1W6MIP2,A0A1C0UUC4,A0A2U2J9E0,A0A2Z6E1D5,A0A0F4NXW8,B1XJG0,A0A326U7G5,A0A3D8L290,A0A1Q4R485,K9U8J6,A0A097QRL6,K9RC91,A0A0D8ZUC0,A0A139XGN8,A0A1T4Y3A2,Q5P0R2,B6YTQ5,A0A0B0H9B4,A0YYT3,A0A2T1EFY0,G6FTN0,R6KUL9,A0A433NB65,A0A1Z4L0A1,K9UQR0,A0A2T1G8M7,K9VUN0,B7GJX9,K9ZDE3,B0JXD6,A0A2T1LS63,A0A1Z4K1Y3,A0A2Z6E0R7,A0A1N6SSK9,A0A0P4UVI8,A0A0V7ZCG4,A0A1J0AGK2,K9PFF9,A0A2G9DT08,K9UEV4,Q9L1X1,A0A060HNJ0,A0A235B542,R5XQK4,A0A1H3LE92,A0A496APJ8,A0A1V9G9U4,S7VLM7,A0A1A5X8H4,A0A1I2T6Q1,A0A1R3T9N6,A0A0Q2M2Z1,H8KXJ0,D3S0S6,A0A2D1U4H7,I3TE64,A0A0B7I4Z6,A0LL61,Q8DKB1,A0A139WY18,A0A1J1EK56,A0A2T1E1K4,A0A1Q8ZD62,A0A4Q6XKV6,A0A1Z3HNN4,A0A239JE83,A0A2N4XBY2,Q53W94,R5JEI2,A0A0Q0ZC47,A0A2T0XH18,A0A1V4CHV0,A0A1K1RQP7,A0A2T1EKT1,A0A1N6LUI7,A0A0P0NGR6,A0A1X7IML5,A0A0A2LKJ7,K1L112,A0A0U3AL92,A0A1H3A054,E0UCX3,K9XZC6,A0A0C1VHB4,Q31N05,A0A0C5JKF3,R5NJJ8,A5D4D9,Q2JI93,A0A142Y7A9,A0A432MEQ5,A0A372DKU2,C1F5Q7,A0A4R3EV39,A0A1P8WP90,A0A222F7P0,A0A1C9VH88,A0A2T2YMB1,A0A329TD61,A0A101R2A0,A0A1E3XF49,A0A1U9ND56,A0A4R7BQC4,A0A1Q1FPH0,E0TGY3,A0A259TUP4,F6EYI8,A0A2S9Q9J0,A0A4Q2UIU6,A0A1H0LH25,A0A318LG42,H1YCU5,L0JS08,A0A1Q5ZS75,A0A345E7N0,M0AF24,A0A1W2A082,A0A1H3X247,A0A0C1XUA0,M0D2X3,A0A2R5G167,A0A346PK63,R7RTW6,A0A1H2RBI2,A0A1C3ZXN2,B9LVP8,M5RSF0,W0JW77,B7K585,F8D8G0,A0A343TL88,L0AJX6,A0A2A5QS34,A0A343JEE2,A0A3P3RGE5,A0A329TBQ3,A0A285N2A8,A0A0W1S8B8,A0A1V4C8L7,L9VRQ2,E4NRV1,A0A1I6HGN0,A0A1I0NI68,,",366,37
"1203","C.H5.12","C.H5.9",353,181,172,2.50754850314789,"4F1N,4F3T,4KRE,5GUH,5VM9,6KR6,6OON,7KX7,7SWF,A0A163JTZ6,A0A196SDB4,J9D5G4,Q389P5,C4LVV2,A0A2P6N8X7,A8BCK6,A2DPV7,A0A0G4H2S4,T1H8B3,R1FDF0,S4RWI0,D2VMG4,A0A074TLL7,A0A0D1ZAJ4,Q1K660,F4PH46,A0A3M7S814,A0A164ZA52,A0A383WDW5,Q54G64,S7WCF7,I0YVB2,R7QGN7,C1DZY0,A0A2C5Z0M1,A0CB11,R9ACY5,D3BMP8,A0A1Z5TVE5,W7XD45,A0A1U7LLR0,A0A4S2MWZ7,K1VVQ6,A0A158P1R9,G7DVX0,V6R0U9,G4N9J3,E3KLI3,B7Q5I1,A0A1E3QC61,D5GGK8,S8ANP9,A0A139AUH8,L2GMR6,U4LBG4,A0A177URI1,O74957,A0A3N4IGK1,A6N7Y9,A0A0E9NDK5,T1KZ60,A0A250WXN5,A0A2G8JLH3,Q5KAT1,L2GUF2,W2T741,A0A1W0E4B5,A0A2J7QB22,S4RYE2,A0A2K3CW87,A0A388KES6,A0A226EFL3,A0A3S3PD82,A0A0L0TEV1,A0A1S3J512,G0QTT2,A0A1J1HRI1,C4V9J2,Q9JMB7,A0A075AN09,Q5TW24,U5HIG6,A0A401PRI6,Q96J94,A0A2B4RHN2,G2QEV0,A0A397UU01,A0A2T7PFL8,K7ISV0,A0A024FT57,H3HCL6,A0A0G4IME3,E9FUN9,A0A1S3CYL5,D7FQK3,A0A1Y1YHC8,T1GSU4,F4S231,A0A1D8PMK0,A0A2G5B1D8,Q5BD61,A0A1C7M8P2,A0A4D8YSQ3,A0A158PJG6,J9JZ66,A0A0C2XG51,A0A158QZT6,T0SAU8,R7YY92,A0A3S1A0C3,A0A074YJ47,A0A2K1J482,A0A1Q3ENA6,O04379,A0A371I3C8,M8AEW7,A8P0D4,A0A2K3NY65,F4NYW7,A0A409Y6G2,A0A0L0HAB7,D8PZT7,A0A1D1W4K0,A7RQ46,W4YU94,A7BJS5,D8SNM6,A0A1J8PPA3,X1WG39,M5FQK2,Q69VD5,A0A2R6NSC2,A0A0D8XL16,A0A016WPN3,Q9QZ81,G5EES3,A0A0K0EFP6,Q8CJG0,A0A1D5NTU6,V2WTL2,A0A0V0YLH8,A0A139WDH0,A0A0R3W9Q7,H3DS31,A0A1Y1HWP2,G4T5G9,B7QCC4,A0A0B2UV00,M7BCJ9,E9GN30,Q7PZ41,A0A077Z361,R7U9I3,A0A1X7V1N5,A0A0K0JDP1,A0A0N4UKJ1,A0A498N3A3,A0A3M0IQP5,A0A0L8GBV4,Q32KD4,A0A1J1JBJ0,E0W4C3,A0A482XDA9,A0A3P7EJD6,J9K2Z4,A0A2J7Q8V4,T1IBM6,V3ZRX0,A0A210QKF7,A0A423TSS1,K1PT78,A0A267E8R7,A0A1D2N447,A0A226D7A9,F6YK55,T1KTE4,A0A2C9JGZ6,A0A1V9X9F0,K5X5Z7,A0A3Q0KUG5,T1FY40,1YVU,1Z26,3DLB,5AWH,5I4A,6QZK,E8N0K8,A0A1I7IXT4,A0A2W1JZ37,A0A2S7WBN3,A0A328VKE4,A0A420DFE6,E0ST67,A0A4V1VDY2,A0A368P5I0,C4L1M1,A0A4R1RMM2,A0A1Y2RDH8,Q11QW7,A0A1M5ZSR3,A0A0K8QX04,A0A0M2PXX3,A0A1I3LMA1,K9TPA9,A0A1L3JHM3,A0A1W6MIP2,A0A1C0UUC4,A0A2U2J9E0,A0A2Z6E1D5,A0A0F4NXW8,B1XJG0,A0A326U7G5,A0A3D8L290,H1KXR6,A0A1Q4R485,K9U8J6,A0A097QRL6,K9RC91,A0A0D8ZUC0,A0A139XGN8,A0A1T4Y3A2,Q5P0R2,B6YTQ5,A0A0B0H9B4,A0YYT3,A0A2T1EFY0,G6FTN0,R6KUL9,A0A433NB65,A0A1Z4L0A1,K9UQR0,A0A2T1G8M7,K9VUN0,B7GJX9,A0A0P6X5X2,K9ZDE3,B0JXD6,A0A2T1LS63,A0A1Z4K1Y3,A0A2Z6E0R7,A0A1N6SSK9,A0A0P4UVI8,A0A0V7ZCG4,A0A1J0AGK2,K9PFF9,A0A2G9DT08,K9UEV4,Q9L1X1,A0A060HNJ0,A0A235B542,R5XQK4,A0A1H3LE92,A0A496APJ8,A0A1V9G9U4,S7VLM7,A0A1A5X8H4,A0A1I2T6Q1,A0A1R3T9N6,A0A0Q2M2Z1,H8KXJ0,D3S0S6,A0A2D1U4H7,I3TE64,A0A0B7I4Z6,A0LL61,Q8DKB1,A0A139WY18,A0A1J1EK56,A0A2T1E1K4,A0A1Q8ZD62,A0A4Q6XKV6,A0A1Z3HNN4,A0A239JE83,A0A2N4XBY2,Q53W94,R5JEI2,A0A0Q0ZC47,A0A2T0XH18,A0A1V4CHV0,A0A1K1RQP7,A0A2T1EKT1,A0A1N6LUI7,A0A0P0NGR6,A0A1X7IML5,A0A0A2LKJ7,K1L112,A0A0U3AL92,A0A1H3A054,E0UCX3,K9XZC6,A0A0C1VHB4,Q31N05,A0A0C5JKF3,R5NJJ8,A5D4D9,Q2JI93,A0A142Y7A9,A0A432MEQ5,A0A372DKU2,A0A3R7KLK4,C1F5Q7,A0A4R3EV39,A0A1P8WP90,A0A222F7P0,A0A1C9VH88,A0A2T2YMB1,A0A329TD61,A0A101R2A0,A0A1E3XF49,A0A1U9ND56,A0A4R7BQC4,A0A1H3DGN3,A0A1Q1FPH0,E0TGY3,A0A259TUP4,F6EYI8,A0A2S9Q9J0,A0A4Q2UIU6,A0A1H0LH25,A0A318LG42,H1YCU5,L0JS08,A0A1Q5ZS75,A0A345E7N0,M0AF24,A0A1W2A082,A0A1H3X247,A0A0C1XUA0,M0D2X3,A0A2R5G167,A0A346PK63,R7RTW6,A0A1H2RBI2,A0A1C3ZXN2,B9LVP8,M5RSF0,W0JW77,B7K585,F8D8G0,A0A343TL88,L0AJX6,A0A2A5QS34,A0A343JEE2,A0A3P3RGE5,A0A329TBQ3,A0A285N2A8,A0A0W1S8B8,A0A1V4C8L7,L9VRQ2,E4NRV1,A0A1I6HGN0,A0A1I0NI68,,",366,37
"1204","C.H5.13","C.H5.16",352,181,171,3.35494814384026,"4F1N,4F3T,4KRE,5GUH,6KR6,6OON,7KX7,7SWF,A0A163JTZ6,A0A196SDB4,J9D5G4,Q389P5,C4LVV2,A0A2P6N8X7,A8BCK6,A2DPV7,A0A0G4H2S4,T1H8B3,R1FDF0,S4RWI0,D2VMG4,A0A074TLL7,A0A0D1ZAJ4,Q1K660,F4PH46,A0A3M7S814,A0A164ZA52,A0A383WDW5,Q54G64,S7WCF7,I0YVB2,R7QGN7,C1DZY0,A0A2C5Z0M1,A0CB11,R9ACY5,D3BMP8,A0A1Z5TVE5,W7XD45,A0A1U7LLR0,A0A4S2MWZ7,K1VVQ6,A0A158P1R9,G7DVX0,V6R0U9,G4N9J3,E3KLI3,B7Q5I1,A0A1E3QC61,D5GGK8,S8ANP9,A0A139AUH8,L2GMR6,U4LBG4,A0A177URI1,O74957,A0A3N4IGK1,A6N7Y9,A0A0E9NDK5,T1KZ60,A0A250WXN5,A0A2G8JLH3,Q5KAT1,L2GUF2,W2T741,A0A1W0E4B5,A0A2J7QB22,S4RYE2,A0A2K3CW87,A0A388KES6,A0A226EFL3,A0A3S3PD82,A0A0L0TEV1,A0A1S3J512,G0QTT2,A0A1J1HRI1,C4V9J2,Q9JMB7,A0A075AN09,Q5TW24,U5HIG6,A0A401PRI6,Q96J94,A0A2B4RHN2,G2QEV0,A0A397UU01,A0A2T7PFL8,K7ISV0,A0A024FT57,H3HCL6,A0A0G4IME3,E9FUN9,A0A1S3CYL5,D7FQK3,A0A1Y1YHC8,T1GSU4,F4S231,A0A1D8PMK0,A0A2G5B1D8,Q5BD61,A0A1C7M8P2,A0A4D8YSQ3,A0A158PJG6,J9JZ66,A0A0C2XG51,A0A158QZT6,A0A165QYQ9,T0SAU8,R7YY92,A0A3S1A0C3,A0A074YJ47,A0A2K1J482,A0A1Q3ENA6,O04379,A0A371I3C8,M8AEW7,A8P0D4,A0A2K3NY65,F4NYW7,A0A409Y6G2,A0A0L0HAB7,D8PZT7,A0A1D1W4K0,A7RQ46,W4YU94,A7BJS5,D8SNM6,A0A1J8PPA3,X1WG39,M5FQK2,Q69VD5,A0A2R6NSC2,A0A0D8XL16,A0A016WPN3,Q9QZ81,G5EES3,A0A0K0EFP6,Q8CJG0,A0A1D5NTU6,V2WTL2,A0A0V0YLH8,A0A139WDH0,A0A0R3W9Q7,H3DS31,A0A1Y1HWP2,G4T5G9,B7QCC4,A0A0B2UV00,M7BCJ9,E9GN30,Q7PZ41,A0A077Z361,R7U9I3,A0A1X7V1N5,A0A0K0JDP1,A0A0N4UKJ1,A0A498N3A3,A0A3M0IQP5,A0A0L8GBV4,Q32KD4,A0A1J1JBJ0,E0W4C3,A0A482XDA9,A0A3P7EJD6,J9K2Z4,A0A2J7Q8V4,T1IBM6,V3ZRX0,A0A210QKF7,A0A423TSS1,K1PT78,A0A267E8R7,A0A1D2N447,A0A226D7A9,F6YK55,T1KTE4,A0A2C9JGZ6,A0A1V9X9F0,K5X5Z7,A0A3Q0KUG5,T1FY40,1YVU,1Z26,3DLB,5AWH,5G5T,5I4A,6QZK,E8N0K8,A0A1I7IXT4,A0A2W1JZ37,A0A2S7WBN3,A0A328VKE4,A0A420DFE6,A0A4V1VDY2,A0A368P5I0,C4L1M1,A0A4R1RMM2,A0A1Y2RDH8,Q11QW7,A0A1M5ZSR3,A0A0K8QX04,A0A0M2PXX3,A0A1I3LMA1,K9TPA9,A0A1L3JHM3,A0A1W6MIP2,A0A1C0UUC4,A0A2U2J9E0,A0A2Z6E1D5,A0A0F4NXW8,A0A142XB92,B1XJG0,A0A326U7G5,A0A3D8L290,H1KXR6,A0A1Q4R485,K9U8J6,A0A097QRL6,K9RC91,A0A0D8ZUC0,A0A139XGN8,A0A1T4Y3A2,Q5P0R2,B6YTQ5,A0A0B0H9B4,A0YYT3,A0A2T1EFY0,G6FTN0,R6KUL9,A0A433NB65,A0A1Z4L0A1,K9UQR0,A0A2T1G8M7,K9VUN0,B7GJX9,A0A0P6X5X2,K9ZDE3,B0JXD6,A0A2T1LS63,A0A1Z4K1Y3,A0A2Z6E0R7,A0A1N6SSK9,A0A0P4UVI8,A0A0V7ZCG4,A0A1J0AGK2,K9PFF9,A0A2G9DT08,K9UEV4,Q9L1X1,A0A060HNJ0,A0A235B542,R5XQK4,A0A1H3LE92,A0A496APJ8,A0A1V9G9U4,S7VLM7,A0A1A5X8H4,A0A1I2T6Q1,A0A1R3T9N6,A0A0Q2M2Z1,H8KXJ0,D3S0S6,A0A2D1U4H7,I3TE64,A0A0B7I4Z6,A0LL61,Q8DKB1,A0A139WY18,A0A1J1EK56,A0A2T1E1K4,A0A1Q8ZD62,A0A4Q6XKV6,A0A1Z3HNN4,A0A239JE83,A0A2N4XBY2,Q53W94,R5JEI2,A0A0Q0ZC47,A0A2T0XH18,A0A1V4CHV0,A0A1K1RQP7,A0A2T1EKT1,A0A1N6LUI7,A0A0P0NGR6,A0A1X7IML5,A0A0A2LKJ7,K1L112,A0A0U3AL92,A0A1H3A054,E0UCX3,K9XZC6,A0A0C1VHB4,Q31N05,A0A0C5JKF3,R5NJJ8,A5D4D9,Q2JI93,A0A142Y7A9,A0A432MEQ5,A0A372DKU2,C1F5Q7,A0A4R3EV39,A0A1P8WP90,A0A222F7P0,A0A1C9VH88,A0A2T2YMB1,A0A329TD61,A0A101R2A0,A0A1E3XF49,A0A1U9ND56,A0A4R7BQC4,A0A1Q1FPH0,E0TGY3,A0A259TUP4,F6EYI8,A0A2S9Q9J0,A0A4Q2UIU6,A0A1H0LH25,A0A318LG42,H1YCU5,L0JS08,A0A1Q5ZS75,A0A345E7N0,M0AF24,A0A1W2A082,A0A1H3X247,A0A0C1XUA0,M0D2X3,A0A2R5G167,A0A346PK63,R7RTW6,A0A1H2RBI2,A0A1C3ZXN2,B9LVP8,M5RSF0,W0JW77,B7K585,F8D8G0,A0A343TL88,L0AJX6,A0A2A5QS34,A0A343JEE2,A0A3P3RGE5,A0A329TBQ3,A0A285N2A8,A0A0W1S8B8,A0A1V4C8L7,L9VRQ2,E4NRV1,A0A1I6HGN0,A0A1I0NI68,,",366,37
"1206","C.H5.5","C.H5.7",359,181,178,1.97762120553728,"4F1N,4F3T,4KRE,5GUH,5VM9,6KR6,6OON,7KX7,7SWF,A0A163JTZ6,A0A0N4X8S8,A0A196SDB4,J9D5G4,Q389P5,C4LVV2,A0A2P6N8X7,A8BCK6,A2DPV7,A0A0G4H2S4,T1H8B3,S4RWI0,D2VMG4,A0A074TLL7,A0A0D1ZAJ4,Q1K660,F4PH46,A0A3M7S814,A0A164ZA52,A0A383WDW5,Q54G64,S7WCF7,I0YVB2,R7QGN7,C1DZY0,A0A2C5Z0M1,A0CB11,R9ACY5,D3BMP8,A0A1Z5TVE5,W7XD45,A0A1U7LLR0,A0A4S2MWZ7,K1VVQ6,A0A158P1R9,G7DVX0,V6R0U9,G4N9J3,E3KLI3,B7Q5I1,A0A1E3QC61,D5GGK8,S8ANP9,A0A139AUH8,L2GMR6,U4LBG4,A0A177URI1,O74957,A0A3N4IGK1,A6N7Y9,A0A0E9NDK5,T1KZ60,A0A250WXN5,A0A2G8JLH3,Q5KAT1,L2GUF2,W2T741,A0A1W0E4B5,A0A2J7QB22,S4RYE2,A0A2K3CW87,A0A388KES6,A0A226EFL3,A0A3S3PD82,A0A0L0TEV1,A0A1S3J512,G0QTT2,A0A1J1HRI1,C4V9J2,Q9JMB7,A0A075AN09,Q5TW24,U5HIG6,A0A401PRI6,Q96J94,A0A2B4RHN2,G2QEV0,A0A397UU01,A0A2T7PFL8,K7ISV0,A0A024FT57,H3HCL6,A0A0G4IME3,E9FUN9,A0A1S3CYL5,D7FQK3,A0A1Y1YHC8,T1GSU4,F4S231,A0A1D8PMK0,A0A2G5B1D8,Q5BD61,A0A1C7M8P2,A0A4D8YSQ3,A0A158PJG6,J9JZ66,A0A0C2XG51,A0A158QZT6,T0SAU8,R7YY92,A0A3S1A0C3,A0A074YJ47,A0A2K1J482,A0A1Q3ENA6,O04379,A0A371I3C8,M8AEW7,A8P0D4,A0A2K3NY65,F4NYW7,A0A409Y6G2,A0A0L0HAB7,D8PZT7,A0A1D1W4K0,A7RQ46,W4YU94,A7BJS5,D8SNM6,A0A1J8PPA3,X1WG39,M5FQK2,Q69VD5,A0A2R6NSC2,A0A0D8XL16,A0A016WPN3,Q9QZ81,G5EES3,A0A0K0EFP6,Q8CJG0,A0A1D5NTU6,V2WTL2,A0A0V0YLH8,A0A139WDH0,A0A0R3W9Q7,H3DS31,A0A1Y1HWP2,G4T5G9,B7QCC4,A0A0B2UV00,M7BCJ9,E9GN30,Q7PZ41,A0A077Z361,R7U9I3,A0A1X7V1N5,A0A0K0JDP1,A0A0N4UKJ1,A0A498N3A3,A0A3M0IQP5,A0A0L8GBV4,Q32KD4,A0A1J1JBJ0,E0W4C3,A0A482XDA9,A0A3P7EJD6,J9K2Z4,A0A2J7Q8V4,T1IBM6,V3ZRX0,A0A210QKF7,A0A423TSS1,K1PT78,A0A267E8R7,A0A1D2N447,A0A226D7A9,F6YK55,T1KTE4,A0A2C9JGZ6,A0A1V9X9F0,K5X5Z7,A0A3Q0KUG5,T1FY40,1YVU,1Z26,3DLB,5AWH,5G5T,5I4A,6QZK,7R8K,E8N0K8,A0A1I7IXT4,A0A2W1JZ37,A0A2S7WBN3,A0A328VKE4,A0A420DFE6,E0ST67,A0A4V1VDY2,A0A368P5I0,C4L1M1,A0A4R1RMM2,A0A1Y2RDH8,Q11QW7,A0A1M5ZSR3,A0A0K8QX04,A0A0M2PXX3,A0A1I3LMA1,K9TPA9,A0A1L3JHM3,A0A1W6MIP2,A0A1C0UUC4,A0A2U2J9E0,A0A2Z6E1D5,A0A0F4NXW8,A0A142XB92,L8D0R3,B1XJG0,A0A326U7G5,A0A3D8L290,H1KXR6,A0A1Q4R485,K9U8J6,A0A097QRL6,K9RC91,A0A0D8ZUC0,A0A139XGN8,A0A1T4Y3A2,Q5P0R2,B6YTQ5,A0A0B0H9B4,A0YYT3,A0A2T1EFY0,G6FTN0,R6KUL9,A0A433NB65,A0A1Z4L0A1,K9UQR0,A0A2T1G8M7,K9VUN0,B7GJX9,K9ZDE3,B0JXD6,A0A2T1LS63,A0A1Z4K1Y3,A0A2Z6E0R7,A0A1N6SSK9,A0A0P4UVI8,A0A0V7ZCG4,A0A1J0AGK2,K9PFF9,A0A2G9DT08,K9UEV4,Q9L1X1,A0A060HNJ0,A0A235B542,R5XQK4,A0A496APJ8,A0A062U2W9,H0HWQ5,A0A1V9G9U4,A0A1I2ZGP1,A0A317EJY3,A0A1I2BD20,F8ERC7,S7VLM7,A0A1A5X8H4,A0A1I2T6Q1,A0A1R3T9N6,A0A0Q2M2Z1,H8KXJ0,D3S0S6,A0A2D1U4H7,A0A0B7I4Z6,A0LL61,Q8DKB1,A0A139WY18,A0A1J1EK56,A0A2T1E1K4,A0A1Q8ZD62,A0A4Q6XKV6,A0A1Z3HNN4,A0A239JE83,A0A2N4XBY2,Q53W94,R5JEI2,A0A0Q0ZC47,A0A2T0XH18,A0A1V4CHV0,A0A1K1RQP7,A0A2T1EKT1,A0A1N6LUI7,A0A0P0NGR6,A0A1X7IML5,A0A0A2LKJ7,K1L112,A0A0U3AL92,A0A1H3A054,E0UCX3,K9XZC6,A0A0C1VHB4,Q31N05,A0A0C5JKF3,R5NJJ8,A5D4D9,Q2JI93,A0A142Y7A9,A0A432MEQ5,A0A372DKU2,A0A3R7KLK4,C1F5Q7,A0A4R3EV39,A0A1P8WP90,A0A222F7P0,A0A1C9VH88,A0A2T2YMB1,A0A329TD61,A0A101R2A0,A0A1E3XF49,A0A1U9ND56,A0A4R7BQC4,A0A1H3DGN3,A0A1Q1FPH0,E0TGY3,A0A259TUP4,F6EYI8,A0A2S9Q9J0,A0A4Q2UIU6,A0A1H0LH25,A0A318LG42,H1YCU5,L0JS08,A0A1Q5ZS75,A0A345E7N0,M0AF24,A0A1W2A082,A0A1H3X247,A0A0C1XUA0,M0D2X3,A0A2R5G167,A0A346PK63,R7RTW6,A0A1H2RBI2,A0A1C3ZXN2,B9LVP8,M5RSF0,B7K585,F8D8G0,A0A343TL88,L0AJX6,A0A2A5QS34,A0A343JEE2,A0A3P3RGE5,A0A329TBQ3,A0A285N2A8,A0A0W1S8B8,A0A1V4C8L7,L9VRQ2,E4NRV1,A0A1I6HGN0,A0A1I0NI68,,",366,37
"1207","C.H5.6","C.H5.8",358,181,177,1.83942004557231,"4F1N,4F3T,4KRE,5GUH,5VM9,6KR6,6OON,7KX7,7SWF,A0A163JTZ6,A0A0N4X8S8,A0A196SDB4,J9D5G4,Q389P5,C4LVV2,A8BCK6,A2DPV7,A0A0G4H2S4,T1H8B3,R1FDF0,S4RWI0,D2VMG4,A0A074TLL7,A0A0D1ZAJ4,Q1K660,F4PH46,A0A3M7S814,A0A164ZA52,A0A383WDW5,Q54G64,S7WCF7,I0YVB2,R7QGN7,C1DZY0,A0A2C5Z0M1,A0CB11,R9ACY5,D3BMP8,A0A1Z5TVE5,W7XD45,A0A1U7LLR0,A0A4S2MWZ7,K1VVQ6,A0A158P1R9,G7DVX0,V6R0U9,G4N9J3,E3KLI3,B7Q5I1,A0A1E3QC61,D5GGK8,S8ANP9,A0A139AUH8,L2GMR6,U4LBG4,A0A177URI1,O74957,A0A3N4IGK1,A6N7Y9,A0A0E9NDK5,T1KZ60,A0A250WXN5,A0A2G8JLH3,Q5KAT1,L2GUF2,W2T741,A0A1W0E4B5,A0A2J7QB22,S4RYE2,A0A2K3CW87,A0A388KES6,A0A226EFL3,A0A3S3PD82,A0A0L0TEV1,A0A1S3J512,G0QTT2,A0A1J1HRI1,C4V9J2,Q9JMB7,A0A075AN09,Q5TW24,U5HIG6,A0A401PRI6,Q96J94,A0A2B4RHN2,G2QEV0,A0A397UU01,A0A2T7PFL8,K7ISV0,A0A024FT57,H3HCL6,A0A0G4IME3,E9FUN9,A0A1S3CYL5,D7FQK3,A0A1Y1YHC8,T1GSU4,F4S231,A0A1D8PMK0,A0A2G5B1D8,Q5BD61,A0A1C7M8P2,A0A4D8YSQ3,A0A158PJG6,J9JZ66,A0A0C2XG51,A0A158QZT6,T0SAU8,R7YY92,A0A3S1A0C3,A0A074YJ47,A0A2K1J482,A0A1Q3ENA6,O04379,A0A371I3C8,M8AEW7,A8P0D4,A0A2K3NY65,F4NYW7,A0A409Y6G2,A0A0L0HAB7,D8PZT7,A0A1D1W4K0,A7RQ46,W4YU94,A7BJS5,D8SNM6,A0A1J8PPA3,X1WG39,M5FQK2,Q69VD5,A0A2R6NSC2,A0A0D8XL16,A0A016WPN3,Q9QZ81,G5EES3,A0A0K0EFP6,Q8CJG0,A0A1D5NTU6,V2WTL2,A0A0V0YLH8,A0A139WDH0,A0A0R3W9Q7,H3DS31,A0A1Y1HWP2,G4T5G9,B7QCC4,A0A0B2UV00,M7BCJ9,E9GN30,Q7PZ41,A0A077Z361,R7U9I3,A0A1X7V1N5,A0A0K0JDP1,A0A0N4UKJ1,A0A498N3A3,A0A3M0IQP5,A0A0L8GBV4,Q32KD4,A0A1J1JBJ0,E0W4C3,A0A482XDA9,A0A3P7EJD6,J9K2Z4,A0A2J7Q8V4,T1IBM6,V3ZRX0,A0A210QKF7,A0A423TSS1,K1PT78,A0A267E8R7,A0A1D2N447,A0A226D7A9,F6YK55,T1KTE4,A0A2C9JGZ6,A0A1V9X9F0,K5X5Z7,A0A3Q0KUG5,T1FY40,1YVU,1Z26,3DLB,5AWH,5G5T,5I4A,6QZK,7R8K,E8N0K8,A0A1I7IXT4,A0A2W1JZ37,A0A2S7WBN3,A0A328VKE4,A0A420DFE6,E0ST67,A0A4V1VDY2,A0A368P5I0,C4L1M1,A0A4R1RMM2,A0A1Y2RDH8,Q11QW7,A0A1M5ZSR3,A0A0K8QX04,A0A0M2PXX3,A0A1I3LMA1,K9TPA9,A0A1L3JHM3,A0A1W6MIP2,A0A1C0UUC4,A0A2U2J9E0,A0A2Z6E1D5,A0A0F4NXW8,A0A142XB92,L8D0R3,B1XJG0,A0A326U7G5,A0A3D8L290,H1KXR6,A0A1Q4R485,K9U8J6,A0A097QRL6,K9RC91,A0A0D8ZUC0,A0A139XGN8,A0A1T4Y3A2,Q5P0R2,B6YTQ5,A0A0B0H9B4,A0YYT3,A0A2T1EFY0,G6FTN0,R6KUL9,A0A433NB65,A0A1Z4L0A1,K9UQR0,A0A2T1G8M7,B7GJX9,A0A2T1LS63,A0A1Z4K1Y3,A0A2Z6E0R7,A0A1N6SSK9,A0A0V7ZCG4,A0A1J0AGK2,K9PFF9,A0A2G9DT08,K9UEV4,Q9L1X1,A0A060HNJ0,A0A235B542,R5XQK4,A0A1H3LE92,A0A496APJ8,A0A062U2W9,H0HWQ5,A0A1V9G9U4,A0A1I2ZGP1,A0A317EJY3,A0A1I2BD20,F8ERC7,S7VLM7,A0A1A5X8H4,A0A1I2T6Q1,A0A1R3T9N6,A0A0Q2M2Z1,H8KXJ0,D3S0S6,A0A2D1U4H7,A0A0B7I4Z6,A0LL61,Q8DKB1,A0A139WY18,A0A1J1EK56,A0A2T1E1K4,A0A1Q8ZD62,A0A4Q6XKV6,A0A1Z3HNN4,A0A239JE83,A0A2N4XBY2,Q53W94,R5JEI2,A0A0Q0ZC47,A0A2T0XH18,A0A1V4CHV0,A0A1K1RQP7,A0A2T1EKT1,A0A1N6LUI7,A0A0P0NGR6,A0A1X7IML5,A0A0A2LKJ7,K1L112,A0A0U3AL92,A0A1H3A054,E0UCX3,K9XZC6,B9LVW4,A0A0C1VHB4,Q31N05,A0A0C5JKF3,R5NJJ8,A5D4D9,Q2JI93,A0A142Y7A9,A0A432MEQ5,A0A372DKU2,A0A3R7KLK4,C1F5Q7,A0A4R3EV39,A0A1P8WP90,A0A222F7P0,A0A1C9VH88,A0A2T2YMB1,A0A329TD61,A0A101R2A0,A0A1E3XF49,A0A1U9ND56,A0A4R7BQC4,A0A1H3DGN3,A0A1Q1FPH0,E0TGY3,A0A259TUP4,F6EYI8,A0A2S9Q9J0,A0A4Q2UIU6,A0A1H0LH25,A0A318LG42,H1YCU5,L0JS08,A0A1Q5ZS75,A0A345E7N0,M0AF24,A0A1W2A082,A0A1H3X247,A0A0C1XUA0,M0D2X3,A0A2R5G167,A0A346PK63,R7RTW6,A0A1H2RBI2,A0A1C3ZXN2,B9LVP8,M5RSF0,W0JW77,B7K585,F8D8G0,A0A343TL88,L0AJX6,A0A2A5QS34,A0A343JEE2,A0A3P3RGE5,A0A329TBQ3,A0A285N2A8,A0A0W1S8B8,A0A1V4C8L7,L9VRQ2,E4NRV1,A0A1I6HGN0,A0A1I0NI68,,",366,37
"1209","C.H7.13","C.H7.9",290,181,109,2.38894520756247,"4F1N,4F3T,4KRE,5GUH,5VM9,6KR6,6OON,7KX7,7SWF,A0A163JTZ6,A0A0N4X8S8,A0A196SDB4,J9D5G4,Q389P5,C4LVV2,A0A2P6N8X7,A8BCK6,A2DPV7,A0A0G4H2S4,T1H8B3,R1FDF0,S4RWI0,D2VMG4,A0A074TLL7,A0A0D1ZAJ4,Q1K660,F4PH46,A0A3M7S814,A0A164ZA52,A0A383WDW5,Q54G64,S7WCF7,I0YVB2,R7QGN7,C1DZY0,A0A2C5Z0M1,A0CB11,R9ACY5,D3BMP8,A0A1Z5TVE5,W7XD45,A0A1U7LLR0,A0A4S2MWZ7,K1VVQ6,A0A158P1R9,G7DVX0,V6R0U9,G4N9J3,E3KLI3,B7Q5I1,A0A1E3QC61,D5GGK8,S8ANP9,A0A139AUH8,L2GMR6,U4LBG4,A0A177URI1,O74957,A0A3N4IGK1,A6N7Y9,A0A0E9NDK5,T1KZ60,A0A250WXN5,A0A2G8JLH3,Q5KAT1,L2GUF2,W2T741,A0A1W0E4B5,A0A2J7QB22,A0A2K3CW87,A0A226EFL3,A0A3S3PD82,A0A0L0TEV1,A0A1S3J512,G0QTT2,A0A1J1HRI1,C4V9J2,Q9JMB7,A0A075AN09,Q5TW24,U5HIG6,A0A401PRI6,Q96J94,A0A2B4RHN2,G2QEV0,A0A397UU01,A0A2T7PFL8,K7ISV0,A0A024FT57,H3HCL6,A0A0G4IME3,E9FUN9,A0A1S3CYL5,D7FQK3,A0A1Y1YHC8,T1GSU4,F4S231,A0A1D8PMK0,A0A2G5B1D8,Q5BD61,A0A1C7M8P2,A0A4D8YSQ3,A0A158PJG6,J9JZ66,A0A0C2XG51,A0A158QZT6,A0A165QYQ9,T0SAU8,R7YY92,A0A3S1A0C3,A0A074YJ47,A0A2K1J482,A0A1Q3ENA6,O04379,A0A371I3C8,M8AEW7,A8P0D4,A0A2K3NY65,F4NYW7,A0A409Y6G2,A0A0L0HAB7,D8PZT7,A0A1D1W4K0,A7RQ46,W4YU94,A7BJS5,D8SNM6,A0A1J8PPA3,X1WG39,M5FQK2,Q69VD5,A0A2R6NSC2,A0A0D8XL16,A0A016WPN3,Q9QZ81,G5EES3,A0A0K0EFP6,Q8CJG0,A0A1D5NTU6,V2WTL2,A0A0V0YLH8,A0A139WDH0,A0A0R3W9Q7,H3DS31,A0A1Y1HWP2,G4T5G9,B7QCC4,A0A0B2UV00,M7BCJ9,E9GN30,Q7PZ41,A0A077Z361,R7U9I3,A0A1X7V1N5,A0A0K0JDP1,A0A0N4UKJ1,A0A498N3A3,A0A3M0IQP5,A0A0L8GBV4,Q32KD4,A0A1J1JBJ0,E0W4C3,A0A482XDA9,A0A3P7EJD6,J9K2Z4,A0A2J7Q8V4,T1IBM6,V3ZRX0,A0A210QKF7,A0A423TSS1,K1PT78,A0A267E8R7,A0A1D2N447,A0A226D7A9,F6YK55,T1KTE4,A0A2C9JGZ6,A0A1V9X9F0,K5X5Z7,A0A3Q0KUG5,T1FY40,1YVU,1Z26,3DLB,5AWH,5G5T,5I4A,6QZK,7R8K,E8N0K8,A0A2W1JZ37,A0A2S7WBN3,A0A328VKE4,A0A420DFE6,E0ST67,C4L1M1,A0A1Y2RDH8,A0A1M5ZSR3,A0A0K8QX04,A0A0M2PXX3,A0A1I3LMA1,K9TPA9,A0A1W6MIP2,A0A2U2J9E0,A0A142XB92,B1XJG0,A0A326U7G5,A0A3D8L290,A0A1Q4R485,K9U8J6,A0A097QRL6,K9RC91,A0A0D8ZUC0,A0A139XGN8,B6YTQ5,A0A0B0H9B4,A0YYT3,A0A2T1EFY0,G6FTN0,R6KUL9,A0A433NB65,A0A1Z4L0A1,K9UQR0,A0A2T1G8M7,K9VUN0,B7GJX9,A0A0P6X5X2,K9ZDE3,B0JXD6,A0A2T1LS63,A0A1Z4K1Y3,A0A1N6SSK9,A0A0V7ZCG4,A0A1J0AGK2,K9PFF9,K9UEV4,A0A060HNJ0,A0A235B542,R5XQK4,A0A1H3LE92,A0A496APJ8,H0HWQ5,A0A1I2ZGP1,A0A317EJY3,A0A1I2BD20,F8ERC7,A0A0Q2M2Z1,I3TE64,Q8DKB1,A0A1J1EK56,A0A1Q8ZD62,A0A1Z3HNN4,Q53W94,A0A2T1EKT1,E0UCX3,K9XZC6,B9LVW4,A0A0C1VHB4,Q31N05,R5NJJ8,Q2JI93,A0A432MEQ5,A0A329TD61,A0A1E3XF49,A0A1H3DGN3,H1YCU5,A0A1Q5ZS75,A0A345E7N0,A0A1W2A082,A0A1H3X247,A0A0C1XUA0,A0A346PK63,R7RTW6,A0A1H2RBI2,A0A1C3ZXN2,B9LVP8,M5RSF0,W0JW77,B7K585,A0A343TL88,L0AJX6,A0A2A5QS34,A0A343JEE2,A0A3P3RGE5,A0A329TBQ3,A0A285N2A8,A0A0W1S8B8,L9VRQ2,E4NRV1,A0A1I6HGN0,,",366,37
"1211","C.H8.10","C.H8.13",343,181,162,2.74856762840188,"4F1N,4F3T,4KRE,5GUH,6KR6,6OON,7KX7,7SWF,A0A163JTZ6,A0A0N4X8S8,A0A196SDB4,J9D5G4,Q389P5,C4LVV2,A0A2P6N8X7,A8BCK6,A2DPV7,A0A0G4H2S4,T1H8B3,R1FDF0,S4RWI0,D2VMG4,A0A074TLL7,A0A0D1ZAJ4,Q1K660,F4PH46,A0A3M7S814,A0A164ZA52,A0A383WDW5,Q54G64,S7WCF7,I0YVB2,R7QGN7,C1DZY0,A0A2C5Z0M1,A0CB11,R9ACY5,D3BMP8,A0A1Z5TVE5,W7XD45,A0A1U7LLR0,A0A4S2MWZ7,K1VVQ6,A0A158P1R9,G7DVX0,V6R0U9,G4N9J3,E3KLI3,B7Q5I1,A0A1E3QC61,D5GGK8,S8ANP9,A0A139AUH8,L2GMR6,U4LBG4,A0A177URI1,O74957,A0A3N4IGK1,A6N7Y9,A0A0E9NDK5,T1KZ60,A0A250WXN5,A0A2G8JLH3,Q5KAT1,L2GUF2,W2T741,A0A1W0E4B5,A0A2J7QB22,A0A2K3CW87,A0A388KES6,A0A226EFL3,A0A3S3PD82,A0A0L0TEV1,A0A1S3J512,G0QTT2,A0A1J1HRI1,C4V9J2,Q9JMB7,A0A075AN09,Q5TW24,U5HIG6,A0A401PRI6,Q96J94,A0A2B4RHN2,G2QEV0,A0A397UU01,A0A2T7PFL8,K7ISV0,A0A024FT57,H3HCL6,A0A0G4IME3,E9FUN9,A0A1S3CYL5,D7FQK3,A0A1Y1YHC8,T1GSU4,F4S231,A0A1D8PMK0,A0A2G5B1D8,Q5BD61,A0A1C7M8P2,A0A4D8YSQ3,A0A158PJG6,J9JZ66,A0A0C2XG51,A0A158QZT6,A0A165QYQ9,T0SAU8,R7YY92,A0A3S1A0C3,A0A074YJ47,A0A2K1J482,A0A1Q3ENA6,O04379,A0A371I3C8,M8AEW7,A8P0D4,A0A2K3NY65,F4NYW7,A0A409Y6G2,A0A0L0HAB7,D8PZT7,A0A1D1W4K0,A7RQ46,W4YU94,A7BJS5,D8SNM6,A0A1J8PPA3,X1WG39,M5FQK2,Q69VD5,A0A2R6NSC2,A0A0D8XL16,A0A016WPN3,Q9QZ81,G5EES3,A0A0K0EFP6,Q8CJG0,A0A1D5NTU6,V2WTL2,A0A0V0YLH8,A0A139WDH0,A0A0R3W9Q7,H3DS31,A0A1Y1HWP2,G4T5G9,B7QCC4,A0A0B2UV00,M7BCJ9,E9GN30,Q7PZ41,A0A077Z361,R7U9I3,A0A1X7V1N5,A0A0K0JDP1,A0A0N4UKJ1,A0A498N3A3,A0A3M0IQP5,A0A0L8GBV4,Q32KD4,A0A1J1JBJ0,E0W4C3,A0A482XDA9,A0A3P7EJD6,J9K2Z4,A0A2J7Q8V4,T1IBM6,V3ZRX0,A0A210QKF7,A0A423TSS1,K1PT78,A0A267E8R7,A0A1D2N447,A0A226D7A9,F6YK55,T1KTE4,A0A2C9JGZ6,A0A1V9X9F0,K5X5Z7,A0A3Q0KUG5,T1FY40,1YVU,1Z26,3DLB,5AWH,5G5T,6QZK,7R8K,E8N0K8,A0A1I7IXT4,A0A2W1JZ37,A0A2S7WBN3,A0A328VKE4,A0A420DFE6,E0ST67,A0A4V1VDY2,A0A368P5I0,C4L1M1,A0A4R1RMM2,Q11QW7,A0A0K8QX04,A0A0M2PXX3,A0A1I3LMA1,K9TPA9,A0A1L3JHM3,A0A1W6MIP2,A0A1C0UUC4,A0A2U2J9E0,A0A2Z6E1D5,A0A0F4NXW8,A0A142XB92,L8D0R3,B1XJG0,A0A326U7G5,A0A3D8L290,H1KXR6,A0A1Q4R485,K9U8J6,A0A097QRL6,K9RC91,A0A0D8ZUC0,A0A139XGN8,A0A1T4Y3A2,Q5P0R2,B6YTQ5,A0A0B0H9B4,A0YYT3,A0A2T1EFY0,G6FTN0,R6KUL9,A0A433NB65,A0A1Z4L0A1,K9UQR0,A0A2T1G8M7,K9VUN0,B7GJX9,A0A0P6X5X2,K9ZDE3,B0JXD6,A0A2T1LS63,A0A1Z4K1Y3,A0A2Z6E0R7,A0A1N6SSK9,A0A0P4UVI8,A0A0V7ZCG4,A0A1J0AGK2,K9PFF9,A0A2G9DT08,K9UEV4,A0A060HNJ0,A0A235B542,R5XQK4,A0A1H3LE92,A0A496APJ8,A0A062U2W9,H0HWQ5,A0A1V9G9U4,A0A1I2ZGP1,A0A317EJY3,A0A1I2BD20,F8ERC7,S7VLM7,A0A1A5X8H4,A0A1I2T6Q1,A0A1R3T9N6,A0A0Q2M2Z1,H8KXJ0,D3S0S6,A0A2D1U4H7,I3TE64,A0A0B7I4Z6,A0LL61,Q8DKB1,A0A139WY18,A0A1J1EK56,A0A2T1E1K4,A0A1Q8ZD62,A0A4Q6XKV6,A0A1Z3HNN4,A0A239JE83,Q53W94,R5JEI2,A0A0Q0ZC47,A0A2T0XH18,A0A1V4CHV0,A0A1K1RQP7,A0A2T1EKT1,A0A0P0NGR6,A0A1X7IML5,A0A0A2LKJ7,K1L112,A0A0U3AL92,A0A1H3A054,E0UCX3,K9XZC6,A0A0C1VHB4,Q31N05,A0A0C5JKF3,A5D4D9,Q2JI93,A0A372DKU2,A0A3R7KLK4,C1F5Q7,A0A4R3EV39,A0A1P8WP90,A0A222F7P0,A0A1C9VH88,A0A2T2YMB1,A0A329TD61,A0A101R2A0,A0A1E3XF49,A0A4R7BQC4,A0A1H3DGN3,E0TGY3,A0A259TUP4,F6EYI8,A0A2S9Q9J0,A0A4Q2UIU6,H1YCU5,L0JS08,A0A1Q5ZS75,A0A345E7N0,M0AF24,A0A1W2A082,A0A1H3X247,A0A0C1XUA0,M0D2X3,A0A346PK63,A0A1H2RBI2,A0A1C3ZXN2,B9LVP8,W0JW77,A0A343TL88,L0AJX6,A0A2A5QS34,A0A343JEE2,A0A3P3RGE5,A0A329TBQ3,A0A285N2A8,A0A0W1S8B8,L9VRQ2,E4NRV1,A0A1I6HGN0,,",366,37
"1212","C.H8.11","C.H8.13",347,181,166,1.90687612327764,"4F1N,4F3T,4KRE,5GUH,5VM9,6KR6,6OON,7KX7,7SWF,A0A163JTZ6,A0A196SDB4,J9D5G4,Q389P5,C4LVV2,A0A2P6N8X7,A8BCK6,A2DPV7,A0A0G4H2S4,T1H8B3,R1FDF0,S4RWI0,D2VMG4,A0A074TLL7,A0A0D1ZAJ4,Q1K660,F4PH46,A0A3M7S814,A0A164ZA52,A0A383WDW5,Q54G64,S7WCF7,I0YVB2,R7QGN7,C1DZY0,A0A2C5Z0M1,A0CB11,R9ACY5,D3BMP8,A0A1Z5TVE5,W7XD45,A0A1U7LLR0,A0A4S2MWZ7,K1VVQ6,A0A158P1R9,G7DVX0,V6R0U9,G4N9J3,E3KLI3,B7Q5I1,A0A1E3QC61,D5GGK8,S8ANP9,A0A139AUH8,L2GMR6,U4LBG4,A0A177URI1,O74957,A0A3N4IGK1,A6N7Y9,A0A0E9NDK5,T1KZ60,A0A250WXN5,A0A2G8JLH3,Q5KAT1,L2GUF2,W2T741,A0A1W0E4B5,A0A2J7QB22,A0A2K3CW87,A0A388KES6,A0A226EFL3,A0A3S3PD82,A0A0L0TEV1,A0A1S3J512,G0QTT2,A0A1J1HRI1,C4V9J2,Q9JMB7,A0A075AN09,Q5TW24,U5HIG6,A0A401PRI6,Q96J94,A0A2B4RHN2,G2QEV0,A0A397UU01,A0A2T7PFL8,K7ISV0,A0A024FT57,H3HCL6,A0A0G4IME3,E9FUN9,A0A1S3CYL5,D7FQK3,A0A1Y1YHC8,T1GSU4,F4S231,A0A1D8PMK0,A0A2G5B1D8,Q5BD61,A0A1C7M8P2,A0A4D8YSQ3,A0A158PJG6,J9JZ66,A0A0C2XG51,A0A158QZT6,A0A165QYQ9,T0SAU8,R7YY92,A0A3S1A0C3,A0A074YJ47,A0A2K1J482,A0A1Q3ENA6,O04379,A0A371I3C8,M8AEW7,A8P0D4,A0A2K3NY65,F4NYW7,A0A409Y6G2,A0A0L0HAB7,D8PZT7,A0A1D1W4K0,A7RQ46,W4YU94,A7BJS5,D8SNM6,A0A1J8PPA3,X1WG39,M5FQK2,Q69VD5,A0A2R6NSC2,A0A0D8XL16,A0A016WPN3,Q9QZ81,G5EES3,A0A0K0EFP6,Q8CJG0,A0A1D5NTU6,V2WTL2,A0A0V0YLH8,A0A139WDH0,A0A0R3W9Q7,H3DS31,A0A1Y1HWP2,G4T5G9,B7QCC4,A0A0B2UV00,M7BCJ9,E9GN30,Q7PZ41,A0A077Z361,R7U9I3,A0A1X7V1N5,A0A0K0JDP1,A0A0N4UKJ1,A0A498N3A3,A0A3M0IQP5,A0A0L8GBV4,Q32KD4,A0A1J1JBJ0,E0W4C3,A0A482XDA9,A0A3P7EJD6,J9K2Z4,A0A2J7Q8V4,T1IBM6,V3ZRX0,A0A210QKF7,A0A423TSS1,K1PT78,A0A267E8R7,A0A1D2N447,A0A226D7A9,F6YK55,T1KTE4,A0A2C9JGZ6,A0A1V9X9F0,K5X5Z7,A0A3Q0KUG5,T1FY40,1YVU,1Z26,3DLB,5AWH,5G5T,6QZK,7R8K,E8N0K8,A0A1I7IXT4,A0A2W1JZ37,A0A2S7WBN3,A0A328VKE4,A0A420DFE6,E0ST67,A0A4V1VDY2,A0A368P5I0,C4L1M1,A0A4R1RMM2,A0A1Y2RDH8,Q11QW7,A0A0K8QX04,A0A0M2PXX3,A0A1I3LMA1,K9TPA9,A0A1L3JHM3,A0A1W6MIP2,A0A1C0UUC4,A0A2U2J9E0,A0A2Z6E1D5,A0A0F4NXW8,A0A142XB92,L8D0R3,B1XJG0,A0A326U7G5,A0A3D8L290,H1KXR6,A0A1Q4R485,K9U8J6,A0A097QRL6,K9RC91,A0A0D8ZUC0,A0A139XGN8,A0A1T4Y3A2,Q5P0R2,B6YTQ5,A0A0B0H9B4,A0YYT3,A0A2T1EFY0,G6FTN0,R6KUL9,A0A433NB65,A0A1Z4L0A1,K9UQR0,A0A2T1G8M7,K9VUN0,B7GJX9,A0A0P6X5X2,K9ZDE3,B0JXD6,A0A2T1LS63,A0A1Z4K1Y3,A0A2Z6E0R7,A0A1N6SSK9,A0A0P4UVI8,A0A0V7ZCG4,A0A1J0AGK2,K9PFF9,A0A2G9DT08,K9UEV4,A0A060HNJ0,A0A235B542,R5XQK4,A0A1H3LE92,A0A496APJ8,A0A062U2W9,H0HWQ5,A0A1V9G9U4,A0A1I2ZGP1,A0A317EJY3,A0A1I2BD20,F8ERC7,S7VLM7,A0A1A5X8H4,A0A1I2T6Q1,A0A1R3T9N6,A0A0Q2M2Z1,H8KXJ0,D3S0S6,A0A2D1U4H7,I3TE64,A0A0B7I4Z6,A0LL61,Q8DKB1,A0A139WY18,A0A1J1EK56,A0A2T1E1K4,A0A1Q8ZD62,A0A4Q6XKV6,A0A1Z3HNN4,A0A239JE83,Q53W94,R5JEI2,A0A0Q0ZC47,A0A2T0XH18,A0A1V4CHV0,A0A1K1RQP7,A0A2T1EKT1,A0A0P0NGR6,A0A1X7IML5,A0A0A2LKJ7,K1L112,A0A0U3AL92,A0A1H3A054,E0UCX3,K9XZC6,A0A0C1VHB4,Q31N05,A0A0C5JKF3,R5NJJ8,A5D4D9,Q2JI93,A0A372DKU2,A0A3R7KLK4,C1F5Q7,A0A4R3EV39,A0A1P8WP90,A0A222F7P0,A0A1C9VH88,A0A2T2YMB1,A0A329TD61,A0A101R2A0,A0A1E3XF49,A0A4R7BQC4,A0A1H3DGN3,A0A1Q1FPH0,E0TGY3,A0A259TUP4,F6EYI8,A0A2S9Q9J0,A0A4Q2UIU6,H1YCU5,L0JS08,A0A1Q5ZS75,A0A345E7N0,M0AF24,A0A1W2A082,A0A1H3X247,A0A0C1XUA0,M0D2X3,A0A346PK63,R7RTW6,A0A1H2RBI2,A0A1C3ZXN2,B9LVP8,W0JW77,A0A343TL88,L0AJX6,A0A2A5QS34,A0A343JEE2,A0A3P3RGE5,A0A329TBQ3,A0A285N2A8,A0A0W1S8B8,L9VRQ2,E4NRV1,A0A1I6HGN0,,",366,37
"1215","C.H8.13","C.H8.16",327,181,146,3.0828729281768,"4F1N,4F3T,4KRE,5GUH,5VM9,6KR6,6OON,7KX7,7SWF,A0A163JTZ6,A0A0N4X8S8,A0A196SDB4,J9D5G4,Q389P5,C4LVV2,A0A2P6N8X7,A8BCK6,A2DPV7,A0A0G4H2S4,T1H8B3,R1FDF0,S4RWI0,D2VMG4,A0A074TLL7,A0A0D1ZAJ4,Q1K660,F4PH46,A0A3M7S814,A0A164ZA52,A0A383WDW5,Q54G64,S7WCF7,I0YVB2,R7QGN7,C1DZY0,A0A2C5Z0M1,A0CB11,R9ACY5,D3BMP8,A0A1Z5TVE5,W7XD45,A0A1U7LLR0,A0A4S2MWZ7,K1VVQ6,A0A158P1R9,G7DVX0,V6R0U9,G4N9J3,E3KLI3,B7Q5I1,A0A1E3QC61,D5GGK8,S8ANP9,A0A139AUH8,L2GMR6,U4LBG4,A0A177URI1,O74957,A0A3N4IGK1,A6N7Y9,A0A0E9NDK5,T1KZ60,A0A250WXN5,A0A2G8JLH3,Q5KAT1,L2GUF2,W2T741,A0A1W0E4B5,A0A2J7QB22,A0A2K3CW87,A0A388KES6,A0A226EFL3,A0A3S3PD82,A0A0L0TEV1,A0A1S3J512,G0QTT2,A0A1J1HRI1,C4V9J2,Q9JMB7,A0A075AN09,Q5TW24,U5HIG6,A0A401PRI6,Q96J94,A0A2B4RHN2,G2QEV0,A0A397UU01,A0A2T7PFL8,K7ISV0,A0A024FT57,H3HCL6,A0A0G4IME3,A0A1S3CYL5,D7FQK3,A0A1Y1YHC8,T1GSU4,F4S231,A0A1D8PMK0,A0A2G5B1D8,Q5BD61,A0A1C7M8P2,A0A4D8YSQ3,A0A158PJG6,J9JZ66,A0A0C2XG51,A0A158QZT6,A0A165QYQ9,T0SAU8,R7YY92,A0A3S1A0C3,A0A074YJ47,A0A2K1J482,A0A1Q3ENA6,O04379,A0A371I3C8,M8AEW7,A8P0D4,A0A2K3NY65,F4NYW7,A0A409Y6G2,A0A0L0HAB7,D8PZT7,A0A1D1W4K0,A7RQ46,W4YU94,A7BJS5,D8SNM6,A0A1J8PPA3,X1WG39,M5FQK2,Q69VD5,A0A2R6NSC2,A0A0D8XL16,A0A016WPN3,Q9QZ81,G5EES3,A0A0K0EFP6,Q8CJG0,A0A1D5NTU6,V2WTL2,A0A0V0YLH8,A0A139WDH0,A0A0R3W9Q7,H3DS31,A0A1Y1HWP2,G4T5G9,B7QCC4,A0A0B2UV00,M7BCJ9,E9GN30,Q7PZ41,A0A077Z361,R7U9I3,A0A1X7V1N5,A0A0K0JDP1,A0A0N4UKJ1,A0A498N3A3,A0A3M0IQP5,A0A0L8GBV4,Q32KD4,A0A1J1JBJ0,E0W4C3,A0A482XDA9,A0A3P7EJD6,J9K2Z4,A0A2J7Q8V4,T1IBM6,V3ZRX0,A0A210QKF7,A0A423TSS1,K1PT78,A0A267E8R7,A0A1D2N447,A0A226D7A9,F6YK55,T1KTE4,A0A2C9JGZ6,A0A1V9X9F0,K5X5Z7,A0A3Q0KUG5,T1FY40,5AWH,6QZK,7R8K,E8N0K8,A0A1I7IXT4,A0A2W1JZ37,A0A2S7WBN3,A0A328VKE4,A0A420DFE6,E0ST67,A0A4V1VDY2,A0A368P5I0,C4L1M1,A0A4R1RMM2,A0A1Y2RDH8,Q11QW7,A0A0K8QX04,A0A0M2PXX3,A0A1I3LMA1,K9TPA9,A0A1L3JHM3,A0A1W6MIP2,A0A1C0UUC4,A0A2U2J9E0,A0A0F4NXW8,A0A142XB92,L8D0R3,A0A326U7G5,A0A3D8L290,H1KXR6,A0A1Q4R485,K9U8J6,A0A097QRL6,K9RC91,A0A0D8ZUC0,A0A139XGN8,A0A1T4Y3A2,B6YTQ5,A0A0B0H9B4,A0YYT3,A0A2T1EFY0,G6FTN0,R6KUL9,A0A433NB65,A0A1Z4L0A1,K9UQR0,A0A2T1G8M7,K9VUN0,B7GJX9,A0A0P6X5X2,K9ZDE3,B0JXD6,A0A2T1LS63,A0A1Z4K1Y3,A0A1N6SSK9,A0A0P4UVI8,A0A0V7ZCG4,A0A1J0AGK2,K9PFF9,A0A2G9DT08,K9UEV4,A0A060HNJ0,A0A235B542,R5XQK4,A0A1H3LE92,A0A496APJ8,A0A062U2W9,H0HWQ5,A0A1V9G9U4,A0A1I2ZGP1,A0A317EJY3,A0A1I2BD20,F8ERC7,S7VLM7,A0A1A5X8H4,A0A1I2T6Q1,A0A1R3T9N6,H8KXJ0,D3S0S6,A0A2D1U4H7,A0A0B7I4Z6,A0LL61,A0A139WY18,A0A2T1E1K4,A0A1Q8ZD62,A0A4Q6XKV6,A0A1Z3HNN4,A0A239JE83,A0A2N4XBY2,R5JEI2,A0A0Q0ZC47,A0A2T0XH18,A0A1V4CHV0,A0A1K1RQP7,A0A0P0NGR6,A0A1X7IML5,A0A0A2LKJ7,K1L112,A0A0U3AL92,A0A1H3A054,A0A0C5JKF3,R5NJJ8,A5D4D9,A0A372DKU2,A0A3R7KLK4,C1F5Q7,A0A4R3EV39,A0A1P8WP90,A0A222F7P0,A0A1C9VH88,A0A2T2YMB1,A0A329TD61,A0A101R2A0,A0A1E3XF49,A0A4R7BQC4,A0A1Q1FPH0,E0TGY3,F6EYI8,A0A2S9Q9J0,H1YCU5,L0JS08,A0A1Q5ZS75,A0A345E7N0,M0AF24,A0A1W2A082,A0A1H3X247,A0A0C1XUA0,M0D2X3,A0A346PK63,R7RTW6,A0A1H2RBI2,A0A1C3ZXN2,B9LVP8,M5RSF0,W0JW77,A0A343TL88,L0AJX6,A0A2A5QS34,A0A343JEE2,A0A3P3RGE5,A0A329TBQ3,A0A285N2A8,A0A0W1S8B8,L9VRQ2,E4NRV1,A0A1I6HGN0,,",366,37
"1216","C.H8.13","C.H8.9",337,181,156,2.96187491146055,"4F1N,4F3T,4KRE,5GUH,5VM9,6KR6,6OON,7KX7,7SWF,A0A163JTZ6,A0A0N4X8S8,J9D5G4,Q389P5,C4LVV2,A0A2P6N8X7,A8BCK6,A2DPV7,A0A0G4H2S4,T1H8B3,R1FDF0,S4RWI0,D2VMG4,A0A074TLL7,A0A0D1ZAJ4,Q1K660,F4PH46,A0A3M7S814,A0A164ZA52,A0A383WDW5,Q54G64,S7WCF7,I0YVB2,R7QGN7,C1DZY0,A0A2C5Z0M1,A0CB11,R9ACY5,D3BMP8,A0A1Z5TVE5,W7XD45,A0A1U7LLR0,A0A4S2MWZ7,K1VVQ6,A0A158P1R9,G7DVX0,V6R0U9,G4N9J3,E3KLI3,B7Q5I1,A0A1E3QC61,D5GGK8,S8ANP9,A0A139AUH8,L2GMR6,U4LBG4,A0A177URI1,O74957,A0A3N4IGK1,A6N7Y9,A0A0E9NDK5,T1KZ60,A0A250WXN5,A0A2G8JLH3,Q5KAT1,L2GUF2,W2T741,A0A1W0E4B5,A0A2J7QB22,A0A2K3CW87,A0A388KES6,A0A226EFL3,A0A3S3PD82,A0A0L0TEV1,A0A1S3J512,G0QTT2,A0A1J1HRI1,C4V9J2,Q9JMB7,A0A075AN09,Q5TW24,U5HIG6,A0A401PRI6,Q96J94,A0A2B4RHN2,G2QEV0,A0A397UU01,A0A2T7PFL8,K7ISV0,A0A024FT57,H3HCL6,A0A0G4IME3,E9FUN9,A0A1S3CYL5,D7FQK3,A0A1Y1YHC8,T1GSU4,F4S231,A0A1D8PMK0,A0A2G5B1D8,Q5BD61,A0A1C7M8P2,A0A4D8YSQ3,A0A158PJG6,J9JZ66,A0A0C2XG51,A0A158QZT6,A0A165QYQ9,T0SAU8,R7YY92,A0A3S1A0C3,A0A074YJ47,A0A2K1J482,A0A1Q3ENA6,O04379,A0A371I3C8,M8AEW7,A8P0D4,A0A2K3NY65,F4NYW7,A0A409Y6G2,A0A0L0HAB7,D8PZT7,A0A1D1W4K0,A7RQ46,W4YU94,A7BJS5,D8SNM6,A0A1J8PPA3,X1WG39,M5FQK2,Q69VD5,A0A2R6NSC2,A0A0D8XL16,A0A016WPN3,Q9QZ81,G5EES3,A0A0K0EFP6,Q8CJG0,A0A1D5NTU6,V2WTL2,A0A0V0YLH8,A0A139WDH0,A0A0R3W9Q7,H3DS31,A0A1Y1HWP2,G4T5G9,B7QCC4,A0A0B2UV00,M7BCJ9,E9GN30,Q7PZ41,A0A077Z361,R7U9I3,A0A1X7V1N5,A0A0K0JDP1,A0A0N4UKJ1,A0A498N3A3,A0A3M0IQP5,A0A0L8GBV4,Q32KD4,A0A1J1JBJ0,E0W4C3,A0A482XDA9,A0A3P7EJD6,J9K2Z4,A0A2J7Q8V4,T1IBM6,V3ZRX0,A0A210QKF7,A0A423TSS1,K1PT78,A0A267E8R7,A0A1D2N447,A0A226D7A9,F6YK55,T1KTE4,A0A2C9JGZ6,A0A1V9X9F0,K5X5Z7,A0A3Q0KUG5,T1FY40,1YVU,1Z26,3DLB,5AWH,5G5T,6QZK,7R8K,E8N0K8,A0A2S7WBN3,A0A328VKE4,A0A420DFE6,E0ST67,A0A4R1RMM2,Q11QW7,A0A0K8QX04,A0A0M2PXX3,A0A1I3LMA1,K9TPA9,A0A1L3JHM3,A0A1W6MIP2,A0A1C0UUC4,A0A2U2J9E0,A0A2Z6E1D5,A0A0F4NXW8,A0A142XB92,L8D0R3,B1XJG0,A0A326U7G5,A0A3D8L290,H1KXR6,A0A1Q4R485,K9U8J6,A0A097QRL6,K9RC91,A0A0D8ZUC0,A0A139XGN8,A0A1T4Y3A2,Q5P0R2,B6YTQ5,A0A0B0H9B4,A0YYT3,A0A2T1EFY0,G6FTN0,A0A433NB65,A0A1Z4L0A1,K9UQR0,A0A2T1G8M7,K9VUN0,B7GJX9,A0A0P6X5X2,K9ZDE3,B0JXD6,A0A2T1LS63,A0A1Z4K1Y3,A0A2Z6E0R7,A0A1N6SSK9,A0A0P4UVI8,A0A0V7ZCG4,A0A1J0AGK2,K9PFF9,K9UEV4,A0A060HNJ0,A0A235B542,R5XQK4,A0A1H3LE92,A0A496APJ8,A0A062U2W9,H0HWQ5,A0A1V9G9U4,A0A1I2ZGP1,A0A317EJY3,A0A1I2BD20,F8ERC7,S7VLM7,A0A1A5X8H4,A0A1I2T6Q1,A0A1R3T9N6,A0A0Q2M2Z1,H8KXJ0,D3S0S6,A0A2D1U4H7,I3TE64,A0A0B7I4Z6,A0LL61,Q8DKB1,A0A139WY18,A0A1J1EK56,A0A2T1E1K4,A0A1Q8ZD62,A0A4Q6XKV6,A0A1Z3HNN4,A0A239JE83,Q53W94,R5JEI2,A0A0Q0ZC47,A0A2T0XH18,A0A1V4CHV0,A0A1K1RQP7,A0A2T1EKT1,A0A0P0NGR6,A0A1X7IML5,A0A0A2LKJ7,K1L112,A0A0U3AL92,A0A1H3A054,E0UCX3,K9XZC6,A0A0C1VHB4,Q31N05,A0A0C5JKF3,R5NJJ8,A5D4D9,Q2JI93,A0A372DKU2,A0A3R7KLK4,C1F5Q7,A0A4R3EV39,A0A1P8WP90,A0A222F7P0,A0A1C9VH88,A0A2T2YMB1,A0A329TD61,A0A1E3XF49,A0A4R7BQC4,A0A1H3DGN3,A0A1Q1FPH0,E0TGY3,A0A259TUP4,F6EYI8,A0A2S9Q9J0,A0A4Q2UIU6,H1YCU5,A0A1Q5ZS75,A0A345E7N0,M0AF24,A0A1W2A082,A0A1H3X247,A0A0C1XUA0,M0D2X3,A0A346PK63,R7RTW6,A0A1H2RBI2,A0A1C3ZXN2,B9LVP8,W0JW77,A0A343TL88,L0AJX6,A0A2A5QS34,A0A343JEE2,A0A3P3RGE5,A0A329TBQ3,A0A285N2A8,A0A0W1S8B8,L9VRQ2,E4NRV1,A0A1I6HGN0,,",366,37
"1219","C.H9.10","C.H9.12",362,181,181,1.97790055248619,"4F1N,4F3T,4KRE,5GUH,5VM9,6KR6,6OON,7KX7,7SWF,A0A163JTZ6,A0A0N4X8S8,A0A196SDB4,J9D5G4,Q389P5,C4LVV2,A0A2P6N8X7,A8BCK6,A2DPV7,A0A0G4H2S4,R1FDF0,D2VMG4,A0A074TLL7,A0A0D1ZAJ4,Q1K660,F4PH46,A0A3M7S814,A0A164ZA52,A0A383WDW5,Q54G64,S7WCF7,I0YVB2,R7QGN7,C1DZY0,A0A2C5Z0M1,A0CB11,R9ACY5,D3BMP8,A0A1Z5TVE5,W7XD45,A0A1U7LLR0,A0A4S2MWZ7,K1VVQ6,A0A158P1R9,G7DVX0,V6R0U9,G4N9J3,E3KLI3,B7Q5I1,A0A1E3QC61,D5GGK8,S8ANP9,A0A139AUH8,L2GMR6,U4LBG4,A0A177URI1,O74957,A0A3N4IGK1,A6N7Y9,A0A0E9NDK5,T1KZ60,A0A250WXN5,A0A2G8JLH3,Q5KAT1,L2GUF2,W2T741,A0A1W0E4B5,A0A2J7QB22,S4RYE2,A0A2K3CW87,A0A388KES6,A0A226EFL3,A0A3S3PD82,A0A0L0TEV1,A0A1S3J512,G0QTT2,A0A1J1HRI1,C4V9J2,Q9JMB7,A0A075AN09,Q5TW24,U5HIG6,A0A401PRI6,Q96J94,A0A2B4RHN2,G2QEV0,A0A397UU01,A0A2T7PFL8,K7ISV0,A0A024FT57,H3HCL6,A0A0G4IME3,E9FUN9,A0A1S3CYL5,D7FQK3,A0A1Y1YHC8,T1GSU4,F4S231,A0A1D8PMK0,A0A2G5B1D8,Q5BD61,A0A1C7M8P2,A0A4D8YSQ3,A0A158PJG6,J9JZ66,A0A0C2XG51,A0A158QZT6,A0A165QYQ9,T0SAU8,R7YY92,A0A3S1A0C3,A0A074YJ47,A0A2K1J482,A0A1Q3ENA6,O04379,A0A371I3C8,M8AEW7,A8P0D4,A0A2K3NY65,F4NYW7,A0A409Y6G2,A0A0L0HAB7,D8PZT7,A0A1D1W4K0,A7RQ46,W4YU94,A7BJS5,D8SNM6,A0A1J8PPA3,X1WG39,M5FQK2,Q69VD5,A0A2R6NSC2,A0A0D8XL16,A0A016WPN3,Q9QZ81,G5EES3,A0A0K0EFP6,Q8CJG0,A0A1D5NTU6,V2WTL2,A0A0V0YLH8,A0A139WDH0,A0A0R3W9Q7,H3DS31,A0A1Y1HWP2,G4T5G9,B7QCC4,A0A0B2UV00,M7BCJ9,E9GN30,Q7PZ41,A0A077Z361,R7U9I3,A0A1X7V1N5,A0A0K0JDP1,A0A0N4UKJ1,A0A498N3A3,A0A3M0IQP5,A0A0L8GBV4,Q32KD4,A0A1J1JBJ0,E0W4C3,A0A482XDA9,A0A3P7EJD6,J9K2Z4,A0A2J7Q8V4,T1IBM6,V3ZRX0,A0A210QKF7,A0A423TSS1,K1PT78,A0A267E8R7,A0A1D2N447,A0A226D7A9,F6YK55,T1KTE4,A0A2C9JGZ6,A0A1V9X9F0,K5X5Z7,A0A3Q0KUG5,T1FY40,1YVU,1Z26,3DLB,5AWH,5G5T,5I4A,6QZK,7R8K,A0A1I7IXT4,A0A2W1JZ37,A0A2S7WBN3,A0A328VKE4,A0A420DFE6,E0ST67,A0A4V1VDY2,A0A368P5I0,C4L1M1,A0A4R1RMM2,A0A1Y2RDH8,Q11QW7,A0A1M5ZSR3,A0A0K8QX04,A0A0M2PXX3,K9TPA9,A0A1L3JHM3,A0A1W6MIP2,A0A1C0UUC4,A0A2U2J9E0,A0A2Z6E1D5,A0A0F4NXW8,A0A142XB92,L8D0R3,B1XJG0,A0A326U7G5,A0A3D8L290,H1KXR6,A0A1Q4R485,K9U8J6,A0A097QRL6,K9RC91,A0A0D8ZUC0,A0A139XGN8,A0A1T4Y3A2,Q5P0R2,B6YTQ5,A0A0B0H9B4,A0YYT3,A0A2T1EFY0,G6FTN0,R6KUL9,A0A433NB65,A0A1Z4L0A1,K9UQR0,A0A2T1G8M7,K9VUN0,B7GJX9,A0A0P6X5X2,K9ZDE3,B0JXD6,A0A2T1LS63,A0A1Z4K1Y3,A0A2Z6E0R7,A0A1N6SSK9,A0A0P4UVI8,A0A0V7ZCG4,A0A1J0AGK2,K9PFF9,A0A2G9DT08,K9UEV4,Q9L1X1,A0A060HNJ0,A0A235B542,R5XQK4,A0A1H3LE92,A0A496APJ8,A0A062U2W9,H0HWQ5,A0A1V9G9U4,A0A1I2ZGP1,A0A317EJY3,A0A1I2BD20,F8ERC7,S7VLM7,A0A1A5X8H4,A0A1I2T6Q1,A0A1R3T9N6,A0A0Q2M2Z1,H8KXJ0,D3S0S6,A0A2D1U4H7,I3TE64,A0A0B7I4Z6,A0LL61,Q8DKB1,A0A139WY18,A0A1J1EK56,A0A2T1E1K4,A0A1Q8ZD62,A0A4Q6XKV6,A0A1Z3HNN4,A0A239JE83,A0A2N4XBY2,Q53W94,R5JEI2,A0A0Q0ZC47,A0A2T0XH18,A0A1V4CHV0,A0A1K1RQP7,A0A2T1EKT1,A0A1N6LUI7,A0A0P0NGR6,A0A1X7IML5,A0A0A2LKJ7,K1L112,A0A0U3AL92,A0A1H3A054,E0UCX3,K9XZC6,B9LVW4,A0A0C1VHB4,Q31N05,A0A0C5JKF3,R5NJJ8,A5D4D9,Q2JI93,A0A142Y7A9,A0A432MEQ5,A0A372DKU2,A0A3R7KLK4,C1F5Q7,A0A4R3EV39,A0A1P8WP90,A0A222F7P0,A0A1C9VH88,A0A2T2YMB1,A0A329TD61,A0A101R2A0,A0A1E3XF49,A0A1U9ND56,A0A4R7BQC4,A0A1H3DGN3,A0A1Q1FPH0,E0TGY3,A0A259TUP4,F6EYI8,A0A2S9Q9J0,A0A4Q2UIU6,A0A1H0LH25,A0A318LG42,H1YCU5,L0JS08,A0A1Q5ZS75,A0A345E7N0,M0AF24,A0A1W2A082,A0A1H3X247,A0A0C1XUA0,M0D2X3,A0A2R5G167,A0A346PK63,R7RTW6,A0A1H2RBI2,A0A1C3ZXN2,B9LVP8,M5RSF0,W0JW77,B7K585,F8D8G0,A0A343TL88,L0AJX6,A0A2A5QS34,A0A343JEE2,A0A3P3RGE5,A0A329TBQ3,A0A285N2A8,A0A0W1S8B8,A0A1V4C8L7,L9VRQ2,E4NRV1,A0A1I6HGN0,A0A1I0NI68,,",366,37
"1220","C.H9.10","C.H9.13",360,181,179,4.71806228587302,"4F1N,4F3T,4KRE,5GUH,5VM9,6KR6,6OON,7KX7,7SWF,A0A163JTZ6,A0A0N4X8S8,A0A196SDB4,J9D5G4,Q389P5,C4LVV2,A0A2P6N8X7,A8BCK6,A2DPV7,A0A0G4H2S4,R1FDF0,D2VMG4,A0A074TLL7,A0A0D1ZAJ4,Q1K660,F4PH46,A0A3M7S814,A0A164ZA52,A0A383WDW5,Q54G64,S7WCF7,I0YVB2,R7QGN7,C1DZY0,A0A2C5Z0M1,A0CB11,R9ACY5,D3BMP8,A0A1Z5TVE5,W7XD45,A0A1U7LLR0,A0A4S2MWZ7,K1VVQ6,A0A158P1R9,G7DVX0,V6R0U9,G4N9J3,E3KLI3,B7Q5I1,A0A1E3QC61,D5GGK8,S8ANP9,A0A139AUH8,L2GMR6,U4LBG4,A0A177URI1,O74957,A0A3N4IGK1,A6N7Y9,A0A0E9NDK5,T1KZ60,A0A250WXN5,A0A2G8JLH3,Q5KAT1,L2GUF2,W2T741,A0A1W0E4B5,A0A2J7QB22,S4RYE2,A0A2K3CW87,A0A388KES6,A0A226EFL3,A0A3S3PD82,A0A0L0TEV1,A0A1S3J512,G0QTT2,A0A1J1HRI1,C4V9J2,Q9JMB7,A0A075AN09,Q5TW24,U5HIG6,A0A401PRI6,Q96J94,A0A2B4RHN2,G2QEV0,A0A397UU01,A0A2T7PFL8,K7ISV0,A0A024FT57,H3HCL6,A0A0G4IME3,E9FUN9,A0A1S3CYL5,D7FQK3,A0A1Y1YHC8,T1GSU4,F4S231,A0A1D8PMK0,A0A2G5B1D8,Q5BD61,A0A1C7M8P2,A0A4D8YSQ3,A0A158PJG6,J9JZ66,A0A0C2XG51,A0A158QZT6,A0A165QYQ9,T0SAU8,R7YY92,A0A3S1A0C3,A0A074YJ47,A0A2K1J482,A0A1Q3ENA6,O04379,A0A371I3C8,M8AEW7,A8P0D4,A0A2K3NY65,F4NYW7,A0A409Y6G2,A0A0L0HAB7,D8PZT7,A0A1D1W4K0,A7RQ46,W4YU94,A7BJS5,D8SNM6,A0A1J8PPA3,X1WG39,M5FQK2,Q69VD5,A0A2R6NSC2,A0A0D8XL16,A0A016WPN3,Q9QZ81,G5EES3,A0A0K0EFP6,Q8CJG0,A0A1D5NTU6,V2WTL2,A0A0V0YLH8,A0A139WDH0,A0A0R3W9Q7,H3DS31,A0A1Y1HWP2,G4T5G9,B7QCC4,A0A0B2UV00,M7BCJ9,E9GN30,Q7PZ41,A0A077Z361,R7U9I3,A0A1X7V1N5,A0A0K0JDP1,A0A0N4UKJ1,A0A498N3A3,A0A3M0IQP5,A0A0L8GBV4,Q32KD4,A0A1J1JBJ0,E0W4C3,A0A482XDA9,A0A3P7EJD6,J9K2Z4,A0A2J7Q8V4,T1IBM6,V3ZRX0,A0A210QKF7,A0A423TSS1,K1PT78,A0A267E8R7,A0A1D2N447,A0A226D7A9,F6YK55,T1KTE4,A0A2C9JGZ6,A0A1V9X9F0,K5X5Z7,A0A3Q0KUG5,T1FY40,1YVU,1Z26,3DLB,5AWH,5G5T,5I4A,6QZK,7R8K,A0A1I7IXT4,A0A2W1JZ37,A0A2S7WBN3,A0A328VKE4,A0A420DFE6,E0ST67,A0A4V1VDY2,A0A368P5I0,C4L1M1,A0A4R1RMM2,A0A1Y2RDH8,Q11QW7,A0A1M5ZSR3,A0A0K8QX04,A0A0M2PXX3,K9TPA9,A0A1L3JHM3,A0A1W6MIP2,A0A1C0UUC4,A0A2U2J9E0,A0A2Z6E1D5,A0A0F4NXW8,A0A142XB92,L8D0R3,B1XJG0,A0A326U7G5,A0A3D8L290,A0A1Q4R485,K9U8J6,A0A097QRL6,K9RC91,A0A0D8ZUC0,A0A139XGN8,A0A1T4Y3A2,Q5P0R2,B6YTQ5,A0A0B0H9B4,A0YYT3,A0A2T1EFY0,G6FTN0,R6KUL9,A0A433NB65,A0A1Z4L0A1,K9UQR0,A0A2T1G8M7,K9VUN0,B7GJX9,K9ZDE3,B0JXD6,A0A2T1LS63,A0A1Z4K1Y3,A0A2Z6E0R7,A0A1N6SSK9,A0A0P4UVI8,A0A0V7ZCG4,A0A1J0AGK2,K9PFF9,A0A2G9DT08,K9UEV4,Q9L1X1,A0A060HNJ0,A0A235B542,R5XQK4,A0A1H3LE92,A0A496APJ8,A0A062U2W9,H0HWQ5,A0A1V9G9U4,A0A1I2ZGP1,A0A317EJY3,A0A1I2BD20,F8ERC7,S7VLM7,A0A1A5X8H4,A0A1I2T6Q1,A0A1R3T9N6,A0A0Q2M2Z1,H8KXJ0,D3S0S6,A0A2D1U4H7,I3TE64,A0A0B7I4Z6,A0LL61,Q8DKB1,A0A139WY18,A0A1J1EK56,A0A2T1E1K4,A0A1Q8ZD62,A0A4Q6XKV6,A0A1Z3HNN4,A0A239JE83,A0A2N4XBY2,Q53W94,R5JEI2,A0A0Q0ZC47,A0A2T0XH18,A0A1V4CHV0,A0A1K1RQP7,A0A2T1EKT1,A0A1N6LUI7,A0A0P0NGR6,A0A1X7IML5,A0A0A2LKJ7,K1L112,A0A0U3AL92,A0A1H3A054,E0UCX3,K9XZC6,B9LVW4,A0A0C1VHB4,Q31N05,A0A0C5JKF3,R5NJJ8,A5D4D9,Q2JI93,A0A142Y7A9,A0A432MEQ5,A0A372DKU2,A0A3R7KLK4,C1F5Q7,A0A4R3EV39,A0A1P8WP90,A0A222F7P0,A0A1C9VH88,A0A2T2YMB1,A0A329TD61,A0A101R2A0,A0A1E3XF49,A0A1U9ND56,A0A4R7BQC4,A0A1H3DGN3,A0A1Q1FPH0,E0TGY3,A0A259TUP4,F6EYI8,A0A2S9Q9J0,A0A4Q2UIU6,A0A1H0LH25,A0A318LG42,H1YCU5,L0JS08,A0A1Q5ZS75,A0A345E7N0,M0AF24,A0A1W2A082,A0A1H3X247,A0A0C1XUA0,M0D2X3,A0A2R5G167,A0A346PK63,R7RTW6,A0A1H2RBI2,A0A1C3ZXN2,B9LVP8,M5RSF0,W0JW77,B7K585,F8D8G0,A0A343TL88,L0AJX6,A0A2A5QS34,A0A343JEE2,A0A3P3RGE5,A0A329TBQ3,A0A285N2A8,A0A0W1S8B8,A0A1V4C8L7,L9VRQ2,E4NRV1,A0A1I6HGN0,A0A1I0NI68,,",366,37
"1221","C.H9.10","C.H9.8",362,181,181,1.98066298342541,"4F1N,4F3T,4KRE,5GUH,5VM9,6KR6,6OON,7KX7,7SWF,A0A163JTZ6,A0A0N4X8S8,A0A196SDB4,J9D5G4,Q389P5,C4LVV2,A0A2P6N8X7,A8BCK6,A2DPV7,A0A0G4H2S4,R1FDF0,D2VMG4,A0A074TLL7,A0A0D1ZAJ4,Q1K660,F4PH46,A0A3M7S814,A0A164ZA52,A0A383WDW5,Q54G64,S7WCF7,I0YVB2,R7QGN7,C1DZY0,A0A2C5Z0M1,A0CB11,R9ACY5,D3BMP8,A0A1Z5TVE5,W7XD45,A0A1U7LLR0,A0A4S2MWZ7,K1VVQ6,A0A158P1R9,G7DVX0,V6R0U9,G4N9J3,E3KLI3,B7Q5I1,A0A1E3QC61,D5GGK8,S8ANP9,A0A139AUH8,L2GMR6,U4LBG4,A0A177URI1,O74957,A0A3N4IGK1,A6N7Y9,A0A0E9NDK5,T1KZ60,A0A250WXN5,A0A2G8JLH3,Q5KAT1,L2GUF2,W2T741,A0A1W0E4B5,A0A2J7QB22,S4RYE2,A0A2K3CW87,A0A388KES6,A0A226EFL3,A0A3S3PD82,A0A0L0TEV1,A0A1S3J512,G0QTT2,A0A1J1HRI1,C4V9J2,Q9JMB7,A0A075AN09,Q5TW24,U5HIG6,A0A401PRI6,Q96J94,A0A2B4RHN2,G2QEV0,A0A397UU01,A0A2T7PFL8,K7ISV0,A0A024FT57,H3HCL6,A0A0G4IME3,E9FUN9,A0A1S3CYL5,D7FQK3,A0A1Y1YHC8,T1GSU4,F4S231,A0A1D8PMK0,A0A2G5B1D8,Q5BD61,A0A1C7M8P2,A0A4D8YSQ3,A0A158PJG6,J9JZ66,A0A0C2XG51,A0A158QZT6,A0A165QYQ9,T0SAU8,R7YY92,A0A3S1A0C3,A0A074YJ47,A0A2K1J482,A0A1Q3ENA6,O04379,A0A371I3C8,M8AEW7,A8P0D4,A0A2K3NY65,F4NYW7,A0A409Y6G2,A0A0L0HAB7,D8PZT7,A0A1D1W4K0,A7RQ46,W4YU94,A7BJS5,D8SNM6,A0A1J8PPA3,X1WG39,M5FQK2,Q69VD5,A0A2R6NSC2,A0A0D8XL16,A0A016WPN3,Q9QZ81,G5EES3,A0A0K0EFP6,Q8CJG0,A0A1D5NTU6,V2WTL2,A0A0V0YLH8,A0A139WDH0,A0A0R3W9Q7,H3DS31,A0A1Y1HWP2,G4T5G9,B7QCC4,A0A0B2UV00,M7BCJ9,E9GN30,Q7PZ41,A0A077Z361,R7U9I3,A0A1X7V1N5,A0A0K0JDP1,A0A0N4UKJ1,A0A498N3A3,A0A3M0IQP5,A0A0L8GBV4,Q32KD4,A0A1J1JBJ0,E0W4C3,A0A482XDA9,A0A3P7EJD6,J9K2Z4,A0A2J7Q8V4,T1IBM6,V3ZRX0,A0A210QKF7,A0A423TSS1,K1PT78,A0A267E8R7,A0A1D2N447,A0A226D7A9,F6YK55,T1KTE4,A0A2C9JGZ6,A0A1V9X9F0,K5X5Z7,A0A3Q0KUG5,T1FY40,1YVU,1Z26,3DLB,5AWH,5G5T,5I4A,6QZK,7R8K,A0A1I7IXT4,A0A2W1JZ37,A0A2S7WBN3,A0A328VKE4,A0A420DFE6,E0ST67,A0A4V1VDY2,A0A368P5I0,C4L1M1,A0A4R1RMM2,A0A1Y2RDH8,Q11QW7,A0A1M5ZSR3,A0A0K8QX04,A0A0M2PXX3,K9TPA9,A0A1L3JHM3,A0A1W6MIP2,A0A1C0UUC4,A0A2U2J9E0,A0A2Z6E1D5,A0A0F4NXW8,A0A142XB92,L8D0R3,B1XJG0,A0A326U7G5,A0A3D8L290,H1KXR6,A0A1Q4R485,K9U8J6,A0A097QRL6,K9RC91,A0A0D8ZUC0,A0A139XGN8,A0A1T4Y3A2,Q5P0R2,B6YTQ5,A0A0B0H9B4,A0YYT3,A0A2T1EFY0,G6FTN0,R6KUL9,A0A433NB65,A0A1Z4L0A1,K9UQR0,A0A2T1G8M7,K9VUN0,B7GJX9,A0A0P6X5X2,K9ZDE3,B0JXD6,A0A2T1LS63,A0A1Z4K1Y3,A0A2Z6E0R7,A0A1N6SSK9,A0A0P4UVI8,A0A0V7ZCG4,A0A1J0AGK2,K9PFF9,A0A2G9DT08,K9UEV4,Q9L1X1,A0A060HNJ0,A0A235B542,R5XQK4,A0A1H3LE92,A0A496APJ8,A0A062U2W9,H0HWQ5,A0A1V9G9U4,A0A1I2ZGP1,A0A317EJY3,A0A1I2BD20,F8ERC7,S7VLM7,A0A1A5X8H4,A0A1I2T6Q1,A0A1R3T9N6,A0A0Q2M2Z1,H8KXJ0,D3S0S6,A0A2D1U4H7,I3TE64,A0A0B7I4Z6,A0LL61,Q8DKB1,A0A139WY18,A0A1J1EK56,A0A2T1E1K4,A0A1Q8ZD62,A0A4Q6XKV6,A0A1Z3HNN4,A0A239JE83,A0A2N4XBY2,Q53W94,R5JEI2,A0A0Q0ZC47,A0A2T0XH18,A0A1V4CHV0,A0A1K1RQP7,A0A2T1EKT1,A0A1N6LUI7,A0A0P0NGR6,A0A1X7IML5,A0A0A2LKJ7,K1L112,A0A0U3AL92,A0A1H3A054,E0UCX3,K9XZC6,B9LVW4,A0A0C1VHB4,Q31N05,A0A0C5JKF3,R5NJJ8,A5D4D9,Q2JI93,A0A142Y7A9,A0A432MEQ5,A0A372DKU2,A0A3R7KLK4,C1F5Q7,A0A4R3EV39,A0A1P8WP90,A0A222F7P0,A0A1C9VH88,A0A2T2YMB1,A0A329TD61,A0A101R2A0,A0A1E3XF49,A0A1U9ND56,A0A4R7BQC4,A0A1H3DGN3,A0A1Q1FPH0,E0TGY3,A0A259TUP4,F6EYI8,A0A2S9Q9J0,A0A4Q2UIU6,A0A1H0LH25,A0A318LG42,H1YCU5,L0JS08,A0A1Q5ZS75,A0A345E7N0,M0AF24,A0A1W2A082,A0A1H3X247,A0A0C1XUA0,M0D2X3,A0A2R5G167,A0A346PK63,R7RTW6,A0A1H2RBI2,A0A1C3ZXN2,B9LVP8,M5RSF0,W0JW77,B7K585,F8D8G0,A0A343TL88,L0AJX6,A0A2A5QS34,A0A343JEE2,A0A3P3RGE5,A0A329TBQ3,A0A285N2A8,A0A0W1S8B8,A0A1V4C8L7,L9VRQ2,E4NRV1,A0A1I6HGN0,A0A1I0NI68,,",366,37
"1225","C.H9.12","C.H9.8",362,181,181,3.90331491712707,"4F1N,4F3T,4KRE,5GUH,5VM9,6KR6,6OON,7KX7,7SWF,A0A163JTZ6,A0A0N4X8S8,A0A196SDB4,J9D5G4,Q389P5,C4LVV2,A0A2P6N8X7,A8BCK6,A2DPV7,A0A0G4H2S4,R1FDF0,D2VMG4,A0A074TLL7,A0A0D1ZAJ4,Q1K660,F4PH46,A0A3M7S814,A0A164ZA52,A0A383WDW5,Q54G64,S7WCF7,I0YVB2,R7QGN7,C1DZY0,A0A2C5Z0M1,A0CB11,R9ACY5,D3BMP8,A0A1Z5TVE5,W7XD45,A0A1U7LLR0,A0A4S2MWZ7,K1VVQ6,A0A158P1R9,G7DVX0,V6R0U9,G4N9J3,E3KLI3,B7Q5I1,A0A1E3QC61,D5GGK8,S8ANP9,A0A139AUH8,L2GMR6,U4LBG4,A0A177URI1,O74957,A0A3N4IGK1,A6N7Y9,A0A0E9NDK5,T1KZ60,A0A250WXN5,A0A2G8JLH3,Q5KAT1,L2GUF2,W2T741,A0A1W0E4B5,A0A2J7QB22,S4RYE2,A0A2K3CW87,A0A388KES6,A0A226EFL3,A0A3S3PD82,A0A0L0TEV1,A0A1S3J512,G0QTT2,A0A1J1HRI1,C4V9J2,Q9JMB7,A0A075AN09,Q5TW24,U5HIG6,A0A401PRI6,Q96J94,A0A2B4RHN2,G2QEV0,A0A397UU01,A0A2T7PFL8,K7ISV0,A0A024FT57,H3HCL6,A0A0G4IME3,E9FUN9,A0A1S3CYL5,D7FQK3,A0A1Y1YHC8,T1GSU4,F4S231,A0A1D8PMK0,A0A2G5B1D8,Q5BD61,A0A1C7M8P2,A0A4D8YSQ3,A0A158PJG6,J9JZ66,A0A0C2XG51,A0A158QZT6,A0A165QYQ9,T0SAU8,R7YY92,A0A3S1A0C3,A0A074YJ47,A0A2K1J482,A0A1Q3ENA6,O04379,A0A371I3C8,M8AEW7,A8P0D4,A0A2K3NY65,F4NYW7,A0A409Y6G2,A0A0L0HAB7,D8PZT7,A0A1D1W4K0,A7RQ46,W4YU94,A7BJS5,D8SNM6,A0A1J8PPA3,X1WG39,M5FQK2,Q69VD5,A0A2R6NSC2,A0A0D8XL16,A0A016WPN3,Q9QZ81,G5EES3,A0A0K0EFP6,Q8CJG0,A0A1D5NTU6,V2WTL2,A0A0V0YLH8,A0A139WDH0,A0A0R3W9Q7,H3DS31,A0A1Y1HWP2,G4T5G9,B7QCC4,A0A0B2UV00,M7BCJ9,E9GN30,Q7PZ41,A0A077Z361,R7U9I3,A0A1X7V1N5,A0A0K0JDP1,A0A0N4UKJ1,A0A498N3A3,A0A3M0IQP5,A0A0L8GBV4,Q32KD4,A0A1J1JBJ0,E0W4C3,A0A482XDA9,A0A3P7EJD6,J9K2Z4,A0A2J7Q8V4,T1IBM6,V3ZRX0,A0A210QKF7,A0A423TSS1,K1PT78,A0A267E8R7,A0A1D2N447,A0A226D7A9,F6YK55,T1KTE4,A0A2C9JGZ6,A0A1V9X9F0,K5X5Z7,A0A3Q0KUG5,T1FY40,1YVU,1Z26,3DLB,5AWH,5G5T,5I4A,6QZK,7R8K,A0A1I7IXT4,A0A2W1JZ37,A0A2S7WBN3,A0A328VKE4,A0A420DFE6,E0ST67,A0A4V1VDY2,A0A368P5I0,C4L1M1,A0A4R1RMM2,A0A1Y2RDH8,Q11QW7,A0A1M5ZSR3,A0A0K8QX04,A0A0M2PXX3,K9TPA9,A0A1L3JHM3,A0A1W6MIP2,A0A1C0UUC4,A0A2U2J9E0,A0A2Z6E1D5,A0A0F4NXW8,A0A142XB92,L8D0R3,B1XJG0,A0A326U7G5,A0A3D8L290,H1KXR6,A0A1Q4R485,K9U8J6,A0A097QRL6,K9RC91,A0A0D8ZUC0,A0A139XGN8,A0A1T4Y3A2,Q5P0R2,B6YTQ5,A0A0B0H9B4,A0YYT3,A0A2T1EFY0,G6FTN0,R6KUL9,A0A433NB65,A0A1Z4L0A1,K9UQR0,A0A2T1G8M7,K9VUN0,B7GJX9,A0A0P6X5X2,K9ZDE3,B0JXD6,A0A2T1LS63,A0A1Z4K1Y3,A0A2Z6E0R7,A0A1N6SSK9,A0A0P4UVI8,A0A0V7ZCG4,A0A1J0AGK2,K9PFF9,A0A2G9DT08,K9UEV4,Q9L1X1,A0A060HNJ0,A0A235B542,R5XQK4,A0A1H3LE92,A0A496APJ8,A0A062U2W9,H0HWQ5,A0A1V9G9U4,A0A1I2ZGP1,A0A317EJY3,A0A1I2BD20,F8ERC7,S7VLM7,A0A1A5X8H4,A0A1I2T6Q1,A0A1R3T9N6,A0A0Q2M2Z1,H8KXJ0,D3S0S6,A0A2D1U4H7,I3TE64,A0A0B7I4Z6,A0LL61,Q8DKB1,A0A139WY18,A0A1J1EK56,A0A2T1E1K4,A0A1Q8ZD62,A0A4Q6XKV6,A0A1Z3HNN4,A0A239JE83,A0A2N4XBY2,Q53W94,R5JEI2,A0A0Q0ZC47,A0A2T0XH18,A0A1V4CHV0,A0A1K1RQP7,A0A2T1EKT1,A0A1N6LUI7,A0A0P0NGR6,A0A1X7IML5,A0A0A2LKJ7,K1L112,A0A0U3AL92,A0A1H3A054,E0UCX3,K9XZC6,B9LVW4,A0A0C1VHB4,Q31N05,A0A0C5JKF3,R5NJJ8,A5D4D9,Q2JI93,A0A142Y7A9,A0A432MEQ5,A0A372DKU2,A0A3R7KLK4,C1F5Q7,A0A4R3EV39,A0A1P8WP90,A0A222F7P0,A0A1C9VH88,A0A2T2YMB1,A0A329TD61,A0A101R2A0,A0A1E3XF49,A0A1U9ND56,A0A4R7BQC4,A0A1H3DGN3,A0A1Q1FPH0,E0TGY3,A0A259TUP4,F6EYI8,A0A2S9Q9J0,A0A4Q2UIU6,A0A1H0LH25,A0A318LG42,H1YCU5,L0JS08,A0A1Q5ZS75,A0A345E7N0,M0AF24,A0A1W2A082,A0A1H3X247,A0A0C1XUA0,M0D2X3,A0A2R5G167,A0A346PK63,R7RTW6,A0A1H2RBI2,A0A1C3ZXN2,B9LVP8,M5RSF0,W0JW77,B7K585,F8D8G0,A0A343TL88,L0AJX6,A0A2A5QS34,A0A343JEE2,A0A3P3RGE5,A0A329TBQ3,A0A285N2A8,A0A0W1S8B8,A0A1V4C8L7,L9VRQ2,E4NRV1,A0A1I6HGN0,A0A1I0NI68,,",366,37
"1226","C.H9.12","C.L25.1",361,181,180,1.98611111111111,"4F1N,4F3T,4KRE,5GUH,5VM9,6KR6,6OON,7KX7,7SWF,A0A163JTZ6,A0A0N4X8S8,A0A196SDB4,J9D5G4,Q389P5,C4LVV2,A0A2P6N8X7,A8BCK6,A2DPV7,A0A0G4H2S4,R1FDF0,D2VMG4,A0A074TLL7,A0A0D1ZAJ4,Q1K660,F4PH46,A0A3M7S814,A0A164ZA52,A0A383WDW5,Q54G64,S7WCF7,I0YVB2,R7QGN7,C1DZY0,A0A2C5Z0M1,A0CB11,R9ACY5,D3BMP8,A0A1Z5TVE5,W7XD45,A0A1U7LLR0,A0A4S2MWZ7,K1VVQ6,A0A158P1R9,G7DVX0,V6R0U9,G4N9J3,E3KLI3,B7Q5I1,A0A1E3QC61,D5GGK8,S8ANP9,A0A139AUH8,L2GMR6,U4LBG4,A0A177URI1,O74957,A0A3N4IGK1,A6N7Y9,A0A0E9NDK5,T1KZ60,A0A250WXN5,A0A2G8JLH3,Q5KAT1,L2GUF2,W2T741,A0A1W0E4B5,A0A2J7QB22,S4RYE2,A0A2K3CW87,A0A388KES6,A0A226EFL3,A0A3S3PD82,A0A0L0TEV1,A0A1S3J512,G0QTT2,A0A1J1HRI1,C4V9J2,Q9JMB7,A0A075AN09,Q5TW24,U5HIG6,A0A401PRI6,Q96J94,A0A2B4RHN2,G2QEV0,A0A397UU01,A0A2T7PFL8,K7ISV0,A0A024FT57,H3HCL6,A0A0G4IME3,E9FUN9,A0A1S3CYL5,D7FQK3,A0A1Y1YHC8,T1GSU4,F4S231,A0A1D8PMK0,A0A2G5B1D8,Q5BD61,A0A1C7M8P2,A0A4D8YSQ3,A0A158PJG6,J9JZ66,A0A0C2XG51,A0A158QZT6,A0A165QYQ9,T0SAU8,R7YY92,A0A3S1A0C3,A0A074YJ47,A0A2K1J482,A0A1Q3ENA6,O04379,A0A371I3C8,M8AEW7,A8P0D4,A0A2K3NY65,F4NYW7,A0A409Y6G2,A0A0L0HAB7,D8PZT7,A0A1D1W4K0,A7RQ46,W4YU94,A7BJS5,D8SNM6,A0A1J8PPA3,X1WG39,M5FQK2,Q69VD5,A0A2R6NSC2,A0A0D8XL16,A0A016WPN3,Q9QZ81,G5EES3,A0A0K0EFP6,Q8CJG0,A0A1D5NTU6,V2WTL2,A0A0V0YLH8,A0A139WDH0,A0A0R3W9Q7,H3DS31,A0A1Y1HWP2,G4T5G9,B7QCC4,A0A0B2UV00,M7BCJ9,E9GN30,Q7PZ41,A0A077Z361,R7U9I3,A0A1X7V1N5,A0A0K0JDP1,A0A0N4UKJ1,A0A498N3A3,A0A3M0IQP5,A0A0L8GBV4,Q32KD4,A0A1J1JBJ0,E0W4C3,A0A482XDA9,A0A3P7EJD6,J9K2Z4,A0A2J7Q8V4,T1IBM6,V3ZRX0,A0A210QKF7,A0A423TSS1,K1PT78,A0A267E8R7,A0A1D2N447,A0A226D7A9,F6YK55,T1KTE4,A0A2C9JGZ6,A0A1V9X9F0,K5X5Z7,A0A3Q0KUG5,T1FY40,1YVU,1Z26,3DLB,5AWH,5G5T,5I4A,6QZK,7R8K,A0A1I7IXT4,A0A2W1JZ37,A0A2S7WBN3,A0A328VKE4,A0A420DFE6,E0ST67,A0A4V1VDY2,A0A368P5I0,C4L1M1,A0A4R1RMM2,A0A1Y2RDH8,Q11QW7,A0A1M5ZSR3,A0A0K8QX04,A0A0M2PXX3,K9TPA9,A0A1L3JHM3,A0A1W6MIP2,A0A1C0UUC4,A0A2U2J9E0,A0A2Z6E1D5,A0A0F4NXW8,A0A142XB92,L8D0R3,B1XJG0,A0A326U7G5,A0A3D8L290,H1KXR6,A0A1Q4R485,K9U8J6,A0A097QRL6,K9RC91,A0A0D8ZUC0,A0A139XGN8,A0A1T4Y3A2,Q5P0R2,B6YTQ5,A0A0B0H9B4,A0YYT3,A0A2T1EFY0,G6FTN0,R6KUL9,A0A433NB65,A0A1Z4L0A1,K9UQR0,A0A2T1G8M7,K9VUN0,B7GJX9,K9ZDE3,B0JXD6,A0A2T1LS63,A0A1Z4K1Y3,A0A2Z6E0R7,A0A1N6SSK9,A0A0P4UVI8,A0A0V7ZCG4,A0A1J0AGK2,K9PFF9,A0A2G9DT08,K9UEV4,Q9L1X1,A0A060HNJ0,A0A235B542,R5XQK4,A0A1H3LE92,A0A496APJ8,A0A062U2W9,H0HWQ5,A0A1V9G9U4,A0A1I2ZGP1,A0A317EJY3,A0A1I2BD20,F8ERC7,S7VLM7,A0A1A5X8H4,A0A1I2T6Q1,A0A1R3T9N6,A0A0Q2M2Z1,H8KXJ0,D3S0S6,A0A2D1U4H7,I3TE64,A0A0B7I4Z6,A0LL61,Q8DKB1,A0A139WY18,A0A1J1EK56,A0A2T1E1K4,A0A1Q8ZD62,A0A4Q6XKV6,A0A1Z3HNN4,A0A239JE83,A0A2N4XBY2,Q53W94,R5JEI2,A0A0Q0ZC47,A0A2T0XH18,A0A1V4CHV0,A0A1K1RQP7,A0A2T1EKT1,A0A1N6LUI7,A0A0P0NGR6,A0A1X7IML5,A0A0A2LKJ7,K1L112,A0A0U3AL92,A0A1H3A054,E0UCX3,K9XZC6,B9LVW4,A0A0C1VHB4,Q31N05,A0A0C5JKF3,R5NJJ8,A5D4D9,Q2JI93,A0A142Y7A9,A0A432MEQ5,A0A372DKU2,A0A3R7KLK4,C1F5Q7,A0A4R3EV39,A0A1P8WP90,A0A222F7P0,A0A1C9VH88,A0A2T2YMB1,A0A329TD61,A0A101R2A0,A0A1E3XF49,A0A1U9ND56,A0A4R7BQC4,A0A1H3DGN3,A0A1Q1FPH0,E0TGY3,A0A259TUP4,F6EYI8,A0A2S9Q9J0,A0A4Q2UIU6,A0A1H0LH25,A0A318LG42,H1YCU5,L0JS08,A0A1Q5ZS75,A0A345E7N0,M0AF24,A0A1W2A082,A0A1H3X247,A0A0C1XUA0,M0D2X3,A0A2R5G167,A0A346PK63,R7RTW6,A0A1H2RBI2,A0A1C3ZXN2,B9LVP8,M5RSF0,W0JW77,B7K585,F8D8G0,A0A343TL88,L0AJX6,A0A2A5QS34,A0A343JEE2,A0A3P3RGE5,A0A329TBQ3,A0A285N2A8,A0A0W1S8B8,A0A1V4C8L7,L9VRQ2,E4NRV1,A0A1I6HGN0,A0A1I0NI68,,",366,37
"1230","C.S5.4","C.S6.3",358,181,177,1.17389268658114,"4F1N,4F3T,4KRE,5GUH,5VM9,6KR6,6OON,7KX7,7SWF,A0A163JTZ6,A0A0N4X8S8,A0A196SDB4,J9D5G4,Q389P5,C4LVV2,A0A2P6N8X7,A8BCK6,A2DPV7,A0A0G4H2S4,T1H8B3,S4RWI0,D2VMG4,A0A074TLL7,A0A0D1ZAJ4,Q1K660,F4PH46,A0A3M7S814,A0A164ZA52,A0A383WDW5,Q54G64,S7WCF7,I0YVB2,R7QGN7,C1DZY0,A0A2C5Z0M1,A0CB11,R9ACY5,D3BMP8,A0A1Z5TVE5,W7XD45,A0A1U7LLR0,A0A4S2MWZ7,K1VVQ6,A0A158P1R9,G7DVX0,V6R0U9,G4N9J3,E3KLI3,B7Q5I1,A0A1E3QC61,D5GGK8,S8ANP9,A0A139AUH8,L2GMR6,U4LBG4,A0A177URI1,O74957,A0A3N4IGK1,A6N7Y9,A0A0E9NDK5,T1KZ60,A0A250WXN5,A0A2G8JLH3,Q5KAT1,L2GUF2,W2T741,A0A1W0E4B5,A0A2J7QB22,S4RYE2,A0A2K3CW87,A0A388KES6,A0A226EFL3,A0A3S3PD82,A0A0L0TEV1,A0A1S3J512,G0QTT2,A0A1J1HRI1,C4V9J2,Q9JMB7,A0A075AN09,Q5TW24,U5HIG6,A0A401PRI6,Q96J94,A0A2B4RHN2,G2QEV0,A0A397UU01,A0A2T7PFL8,K7ISV0,A0A024FT57,H3HCL6,A0A0G4IME3,E9FUN9,A0A1S3CYL5,D7FQK3,A0A1Y1YHC8,F4S231,A0A1D8PMK0,A0A2G5B1D8,Q5BD61,A0A1C7M8P2,A0A4D8YSQ3,A0A158PJG6,J9JZ66,A0A0C2XG51,A0A158QZT6,A0A165QYQ9,T0SAU8,R7YY92,A0A3S1A0C3,A0A074YJ47,A0A2K1J482,A0A1Q3ENA6,O04379,A0A371I3C8,M8AEW7,A8P0D4,A0A2K3NY65,F4NYW7,A0A409Y6G2,A0A0L0HAB7,D8PZT7,A0A1D1W4K0,A7RQ46,W4YU94,A7BJS5,D8SNM6,A0A1J8PPA3,X1WG39,M5FQK2,Q69VD5,A0A2R6NSC2,A0A0D8XL16,A0A016WPN3,Q9QZ81,G5EES3,A0A0K0EFP6,Q8CJG0,A0A1D5NTU6,V2WTL2,A0A0V0YLH8,A0A139WDH0,A0A0R3W9Q7,H3DS31,A0A1Y1HWP2,G4T5G9,B7QCC4,A0A0B2UV00,M7BCJ9,E9GN30,Q7PZ41,A0A077Z361,R7U9I3,A0A1X7V1N5,A0A0K0JDP1,A0A0N4UKJ1,A0A498N3A3,A0A3M0IQP5,A0A0L8GBV4,Q32KD4,A0A1J1JBJ0,E0W4C3,A0A482XDA9,A0A3P7EJD6,J9K2Z4,A0A2J7Q8V4,T1IBM6,V3ZRX0,A0A210QKF7,A0A423TSS1,K1PT78,A0A267E8R7,A0A1D2N447,A0A226D7A9,F6YK55,T1KTE4,A0A2C9JGZ6,A0A1V9X9F0,K5X5Z7,A0A3Q0KUG5,T1FY40,1YVU,1Z26,3DLB,5AWH,5G5T,5I4A,7R8K,E8N0K8,A0A1I7IXT4,A0A2W1JZ37,A0A2S7WBN3,A0A328VKE4,A0A420DFE6,E0ST67,A0A4V1VDY2,A0A368P5I0,C4L1M1,A0A4R1RMM2,A0A1Y2RDH8,Q11QW7,A0A1M5ZSR3,A0A0K8QX04,A0A0M2PXX3,A0A1I3LMA1,K9TPA9,A0A1L3JHM3,A0A1W6MIP2,A0A1C0UUC4,A0A2U2J9E0,A0A2Z6E1D5,A0A0F4NXW8,A0A142XB92,L8D0R3,B1XJG0,A0A326U7G5,A0A3D8L290,H1KXR6,A0A1Q4R485,K9U8J6,K9RC91,A0A0D8ZUC0,A0A139XGN8,A0A1T4Y3A2,Q5P0R2,A0A0B0H9B4,A0YYT3,A0A2T1EFY0,G6FTN0,R6KUL9,A0A433NB65,A0A1Z4L0A1,K9UQR0,A0A2T1G8M7,K9VUN0,B7GJX9,A0A0P6X5X2,K9ZDE3,B0JXD6,A0A2T1LS63,A0A1Z4K1Y3,A0A2Z6E0R7,A0A1N6SSK9,A0A0P4UVI8,A0A0V7ZCG4,A0A1J0AGK2,K9PFF9,A0A2G9DT08,K9UEV4,Q9L1X1,A0A060HNJ0,A0A235B542,R5XQK4,A0A1H3LE92,A0A496APJ8,A0A062U2W9,H0HWQ5,A0A1V9G9U4,A0A1I2ZGP1,A0A317EJY3,A0A1I2BD20,F8ERC7,S7VLM7,A0A1A5X8H4,A0A1I2T6Q1,A0A1R3T9N6,A0A0Q2M2Z1,H8KXJ0,D3S0S6,A0A2D1U4H7,I3TE64,A0A0B7I4Z6,A0LL61,Q8DKB1,A0A139WY18,A0A1J1EK56,A0A2T1E1K4,A0A1Q8ZD62,A0A4Q6XKV6,A0A1Z3HNN4,A0A239JE83,A0A2N4XBY2,Q53W94,R5JEI2,A0A0Q0ZC47,A0A2T0XH18,A0A1V4CHV0,A0A1K1RQP7,A0A2T1EKT1,A0A1N6LUI7,A0A0P0NGR6,A0A1X7IML5,A0A0A2LKJ7,K1L112,A0A0U3AL92,A0A1H3A054,E0UCX3,K9XZC6,A0A0C1VHB4,Q31N05,A0A0C5JKF3,R5NJJ8,A5D4D9,Q2JI93,A0A142Y7A9,A0A432MEQ5,A0A372DKU2,A0A3R7KLK4,C1F5Q7,A0A4R3EV39,A0A1P8WP90,A0A222F7P0,A0A1C9VH88,A0A2T2YMB1,A0A101R2A0,A0A1E3XF49,A0A1U9ND56,A0A4R7BQC4,A0A1H3DGN3,A0A1Q1FPH0,E0TGY3,A0A259TUP4,F6EYI8,A0A2S9Q9J0,A0A4Q2UIU6,A0A1H0LH25,A0A318LG42,H1YCU5,L0JS08,A0A1Q5ZS75,M0AF24,A0A1W2A082,A0A1H3X247,A0A0C1XUA0,M0D2X3,A0A2R5G167,A0A346PK63,R7RTW6,A0A1H2RBI2,A0A1C3ZXN2,B9LVP8,M5RSF0,W0JW77,B7K585,F8D8G0,A0A343TL88,L0AJX6,A0A2A5QS34,A0A343JEE2,A0A3P3RGE5,A0A329TBQ3,A0A285N2A8,A0A0W1S8B8,A0A1V4C8L7,L9VRQ2,E4NRV1,A0A1I6HGN0,A0A1I0NI68,,",366,37
"1232","C.S8.4","C.S9.6",336,181,155,2.62111923008376,"4F1N,4F3T,4KRE,5GUH,5VM9,6KR6,6OON,7KX7,7SWF,A0A163JTZ6,A0A0N4X8S8,A0A196SDB4,J9D5G4,C4LVV2,A8BCK6,A2DPV7,A0A0G4H2S4,T1H8B3,R1FDF0,S4RWI0,D2VMG4,A0A074TLL7,A0A0D1ZAJ4,Q1K660,F4PH46,A0A3M7S814,A0A164ZA52,A0A383WDW5,Q54G64,S7WCF7,I0YVB2,R7QGN7,C1DZY0,A0A2C5Z0M1,A0CB11,R9ACY5,D3BMP8,A0A1Z5TVE5,W7XD45,A0A1U7LLR0,A0A4S2MWZ7,K1VVQ6,A0A158P1R9,G7DVX0,V6R0U9,G4N9J3,E3KLI3,B7Q5I1,A0A1E3QC61,D5GGK8,S8ANP9,A0A139AUH8,L2GMR6,U4LBG4,A0A177URI1,O74957,A0A3N4IGK1,A6N7Y9,A0A0E9NDK5,T1KZ60,A0A250WXN5,A0A2G8JLH3,Q5KAT1,L2GUF2,W2T741,A0A1W0E4B5,A0A2J7QB22,S4RYE2,A0A2K3CW87,A0A388KES6,A0A226EFL3,A0A3S3PD82,A0A0L0TEV1,A0A1S3J512,G0QTT2,A0A1J1HRI1,C4V9J2,Q9JMB7,A0A075AN09,Q5TW24,U5HIG6,A0A401PRI6,Q96J94,A0A2B4RHN2,G2QEV0,A0A397UU01,A0A2T7PFL8,K7ISV0,A0A024FT57,H3HCL6,A0A0G4IME3,E9FUN9,A0A1S3CYL5,D7FQK3,A0A1Y1YHC8,T1GSU4,F4S231,A0A1D8PMK0,A0A2G5B1D8,Q5BD61,A0A1C7M8P2,A0A4D8YSQ3,A0A158PJG6,J9JZ66,A0A0C2XG51,A0A158QZT6,A0A165QYQ9,T0SAU8,R7YY92,A0A3S1A0C3,A0A074YJ47,A0A2K1J482,A0A1Q3ENA6,O04379,A0A371I3C8,M8AEW7,A8P0D4,A0A2K3NY65,F4NYW7,A0A409Y6G2,A0A0L0HAB7,D8PZT7,A0A1D1W4K0,A7RQ46,W4YU94,A7BJS5,D8SNM6,A0A1J8PPA3,X1WG39,M5FQK2,Q69VD5,A0A2R6NSC2,A0A0D8XL16,A0A016WPN3,Q9QZ81,G5EES3,A0A0K0EFP6,Q8CJG0,A0A1D5NTU6,V2WTL2,A0A0V0YLH8,A0A139WDH0,A0A0R3W9Q7,H3DS31,A0A1Y1HWP2,G4T5G9,B7QCC4,A0A0B2UV00,M7BCJ9,E9GN30,Q7PZ41,A0A077Z361,R7U9I3,A0A1X7V1N5,A0A0K0JDP1,A0A0N4UKJ1,A0A498N3A3,A0A3M0IQP5,A0A0L8GBV4,Q32KD4,A0A1J1JBJ0,E0W4C3,A0A482XDA9,A0A3P7EJD6,J9K2Z4,A0A2J7Q8V4,T1IBM6,V3ZRX0,A0A210QKF7,A0A423TSS1,K1PT78,A0A267E8R7,A0A1D2N447,A0A226D7A9,F6YK55,T1KTE4,A0A2C9JGZ6,A0A1V9X9F0,K5X5Z7,A0A3Q0KUG5,T1FY40,1YVU,1Z26,3DLB,5AWH,5G5T,5I4A,6QZK,7R8K,E8N0K8,A0A1I7IXT4,A0A2W1JZ37,A0A2S7WBN3,A0A328VKE4,A0A420DFE6,A0A4V1VDY2,A0A368P5I0,A0A4R1RMM2,A0A1Y2RDH8,Q11QW7,A0A1M5ZSR3,A0A0K8QX04,K9TPA9,A0A1L3JHM3,A0A1W6MIP2,A0A2U2J9E0,A0A2Z6E1D5,B1XJG0,A0A326U7G5,A0A3D8L290,A0A1Q4R485,K9U8J6,A0A097QRL6,K9RC91,A0A0D8ZUC0,A0A139XGN8,A0A1T4Y3A2,B6YTQ5,A0A0B0H9B4,A0YYT3,A0A2T1EFY0,G6FTN0,A0A433NB65,A0A1Z4L0A1,K9UQR0,A0A2T1G8M7,K9VUN0,A0A0P6X5X2,K9ZDE3,B0JXD6,A0A2T1LS63,A0A1Z4K1Y3,A0A2Z6E0R7,A0A1N6SSK9,A0A0P4UVI8,A0A0V7ZCG4,A0A1J0AGK2,K9PFF9,A0A2G9DT08,K9UEV4,Q9L1X1,A0A060HNJ0,A0A1H3LE92,A0A496APJ8,A0A062U2W9,H0HWQ5,A0A1V9G9U4,A0A1I2ZGP1,A0A317EJY3,A0A1I2BD20,F8ERC7,S7VLM7,A0A1A5X8H4,A0A1I2T6Q1,A0A1R3T9N6,A0A0Q2M2Z1,H8KXJ0,D3S0S6,A0A2D1U4H7,I3TE64,A0A0B7I4Z6,A0LL61,Q8DKB1,A0A139WY18,A0A1J1EK56,A0A2T1E1K4,A0A1Q8ZD62,A0A4Q6XKV6,A0A1Z3HNN4,A0A239JE83,A0A2N4XBY2,Q53W94,R5JEI2,A0A2T0XH18,A0A1V4CHV0,A0A1K1RQP7,A0A2T1EKT1,A0A1N6LUI7,A0A1X7IML5,A0A0A2LKJ7,K1L112,A0A0U3AL92,E0UCX3,K9XZC6,A0A0C1VHB4,Q31N05,A0A0C5JKF3,A5D4D9,Q2JI93,A0A142Y7A9,A0A372DKU2,A0A3R7KLK4,C1F5Q7,A0A1P8WP90,A0A1C9VH88,A0A2T2YMB1,A0A329TD61,A0A101R2A0,A0A1E3XF49,A0A1U9ND56,A0A4R7BQC4,A0A1Q1FPH0,A0A259TUP4,A0A4Q2UIU6,A0A1H0LH25,A0A318LG42,H1YCU5,L0JS08,A0A1Q5ZS75,A0A345E7N0,M0AF24,A0A1W2A082,A0A1H3X247,A0A0C1XUA0,M0D2X3,A0A2R5G167,A0A346PK63,A0A1H2RBI2,A0A1C3ZXN2,B9LVP8,M5RSF0,W0JW77,B7K585,F8D8G0,A0A343TL88,L0AJX6,A0A2A5QS34,A0A3P3RGE5,A0A329TBQ3,A0A285N2A8,A0A0W1S8B8,A0A1V4C8L7,L9VRQ2,E4NRV1,A0A1I6HGN0,A0A1I0NI68,,",366,37
"1233","C.S8.5","C.S9.6",339,181,158,3.38208965661934,"4F1N,4F3T,4KRE,5GUH,5VM9,6KR6,6OON,7KX7,7SWF,A0A163JTZ6,A0A0N4X8S8,A0A196SDB4,J9D5G4,C4LVV2,A8BCK6,A2DPV7,A0A0G4H2S4,T1H8B3,R1FDF0,S4RWI0,D2VMG4,A0A074TLL7,A0A0D1ZAJ4,Q1K660,F4PH46,A0A3M7S814,A0A164ZA52,A0A383WDW5,Q54G64,S7WCF7,I0YVB2,R7QGN7,C1DZY0,A0A2C5Z0M1,A0CB11,R9ACY5,D3BMP8,A0A1Z5TVE5,W7XD45,A0A1U7LLR0,A0A4S2MWZ7,K1VVQ6,A0A158P1R9,G7DVX0,V6R0U9,G4N9J3,E3KLI3,B7Q5I1,A0A1E3QC61,D5GGK8,S8ANP9,A0A139AUH8,L2GMR6,U4LBG4,A0A177URI1,O74957,A0A3N4IGK1,A6N7Y9,A0A0E9NDK5,T1KZ60,A0A250WXN5,A0A2G8JLH3,Q5KAT1,L2GUF2,W2T741,A0A1W0E4B5,A0A2J7QB22,S4RYE2,A0A2K3CW87,A0A388KES6,A0A226EFL3,A0A3S3PD82,A0A0L0TEV1,A0A1S3J512,G0QTT2,A0A1J1HRI1,C4V9J2,Q9JMB7,A0A075AN09,Q5TW24,U5HIG6,A0A401PRI6,Q96J94,A0A2B4RHN2,G2QEV0,A0A397UU01,A0A2T7PFL8,K7ISV0,A0A024FT57,H3HCL6,A0A0G4IME3,E9FUN9,A0A1S3CYL5,D7FQK3,A0A1Y1YHC8,T1GSU4,F4S231,A0A1D8PMK0,A0A2G5B1D8,Q5BD61,A0A1C7M8P2,A0A4D8YSQ3,A0A158PJG6,J9JZ66,A0A0C2XG51,A0A158QZT6,A0A165QYQ9,T0SAU8,R7YY92,A0A3S1A0C3,A0A074YJ47,A0A2K1J482,A0A1Q3ENA6,O04379,A0A371I3C8,M8AEW7,A8P0D4,A0A2K3NY65,F4NYW7,A0A409Y6G2,A0A0L0HAB7,D8PZT7,A0A1D1W4K0,A7RQ46,W4YU94,A7BJS5,D8SNM6,A0A1J8PPA3,X1WG39,M5FQK2,Q69VD5,A0A2R6NSC2,A0A0D8XL16,A0A016WPN3,Q9QZ81,G5EES3,A0A0K0EFP6,Q8CJG0,A0A1D5NTU6,V2WTL2,A0A0V0YLH8,A0A139WDH0,A0A0R3W9Q7,H3DS31,A0A1Y1HWP2,G4T5G9,B7QCC4,A0A0B2UV00,M7BCJ9,E9GN30,Q7PZ41,A0A077Z361,R7U9I3,A0A1X7V1N5,A0A0K0JDP1,A0A0N4UKJ1,A0A498N3A3,A0A3M0IQP5,A0A0L8GBV4,Q32KD4,A0A1J1JBJ0,E0W4C3,A0A482XDA9,A0A3P7EJD6,J9K2Z4,A0A2J7Q8V4,T1IBM6,V3ZRX0,A0A210QKF7,A0A423TSS1,K1PT78,A0A267E8R7,A0A1D2N447,A0A226D7A9,F6YK55,T1KTE4,A0A2C9JGZ6,A0A1V9X9F0,K5X5Z7,A0A3Q0KUG5,T1FY40,1YVU,1Z26,3DLB,5AWH,5G5T,5I4A,6QZK,7R8K,E8N0K8,A0A1I7IXT4,A0A2W1JZ37,A0A2S7WBN3,A0A328VKE4,A0A420DFE6,E0ST67,A0A4V1VDY2,A0A368P5I0,C4L1M1,A0A4R1RMM2,A0A1Y2RDH8,Q11QW7,A0A1M5ZSR3,A0A0K8QX04,A0A1L3JHM3,A0A1W6MIP2,A0A1C0UUC4,A0A2U2J9E0,A0A2Z6E1D5,B1XJG0,A0A326U7G5,A0A3D8L290,H1KXR6,A0A1Q4R485,K9U8J6,A0A097QRL6,K9RC91,A0A0D8ZUC0,A0A139XGN8,A0A1T4Y3A2,B6YTQ5,A0A0B0H9B4,A0A2T1EFY0,G6FTN0,A0A1Z4L0A1,K9UQR0,A0A2T1G8M7,K9VUN0,A0A0P6X5X2,K9ZDE3,A0A1Z4K1Y3,A0A2Z6E0R7,A0A1N6SSK9,A0A0P4UVI8,A0A0V7ZCG4,A0A1J0AGK2,K9PFF9,A0A2G9DT08,K9UEV4,Q9L1X1,A0A060HNJ0,A0A1H3LE92,A0A496APJ8,A0A062U2W9,H0HWQ5,A0A1V9G9U4,A0A1I2ZGP1,A0A317EJY3,A0A1I2BD20,F8ERC7,S7VLM7,A0A1A5X8H4,A0A1I2T6Q1,A0A1R3T9N6,A0A0Q2M2Z1,H8KXJ0,D3S0S6,A0A2D1U4H7,I3TE64,A0A0B7I4Z6,A0LL61,Q8DKB1,A0A139WY18,A0A1J1EK56,A0A2T1E1K4,A0A1Q8ZD62,A0A4Q6XKV6,A0A1Z3HNN4,A0A239JE83,A0A2N4XBY2,Q53W94,R5JEI2,A0A2T0XH18,A0A1V4CHV0,A0A1K1RQP7,A0A2T1EKT1,A0A1N6LUI7,A0A1X7IML5,A0A0A2LKJ7,K1L112,A0A0U3AL92,E0UCX3,K9XZC6,A0A0C1VHB4,Q31N05,A0A0C5JKF3,R5NJJ8,A5D4D9,Q2JI93,A0A142Y7A9,A0A372DKU2,A0A3R7KLK4,C1F5Q7,A0A1P8WP90,A0A1C9VH88,A0A2T2YMB1,A0A329TD61,A0A101R2A0,A0A1E3XF49,A0A1U9ND56,A0A4R7BQC4,A0A1H3DGN3,A0A1Q1FPH0,A0A259TUP4,A0A4Q2UIU6,A0A1H0LH25,A0A318LG42,H1YCU5,L0JS08,A0A1Q5ZS75,A0A345E7N0,M0AF24,A0A1W2A082,A0A1H3X247,A0A0C1XUA0,M0D2X3,A0A2R5G167,A0A346PK63,R7RTW6,A0A1H2RBI2,A0A1C3ZXN2,B9LVP8,M5RSF0,W0JW77,B7K585,F8D8G0,A0A343TL88,L0AJX6,A0A2A5QS34,A0A343JEE2,A0A3P3RGE5,A0A329TBQ3,A0A285N2A8,A0A0W1S8B8,A0A1V4C8L7,L9VRQ2,E4NRV1,A0A1I6HGN0,A0A1I0NI68,,",366,37
"1235","C.S8.7","C.S9.4",267,181,86,3.14126943338044,"4F1N,4F3T,4KRE,5GUH,5VM9,6KR6,6OON,7KX7,7SWF,A0A163JTZ6,A0A0N4X8S8,A0A196SDB4,J9D5G4,C4LVV2,A8BCK6,A2DPV7,A0A0G4H2S4,T1H8B3,R1FDF0,S4RWI0,D2VMG4,A0A074TLL7,A0A0D1ZAJ4,Q1K660,F4PH46,A0A3M7S814,A0A164ZA52,A0A383WDW5,Q54G64,S7WCF7,I0YVB2,R7QGN7,C1DZY0,A0A2C5Z0M1,A0CB11,R9ACY5,D3BMP8,A0A1Z5TVE5,W7XD45,A0A1U7LLR0,A0A4S2MWZ7,K1VVQ6,A0A158P1R9,G7DVX0,V6R0U9,G4N9J3,E3KLI3,B7Q5I1,A0A1E3QC61,D5GGK8,S8ANP9,A0A139AUH8,L2GMR6,U4LBG4,A0A177URI1,O74957,A0A3N4IGK1,A6N7Y9,A0A0E9NDK5,T1KZ60,A0A250WXN5,A0A2G8JLH3,Q5KAT1,L2GUF2,W2T741,A0A1W0E4B5,A0A2J7QB22,S4RYE2,A0A2K3CW87,A0A388KES6,A0A226EFL3,A0A3S3PD82,A0A0L0TEV1,A0A1S3J512,G0QTT2,A0A1J1HRI1,C4V9J2,Q9JMB7,A0A075AN09,Q5TW24,U5HIG6,A0A401PRI6,Q96J94,A0A2B4RHN2,G2QEV0,A0A397UU01,A0A2T7PFL8,K7ISV0,A0A024FT57,H3HCL6,A0A0G4IME3,E9FUN9,A0A1S3CYL5,D7FQK3,A0A1Y1YHC8,T1GSU4,F4S231,A0A1D8PMK0,A0A2G5B1D8,Q5BD61,A0A1C7M8P2,A0A4D8YSQ3,A0A158PJG6,J9JZ66,A0A0C2XG51,A0A158QZT6,A0A165QYQ9,T0SAU8,R7YY92,A0A3S1A0C3,A0A074YJ47,A0A2K1J482,A0A1Q3ENA6,O04379,A0A371I3C8,M8AEW7,A8P0D4,A0A2K3NY65,F4NYW7,A0A409Y6G2,A0A0L0HAB7,D8PZT7,A0A1D1W4K0,A7RQ46,W4YU94,A7BJS5,D8SNM6,A0A1J8PPA3,X1WG39,M5FQK2,Q69VD5,A0A2R6NSC2,A0A0D8XL16,A0A016WPN3,Q9QZ81,G5EES3,A0A0K0EFP6,Q8CJG0,A0A1D5NTU6,V2WTL2,A0A0V0YLH8,A0A139WDH0,A0A0R3W9Q7,H3DS31,A0A1Y1HWP2,G4T5G9,B7QCC4,A0A0B2UV00,M7BCJ9,E9GN30,Q7PZ41,A0A077Z361,R7U9I3,A0A1X7V1N5,A0A0K0JDP1,A0A0N4UKJ1,A0A498N3A3,A0A3M0IQP5,A0A0L8GBV4,Q32KD4,A0A1J1JBJ0,E0W4C3,A0A482XDA9,A0A3P7EJD6,J9K2Z4,A0A2J7Q8V4,T1IBM6,V3ZRX0,A0A210QKF7,A0A423TSS1,K1PT78,A0A267E8R7,A0A1D2N447,A0A226D7A9,F6YK55,T1KTE4,A0A2C9JGZ6,A0A1V9X9F0,K5X5Z7,A0A3Q0KUG5,T1FY40,1YVU,1Z26,3DLB,5AWH,5G5T,5I4A,6QZK,7R8K,E8N0K8,A0A328VKE4,E0ST67,A0A1M5ZSR3,A0A0K8QX04,K9TPA9,A0A1W6MIP2,A0A2U2J9E0,B1XJG0,A0A326U7G5,A0A3D8L290,A0A1Q4R485,K9U8J6,A0A097QRL6,K9RC91,A0A0D8ZUC0,A0A139XGN8,A0A1T4Y3A2,B6YTQ5,A0A2T1EFY0,G6FTN0,A0A1Z4L0A1,K9UQR0,A0A2T1G8M7,K9VUN0,K9ZDE3,A0A1Z4K1Y3,A0A0P4UVI8,A0A0V7ZCG4,K9PFF9,K9UEV4,A0A060HNJ0,A0A496APJ8,A0A062U2W9,H0HWQ5,A0A1V9G9U4,A0A1I2ZGP1,A0A317EJY3,A0A1I2BD20,F8ERC7,A0A0Q2M2Z1,I3TE64,A0A139WY18,A0A2T1E1K4,A0A1Q8ZD62,A0A1Z3HNN4,Q53W94,E0UCX3,K9XZC6,A0A0C1VHB4,A5D4D9,A0A329TD61,A0A1E3XF49,A0A1Q1FPH0,A0A4Q2UIU6,H1YCU5,L0JS08,A0A1Q5ZS75,A0A345E7N0,M0AF24,A0A1W2A082,A0A1H3X247,A0A0C1XUA0,A0A2R5G167,A0A346PK63,A0A1H2RBI2,A0A1C3ZXN2,B9LVP8,M5RSF0,A0A343TL88,A0A3P3RGE5,A0A329TBQ3,A0A285N2A8,A0A0W1S8B8,A0A1V4C8L7,L9VRQ2,E4NRV1,A0A1I6HGN0,,",366,37
"1237","N.H4.2","N.H4.5",332,181,151,3.80300757381728,"4F1N,4F3T,4KRE,5GUH,5VM9,6KR6,6OON,7KX7,7SWF,A0A163JTZ6,A0A0N4X8S8,A0A196SDB4,J9D5G4,C4LVV2,A0A2P6N8X7,A8BCK6,A2DPV7,A0A0G4H2S4,T1H8B3,R1FDF0,S4RWI0,D2VMG4,A0A074TLL7,A0A0D1ZAJ4,Q1K660,F4PH46,A0A3M7S814,A0A164ZA52,A0A383WDW5,Q54G64,S7WCF7,I0YVB2,R7QGN7,C1DZY0,A0A2C5Z0M1,A0CB11,R9ACY5,D3BMP8,A0A1Z5TVE5,W7XD45,A0A1U7LLR0,A0A4S2MWZ7,K1VVQ6,A0A158P1R9,G7DVX0,V6R0U9,G4N9J3,E3KLI3,B7Q5I1,A0A1E3QC61,D5GGK8,S8ANP9,A0A139AUH8,L2GMR6,U4LBG4,A0A177URI1,O74957,A0A3N4IGK1,A6N7Y9,A0A0E9NDK5,T1KZ60,A0A250WXN5,A0A2G8JLH3,Q5KAT1,L2GUF2,W2T741,A0A1W0E4B5,A0A2J7QB22,S4RYE2,A0A2K3CW87,A0A388KES6,A0A226EFL3,A0A3S3PD82,A0A0L0TEV1,A0A1S3J512,G0QTT2,A0A1J1HRI1,C4V9J2,Q9JMB7,A0A075AN09,Q5TW24,U5HIG6,A0A401PRI6,Q96J94,A0A2B4RHN2,G2QEV0,A0A397UU01,A0A2T7PFL8,K7ISV0,A0A024FT57,H3HCL6,E9FUN9,A0A1S3CYL5,D7FQK3,A0A1Y1YHC8,T1GSU4,F4S231,A0A1D8PMK0,A0A2G5B1D8,Q5BD61,A0A1C7M8P2,A0A4D8YSQ3,A0A158PJG6,J9JZ66,A0A0C2XG51,A0A158QZT6,A0A165QYQ9,T0SAU8,R7YY92,A0A3S1A0C3,A0A074YJ47,A0A2K1J482,A0A1Q3ENA6,O04379,A0A371I3C8,M8AEW7,A8P0D4,A0A2K3NY65,F4NYW7,A0A409Y6G2,A0A0L0HAB7,D8PZT7,A0A1D1W4K0,A7RQ46,W4YU94,A7BJS5,D8SNM6,A0A1J8PPA3,X1WG39,M5FQK2,Q69VD5,A0A2R6NSC2,A0A0D8XL16,A0A016WPN3,Q9QZ81,G5EES3,A0A0K0EFP6,Q8CJG0,A0A1D5NTU6,V2WTL2,A0A0V0YLH8,A0A139WDH0,A0A0R3W9Q7,H3DS31,A0A1Y1HWP2,G4T5G9,B7QCC4,A0A0B2UV00,M7BCJ9,E9GN30,Q7PZ41,A0A077Z361,R7U9I3,A0A1X7V1N5,A0A0K0JDP1,A0A0N4UKJ1,A0A498N3A3,A0A3M0IQP5,A0A0L8GBV4,Q32KD4,A0A1J1JBJ0,E0W4C3,A0A482XDA9,A0A3P7EJD6,J9K2Z4,A0A2J7Q8V4,T1IBM6,V3ZRX0,A0A210QKF7,A0A423TSS1,K1PT78,A0A267E8R7,A0A1D2N447,A0A226D7A9,F6YK55,T1KTE4,A0A2C9JGZ6,A0A1V9X9F0,K5X5Z7,A0A3Q0KUG5,T1FY40,1YVU,1Z26,5AWH,5G5T,5I4A,6QZK,E8N0K8,A0A328VKE4,E0ST67,C4L1M1,A0A0M2PXX3,A0A1I3LMA1,K9TPA9,A0A1C0UUC4,A0A142XB92,B1XJG0,H1KXR6,A0A1Q4R485,K9U8J6,A0A097QRL6,K9RC91,A0A0D8ZUC0,A0A139XGN8,A0A1T4Y3A2,B6YTQ5,A0A0B0H9B4,A0YYT3,A0A2T1EFY0,G6FTN0,R6KUL9,A0A433NB65,A0A1Z4L0A1,K9UQR0,A0A2T1G8M7,K9VUN0,B7GJX9,K9ZDE3,B0JXD6,A0A2T1LS63,A0A1Z4K1Y3,A0A1N6SSK9,A0A0P4UVI8,A0A0V7ZCG4,A0A1J0AGK2,K9PFF9,A0A2G9DT08,K9UEV4,Q9L1X1,A0A060HNJ0,A0A235B542,R5XQK4,A0A1H3LE92,A0A496APJ8,A0A1V9G9U4,S7VLM7,A0A1A5X8H4,A0A1I2T6Q1,A0A1R3T9N6,A0A0Q2M2Z1,H8KXJ0,D3S0S6,A0A2D1U4H7,I3TE64,A0A0B7I4Z6,A0LL61,Q8DKB1,A0A139WY18,A0A1J1EK56,A0A2T1E1K4,A0A1Q8ZD62,A0A4Q6XKV6,A0A1Z3HNN4,A0A239JE83,A0A2N4XBY2,Q53W94,R5JEI2,A0A0Q0ZC47,A0A2T0XH18,A0A1V4CHV0,A0A1K1RQP7,A0A2T1EKT1,A0A1N6LUI7,A0A0P0NGR6,A0A1X7IML5,A0A0A2LKJ7,K1L112,A0A0U3AL92,A0A1H3A054,E0UCX3,K9XZC6,B9LVW4,A0A0C1VHB4,Q31N05,A0A0C5JKF3,R5NJJ8,A5D4D9,Q2JI93,A0A142Y7A9,A0A432MEQ5,A0A372DKU2,A0A3R7KLK4,C1F5Q7,A0A4R3EV39,A0A1P8WP90,A0A222F7P0,A0A1C9VH88,A0A2T2YMB1,A0A329TD61,A0A101R2A0,A0A1E3XF49,A0A1U9ND56,A0A4R7BQC4,A0A1H3DGN3,A0A1Q1FPH0,E0TGY3,A0A259TUP4,F6EYI8,A0A2S9Q9J0,A0A4Q2UIU6,A0A1H0LH25,A0A318LG42,H1YCU5,A0A1Q5ZS75,A0A345E7N0,M0AF24,A0A1W2A082,A0A1H3X247,A0A0C1XUA0,M0D2X3,A0A2R5G167,A0A346PK63,R7RTW6,A0A1H2RBI2,A0A1C3ZXN2,B9LVP8,M5RSF0,W0JW77,B7K585,A0A343TL88,L0AJX6,A0A2A5QS34,A0A343JEE2,A0A3P3RGE5,A0A329TBQ3,A0A285N2A8,A0A0W1S8B8,A0A1V4C8L7,L9VRQ2,E4NRV1,A0A1I6HGN0,A0A1I0NI68,,",366,37
"1238","N.H4.2","N.H4.6",325,181,144,2.86322130141191,"4F1N,4F3T,4KRE,5GUH,5VM9,6KR6,6OON,7KX7,7SWF,A0A163JTZ6,A0A0N4X8S8,A0A196SDB4,J9D5G4,C4LVV2,A0A2P6N8X7,A8BCK6,A2DPV7,A0A0G4H2S4,T1H8B3,S4RWI0,D2VMG4,A0A074TLL7,A0A0D1ZAJ4,Q1K660,F4PH46,A0A3M7S814,A0A164ZA52,A0A383WDW5,Q54G64,S7WCF7,I0YVB2,R7QGN7,C1DZY0,A0A2C5Z0M1,A0CB11,R9ACY5,D3BMP8,A0A1Z5TVE5,W7XD45,A0A1U7LLR0,A0A4S2MWZ7,K1VVQ6,A0A158P1R9,G7DVX0,V6R0U9,G4N9J3,E3KLI3,B7Q5I1,A0A1E3QC61,D5GGK8,S8ANP9,A0A139AUH8,L2GMR6,U4LBG4,A0A177URI1,O74957,A0A3N4IGK1,A6N7Y9,A0A0E9NDK5,T1KZ60,A0A250WXN5,A0A2G8JLH3,Q5KAT1,L2GUF2,W2T741,A0A1W0E4B5,A0A2J7QB22,S4RYE2,A0A2K3CW87,A0A388KES6,A0A226EFL3,A0A3S3PD82,A0A0L0TEV1,A0A1S3J512,G0QTT2,A0A1J1HRI1,C4V9J2,Q9JMB7,A0A075AN09,Q5TW24,U5HIG6,A0A401PRI6,Q96J94,A0A2B4RHN2,G2QEV0,A0A397UU01,A0A2T7PFL8,K7ISV0,A0A024FT57,H3HCL6,A0A0G4IME3,E9FUN9,A0A1S3CYL5,D7FQK3,A0A1Y1YHC8,T1GSU4,F4S231,A0A1D8PMK0,A0A2G5B1D8,Q5BD61,A0A1C7M8P2,A0A4D8YSQ3,A0A158PJG6,J9JZ66,A0A0C2XG51,A0A158QZT6,A0A165QYQ9,T0SAU8,R7YY92,A0A3S1A0C3,A0A074YJ47,A0A2K1J482,A0A1Q3ENA6,O04379,A0A371I3C8,M8AEW7,A8P0D4,A0A2K3NY65,F4NYW7,A0A409Y6G2,A0A0L0HAB7,D8PZT7,A0A1D1W4K0,A7RQ46,W4YU94,A7BJS5,D8SNM6,A0A1J8PPA3,X1WG39,M5FQK2,Q69VD5,A0A2R6NSC2,A0A0D8XL16,A0A016WPN3,Q9QZ81,G5EES3,A0A0K0EFP6,Q8CJG0,A0A1D5NTU6,V2WTL2,A0A0V0YLH8,A0A139WDH0,A0A0R3W9Q7,H3DS31,A0A1Y1HWP2,G4T5G9,B7QCC4,A0A0B2UV00,M7BCJ9,E9GN30,Q7PZ41,A0A077Z361,R7U9I3,A0A1X7V1N5,A0A0K0JDP1,A0A0N4UKJ1,A0A498N3A3,A0A3M0IQP5,A0A0L8GBV4,Q32KD4,A0A1J1JBJ0,E0W4C3,A0A482XDA9,A0A3P7EJD6,J9K2Z4,A0A2J7Q8V4,T1IBM6,V3ZRX0,A0A210QKF7,A0A423TSS1,K1PT78,A0A267E8R7,A0A1D2N447,A0A226D7A9,F6YK55,T1KTE4,A0A2C9JGZ6,A0A1V9X9F0,K5X5Z7,A0A3Q0KUG5,T1FY40,1YVU,1Z26,3DLB,5AWH,5G5T,6QZK,7R8K,E8N0K8,A0A328VKE4,C4L1M1,A0A0M2PXX3,A0A1I3LMA1,K9TPA9,A0A142XB92,B1XJG0,H1KXR6,A0A1Q4R485,K9U8J6,A0A097QRL6,K9RC91,A0A0D8ZUC0,A0A139XGN8,A0A1T4Y3A2,B6YTQ5,A0A0B0H9B4,A0YYT3,A0A2T1EFY0,G6FTN0,R6KUL9,A0A433NB65,A0A1Z4L0A1,K9UQR0,A0A2T1G8M7,K9VUN0,B7GJX9,K9ZDE3,B0JXD6,A0A2T1LS63,A0A1Z4K1Y3,A0A1N6SSK9,A0A0P4UVI8,A0A0V7ZCG4,A0A1J0AGK2,K9PFF9,A0A2G9DT08,K9UEV4,Q9L1X1,A0A060HNJ0,A0A235B542,R5XQK4,A0A496APJ8,A0A062U2W9,A0A1V9G9U4,S7VLM7,A0A1A5X8H4,A0A1I2T6Q1,A0A1R3T9N6,A0A0Q2M2Z1,H8KXJ0,D3S0S6,A0A2D1U4H7,I3TE64,A0A0B7I4Z6,A0LL61,Q8DKB1,A0A139WY18,A0A1J1EK56,A0A2T1E1K4,A0A1Q8ZD62,A0A4Q6XKV6,A0A1Z3HNN4,A0A239JE83,A0A2N4XBY2,Q53W94,R5JEI2,A0A0Q0ZC47,A0A2T0XH18,A0A1V4CHV0,A0A1K1RQP7,A0A2T1EKT1,A0A1N6LUI7,A0A0P0NGR6,A0A1X7IML5,A0A0A2LKJ7,K1L112,A0A0U3AL92,A0A1H3A054,E0UCX3,K9XZC6,A0A0C1VHB4,Q31N05,A0A0C5JKF3,R5NJJ8,A5D4D9,Q2JI93,A0A142Y7A9,A0A432MEQ5,A0A372DKU2,A0A3R7KLK4,C1F5Q7,A0A4R3EV39,A0A1P8WP90,A0A222F7P0,A0A1C9VH88,A0A2T2YMB1,A0A329TD61,A0A101R2A0,A0A1E3XF49,A0A1U9ND56,A0A4R7BQC4,A0A1H3DGN3,A0A1Q1FPH0,E0TGY3,A0A259TUP4,F6EYI8,A0A2S9Q9J0,A0A4Q2UIU6,A0A1H0LH25,A0A318LG42,H1YCU5,A0A1Q5ZS75,A0A345E7N0,A0A1W2A082,A0A1H3X247,A0A0C1XUA0,M0D2X3,A0A2R5G167,A0A346PK63,R7RTW6,A0A1H2RBI2,A0A1C3ZXN2,B9LVP8,M5RSF0,B7K585,A0A343TL88,A0A343JEE2,A0A3P3RGE5,A0A329TBQ3,A0A0W1S8B8,A0A1V4C8L7,L9VRQ2,E4NRV1,A0A1I6HGN0,A0A1I0NI68,,",366,37
"1241","N.H8.5","N.H8.7",347,181,166,1.96410503894029,"4F1N,4F3T,4KRE,5GUH,5VM9,6KR6,6OON,7KX7,7SWF,A0A163JTZ6,J9D5G4,Q389P5,C4LVV2,A0A2P6N8X7,A8BCK6,A2DPV7,A0A0G4H2S4,T1H8B3,R1FDF0,S4RWI0,D2VMG4,A0A074TLL7,A0A0D1ZAJ4,Q1K660,F4PH46,A0A3M7S814,A0A164ZA52,A0A383WDW5,Q54G64,S7WCF7,I0YVB2,R7QGN7,C1DZY0,A0A2C5Z0M1,A0CB11,R9ACY5,D3BMP8,A0A1Z5TVE5,W7XD45,A0A1U7LLR0,A0A4S2MWZ7,K1VVQ6,A0A158P1R9,G7DVX0,V6R0U9,G4N9J3,E3KLI3,B7Q5I1,A0A1E3QC61,D5GGK8,S8ANP9,A0A139AUH8,L2GMR6,U4LBG4,A0A177URI1,O74957,A0A3N4IGK1,A6N7Y9,A0A0E9NDK5,T1KZ60,A0A250WXN5,A0A2G8JLH3,Q5KAT1,L2GUF2,W2T741,A0A1W0E4B5,A0A2J7QB22,S4RYE2,A0A2K3CW87,A0A388KES6,A0A226EFL3,A0A3S3PD82,A0A0L0TEV1,A0A1S3J512,G0QTT2,A0A1J1HRI1,C4V9J2,Q9JMB7,A0A075AN09,Q5TW24,U5HIG6,A0A401PRI6,Q96J94,A0A2B4RHN2,G2QEV0,A0A397UU01,A0A2T7PFL8,K7ISV0,A0A024FT57,H3HCL6,A0A0G4IME3,E9FUN9,A0A1S3CYL5,D7FQK3,A0A1Y1YHC8,T1GSU4,F4S231,A0A1D8PMK0,A0A2G5B1D8,Q5BD61,A0A1C7M8P2,A0A4D8YSQ3,A0A158PJG6,J9JZ66,A0A0C2XG51,A0A158QZT6,A0A165QYQ9,T0SAU8,R7YY92,A0A3S1A0C3,A0A074YJ47,A0A2K1J482,A0A1Q3ENA6,O04379,A0A371I3C8,M8AEW7,A8P0D4,A0A2K3NY65,F4NYW7,A0A409Y6G2,A0A0L0HAB7,D8PZT7,A0A1D1W4K0,A7RQ46,W4YU94,A7BJS5,D8SNM6,A0A1J8PPA3,X1WG39,M5FQK2,Q69VD5,A0A2R6NSC2,A0A0D8XL16,A0A016WPN3,Q9QZ81,G5EES3,A0A0K0EFP6,Q8CJG0,A0A1D5NTU6,V2WTL2,A0A0V0YLH8,A0A139WDH0,A0A0R3W9Q7,H3DS31,A0A1Y1HWP2,G4T5G9,B7QCC4,A0A0B2UV00,M7BCJ9,E9GN30,Q7PZ41,A0A077Z361,R7U9I3,A0A1X7V1N5,A0A0K0JDP1,A0A0N4UKJ1,A0A498N3A3,A0A3M0IQP5,A0A0L8GBV4,Q32KD4,A0A1J1JBJ0,E0W4C3,A0A482XDA9,A0A3P7EJD6,J9K2Z4,A0A2J7Q8V4,T1IBM6,V3ZRX0,A0A210QKF7,A0A423TSS1,K1PT78,A0A267E8R7,A0A1D2N447,A0A226D7A9,F6YK55,T1KTE4,A0A2C9JGZ6,A0A1V9X9F0,K5X5Z7,A0A3Q0KUG5,T1FY40,1YVU,1Z26,3DLB,5AWH,5G5T,5I4A,6QZK,7R8K,E8N0K8,A0A328VKE4,E0ST67,C4L1M1,Q11QW7,A0A0K8QX04,A0A1I3LMA1,K9TPA9,A0A2Z6E1D5,A0A0F4NXW8,A0A142XB92,L8D0R3,B1XJG0,A0A326U7G5,A0A3D8L290,H1KXR6,K9U8J6,K9RC91,A0A0D8ZUC0,A0A139XGN8,A0A1T4Y3A2,Q5P0R2,A0A0B0H9B4,A0YYT3,A0A2T1EFY0,G6FTN0,R6KUL9,A0A433NB65,A0A1Z4L0A1,K9UQR0,A0A2T1G8M7,K9VUN0,B7GJX9,A0A0P6X5X2,K9ZDE3,B0JXD6,A0A2T1LS63,A0A1Z4K1Y3,A0A2Z6E0R7,A0A1N6SSK9,A0A0P4UVI8,A0A0V7ZCG4,A0A1J0AGK2,K9PFF9,A0A2G9DT08,K9UEV4,Q9L1X1,A0A060HNJ0,A0A235B542,R5XQK4,A0A1H3LE92,A0A496APJ8,A0A062U2W9,H0HWQ5,A0A1V9G9U4,A0A1I2ZGP1,A0A317EJY3,A0A1I2BD20,F8ERC7,S7VLM7,A0A1A5X8H4,A0A1I2T6Q1,A0A1R3T9N6,A0A0Q2M2Z1,H8KXJ0,D3S0S6,A0A2D1U4H7,I3TE64,A0A0B7I4Z6,A0LL61,Q8DKB1,A0A139WY18,A0A1J1EK56,A0A2T1E1K4,A0A1Q8ZD62,A0A4Q6XKV6,A0A1Z3HNN4,A0A239JE83,A0A2N4XBY2,Q53W94,R5JEI2,A0A0Q0ZC47,A0A2T0XH18,A0A1V4CHV0,A0A1K1RQP7,A0A2T1EKT1,A0A1N6LUI7,A0A0P0NGR6,A0A1X7IML5,A0A0A2LKJ7,K1L112,A0A0U3AL92,A0A1H3A054,E0UCX3,K9XZC6,B9LVW4,A0A0C1VHB4,Q31N05,A0A0C5JKF3,R5NJJ8,A5D4D9,Q2JI93,A0A142Y7A9,A0A432MEQ5,A0A372DKU2,A0A3R7KLK4,C1F5Q7,A0A4R3EV39,A0A1P8WP90,A0A222F7P0,A0A1C9VH88,A0A2T2YMB1,A0A329TD61,A0A101R2A0,A0A1E3XF49,A0A1U9ND56,A0A4R7BQC4,A0A1H3DGN3,A0A1Q1FPH0,E0TGY3,A0A259TUP4,F6EYI8,A0A2S9Q9J0,A0A4Q2UIU6,A0A1H0LH25,A0A318LG42,H1YCU5,L0JS08,A0A1Q5ZS75,A0A345E7N0,M0AF24,A0A1W2A082,A0A1H3X247,A0A0C1XUA0,M0D2X3,A0A2R5G167,A0A346PK63,R7RTW6,A0A1H2RBI2,A0A1C3ZXN2,B9LVP8,M5RSF0,W0JW77,B7K585,F8D8G0,A0A343TL88,L0AJX6,A0A2A5QS34,A0A343JEE2,A0A3P3RGE5,A0A329TBQ3,A0A285N2A8,A0A0W1S8B8,A0A1V4C8L7,L9VRQ2,E4NRV1,A0A1I6HGN0,A0A1I0NI68,,",366,37
"1242","N.H8.5","N.H8.8",336,181,155,3.04938513633933,"4F1N,4F3T,4KRE,5GUH,5VM9,6KR6,6OON,7KX7,7SWF,A0A163JTZ6,J9D5G4,Q389P5,C4LVV2,A0A2P6N8X7,A8BCK6,A2DPV7,A0A0G4H2S4,T1H8B3,R1FDF0,S4RWI0,D2VMG4,A0A074TLL7,A0A0D1ZAJ4,Q1K660,F4PH46,A0A3M7S814,A0A164ZA52,A0A383WDW5,Q54G64,S7WCF7,I0YVB2,R7QGN7,C1DZY0,A0A2C5Z0M1,A0CB11,R9ACY5,D3BMP8,A0A1Z5TVE5,W7XD45,A0A1U7LLR0,A0A4S2MWZ7,K1VVQ6,A0A158P1R9,G7DVX0,V6R0U9,G4N9J3,E3KLI3,B7Q5I1,A0A1E3QC61,D5GGK8,S8ANP9,A0A139AUH8,L2GMR6,U4LBG4,A0A177URI1,O74957,A0A3N4IGK1,A6N7Y9,A0A0E9NDK5,T1KZ60,A0A250WXN5,A0A2G8JLH3,Q5KAT1,L2GUF2,W2T741,A0A1W0E4B5,A0A2J7QB22,S4RYE2,A0A2K3CW87,A0A388KES6,A0A226EFL3,A0A3S3PD82,A0A0L0TEV1,A0A1S3J512,G0QTT2,A0A1J1HRI1,C4V9J2,Q9JMB7,A0A075AN09,Q5TW24,U5HIG6,A0A401PRI6,Q96J94,A0A2B4RHN2,G2QEV0,A0A397UU01,A0A2T7PFL8,K7ISV0,A0A024FT57,H3HCL6,A0A0G4IME3,E9FUN9,A0A1S3CYL5,D7FQK3,A0A1Y1YHC8,T1GSU4,F4S231,A0A1D8PMK0,A0A2G5B1D8,Q5BD61,A0A1C7M8P2,A0A4D8YSQ3,A0A158PJG6,J9JZ66,A0A0C2XG51,A0A158QZT6,A0A165QYQ9,T0SAU8,R7YY92,A0A3S1A0C3,A0A074YJ47,A0A2K1J482,A0A1Q3ENA6,O04379,A0A371I3C8,M8AEW7,A8P0D4,A0A2K3NY65,F4NYW7,A0A409Y6G2,A0A0L0HAB7,D8PZT7,A0A1D1W4K0,A7RQ46,W4YU94,A7BJS5,D8SNM6,A0A1J8PPA3,X1WG39,M5FQK2,Q69VD5,A0A2R6NSC2,A0A0D8XL16,A0A016WPN3,Q9QZ81,G5EES3,A0A0K0EFP6,Q8CJG0,A0A1D5NTU6,V2WTL2,A0A0V0YLH8,A0A139WDH0,A0A0R3W9Q7,H3DS31,A0A1Y1HWP2,G4T5G9,B7QCC4,A0A0B2UV00,M7BCJ9,E9GN30,Q7PZ41,A0A077Z361,R7U9I3,A0A1X7V1N5,A0A0K0JDP1,A0A0N4UKJ1,A0A498N3A3,A0A3M0IQP5,A0A0L8GBV4,Q32KD4,A0A1J1JBJ0,E0W4C3,A0A482XDA9,A0A3P7EJD6,J9K2Z4,A0A2J7Q8V4,T1IBM6,V3ZRX0,A0A210QKF7,A0A423TSS1,K1PT78,A0A267E8R7,A0A1D2N447,A0A226D7A9,F6YK55,T1KTE4,A0A2C9JGZ6,A0A1V9X9F0,K5X5Z7,A0A3Q0KUG5,T1FY40,1YVU,1Z26,3DLB,5AWH,5G5T,5I4A,6QZK,E8N0K8,A0A328VKE4,C4L1M1,A0A1I3LMA1,K9TPA9,A0A2Z6E1D5,A0A142XB92,B1XJG0,A0A326U7G5,A0A3D8L290,H1KXR6,K9U8J6,K9RC91,A0A0D8ZUC0,A0A139XGN8,A0A1T4Y3A2,A0A0B0H9B4,A0YYT3,A0A2T1EFY0,G6FTN0,R6KUL9,A0A433NB65,A0A1Z4L0A1,K9UQR0,A0A2T1G8M7,K9VUN0,B7GJX9,A0A0P6X5X2,K9ZDE3,B0JXD6,A0A2T1LS63,A0A1Z4K1Y3,A0A1N6SSK9,A0A0V7ZCG4,A0A1J0AGK2,K9PFF9,A0A2G9DT08,K9UEV4,Q9L1X1,A0A235B542,R5XQK4,A0A1H3LE92,A0A496APJ8,A0A062U2W9,H0HWQ5,A0A1V9G9U4,A0A1I2ZGP1,A0A317EJY3,A0A1I2BD20,F8ERC7,S7VLM7,A0A1A5X8H4,A0A1I2T6Q1,A0A1R3T9N6,A0A0Q2M2Z1,H8KXJ0,D3S0S6,A0A2D1U4H7,I3TE64,A0A0B7I4Z6,A0LL61,Q8DKB1,A0A139WY18,A0A1J1EK56,A0A2T1E1K4,A0A1Q8ZD62,A0A4Q6XKV6,A0A1Z3HNN4,A0A239JE83,A0A2N4XBY2,Q53W94,R5JEI2,A0A0Q0ZC47,A0A2T0XH18,A0A1V4CHV0,A0A1K1RQP7,A0A2T1EKT1,A0A1N6LUI7,A0A0P0NGR6,A0A1X7IML5,A0A0A2LKJ7,K1L112,A0A0U3AL92,A0A1H3A054,E0UCX3,K9XZC6,B9LVW4,A0A0C1VHB4,Q31N05,A0A0C5JKF3,R5NJJ8,A5D4D9,Q2JI93,A0A142Y7A9,A0A432MEQ5,A0A372DKU2,A0A3R7KLK4,C1F5Q7,A0A4R3EV39,A0A1P8WP90,A0A222F7P0,A0A1C9VH88,A0A2T2YMB1,A0A329TD61,A0A101R2A0,A0A1U9ND56,A0A4R7BQC4,A0A1H3DGN3,A0A1Q1FPH0,E0TGY3,A0A259TUP4,F6EYI8,A0A2S9Q9J0,A0A4Q2UIU6,A0A1H0LH25,A0A318LG42,H1YCU5,L0JS08,A0A1Q5ZS75,A0A345E7N0,M0AF24,A0A1W2A082,A0A1H3X247,A0A0C1XUA0,M0D2X3,A0A2R5G167,A0A346PK63,R7RTW6,A0A1H2RBI2,A0A1C3ZXN2,B9LVP8,M5RSF0,W0JW77,B7K585,F8D8G0,A0A343TL88,L0AJX6,A0A2A5QS34,A0A343JEE2,A0A3P3RGE5,A0A329TBQ3,A0A285N2A8,A0A0W1S8B8,A0A1V4C8L7,L9VRQ2,E4NRV1,A0A1I6HGN0,A0A1I0NI68,,",366,37
"1243","N.H8.5","N.H8.9",339,181,158,3.14595426253584,"4F1N,4F3T,4KRE,5GUH,5VM9,6KR6,6OON,7KX7,7SWF,A0A163JTZ6,J9D5G4,Q389P5,C4LVV2,A0A2P6N8X7,A8BCK6,A2DPV7,A0A0G4H2S4,T1H8B3,R1FDF0,S4RWI0,D2VMG4,A0A074TLL7,A0A0D1ZAJ4,Q1K660,F4PH46,A0A3M7S814,A0A164ZA52,A0A383WDW5,Q54G64,S7WCF7,I0YVB2,R7QGN7,C1DZY0,A0A2C5Z0M1,A0CB11,R9ACY5,D3BMP8,A0A1Z5TVE5,W7XD45,A0A1U7LLR0,A0A4S2MWZ7,K1VVQ6,A0A158P1R9,G7DVX0,V6R0U9,G4N9J3,E3KLI3,B7Q5I1,A0A1E3QC61,D5GGK8,S8ANP9,A0A139AUH8,L2GMR6,U4LBG4,A0A177URI1,O74957,A0A3N4IGK1,A6N7Y9,A0A0E9NDK5,T1KZ60,A0A250WXN5,A0A2G8JLH3,Q5KAT1,L2GUF2,W2T741,A0A1W0E4B5,A0A2J7QB22,S4RYE2,A0A2K3CW87,A0A388KES6,A0A226EFL3,A0A3S3PD82,A0A0L0TEV1,A0A1S3J512,G0QTT2,A0A1J1HRI1,C4V9J2,Q9JMB7,A0A075AN09,Q5TW24,U5HIG6,A0A401PRI6,Q96J94,A0A2B4RHN2,G2QEV0,A0A397UU01,A0A2T7PFL8,K7ISV0,A0A024FT57,H3HCL6,A0A0G4IME3,E9FUN9,A0A1S3CYL5,D7FQK3,A0A1Y1YHC8,T1GSU4,F4S231,A0A1D8PMK0,A0A2G5B1D8,Q5BD61,A0A1C7M8P2,A0A4D8YSQ3,A0A158PJG6,J9JZ66,A0A0C2XG51,A0A158QZT6,A0A165QYQ9,T0SAU8,R7YY92,A0A3S1A0C3,A0A074YJ47,A0A2K1J482,A0A1Q3ENA6,O04379,A0A371I3C8,M8AEW7,A8P0D4,A0A2K3NY65,F4NYW7,A0A409Y6G2,A0A0L0HAB7,D8PZT7,A0A1D1W4K0,A7RQ46,W4YU94,A7BJS5,D8SNM6,A0A1J8PPA3,X1WG39,M5FQK2,Q69VD5,A0A2R6NSC2,A0A0D8XL16,A0A016WPN3,Q9QZ81,G5EES3,A0A0K0EFP6,Q8CJG0,A0A1D5NTU6,V2WTL2,A0A0V0YLH8,A0A139WDH0,A0A0R3W9Q7,H3DS31,A0A1Y1HWP2,G4T5G9,B7QCC4,A0A0B2UV00,M7BCJ9,E9GN30,Q7PZ41,A0A077Z361,R7U9I3,A0A1X7V1N5,A0A0K0JDP1,A0A0N4UKJ1,A0A498N3A3,A0A3M0IQP5,A0A0L8GBV4,Q32KD4,A0A1J1JBJ0,E0W4C3,A0A482XDA9,A0A3P7EJD6,J9K2Z4,A0A2J7Q8V4,T1IBM6,V3ZRX0,A0A210QKF7,A0A423TSS1,K1PT78,A0A267E8R7,A0A1D2N447,A0A226D7A9,F6YK55,T1KTE4,A0A2C9JGZ6,A0A1V9X9F0,K5X5Z7,A0A3Q0KUG5,T1FY40,1YVU,1Z26,3DLB,5AWH,5G5T,5I4A,6QZK,7R8K,E8N0K8,A0A328VKE4,C4L1M1,A0A1I3LMA1,K9TPA9,A0A0F4NXW8,A0A142XB92,B1XJG0,A0A326U7G5,A0A3D8L290,H1KXR6,K9U8J6,K9RC91,A0A0D8ZUC0,A0A139XGN8,A0A1T4Y3A2,A0A0B0H9B4,A0YYT3,A0A2T1EFY0,G6FTN0,R6KUL9,A0A433NB65,A0A1Z4L0A1,K9UQR0,A0A2T1G8M7,K9VUN0,B7GJX9,A0A0P6X5X2,K9ZDE3,B0JXD6,A0A2T1LS63,A0A1Z4K1Y3,A0A1N6SSK9,A0A0V7ZCG4,A0A1J0AGK2,K9PFF9,A0A2G9DT08,K9UEV4,Q9L1X1,A0A060HNJ0,A0A235B542,R5XQK4,A0A1H3LE92,A0A496APJ8,A0A062U2W9,H0HWQ5,A0A1V9G9U4,A0A1I2ZGP1,A0A317EJY3,A0A1I2BD20,F8ERC7,S7VLM7,A0A1A5X8H4,A0A1I2T6Q1,A0A1R3T9N6,A0A0Q2M2Z1,H8KXJ0,D3S0S6,A0A2D1U4H7,I3TE64,A0A0B7I4Z6,A0LL61,Q8DKB1,A0A139WY18,A0A1J1EK56,A0A2T1E1K4,A0A1Q8ZD62,A0A4Q6XKV6,A0A1Z3HNN4,A0A239JE83,A0A2N4XBY2,Q53W94,R5JEI2,A0A0Q0ZC47,A0A2T0XH18,A0A1V4CHV0,A0A1K1RQP7,A0A2T1EKT1,A0A1N6LUI7,A0A0P0NGR6,A0A1X7IML5,A0A0A2LKJ7,K1L112,A0A0U3AL92,A0A1H3A054,E0UCX3,K9XZC6,B9LVW4,A0A0C1VHB4,Q31N05,A0A0C5JKF3,R5NJJ8,A5D4D9,Q2JI93,A0A142Y7A9,A0A432MEQ5,A0A372DKU2,A0A3R7KLK4,C1F5Q7,A0A4R3EV39,A0A1P8WP90,A0A222F7P0,A0A1C9VH88,A0A2T2YMB1,A0A329TD61,A0A101R2A0,A0A1E3XF49,A0A1U9ND56,A0A4R7BQC4,A0A1H3DGN3,A0A1Q1FPH0,E0TGY3,A0A259TUP4,F6EYI8,A0A2S9Q9J0,A0A4Q2UIU6,A0A1H0LH25,A0A318LG42,H1YCU5,L0JS08,A0A1Q5ZS75,A0A345E7N0,M0AF24,A0A1W2A082,A0A1H3X247,A0A0C1XUA0,M0D2X3,A0A2R5G167,A0A346PK63,R7RTW6,A0A1H2RBI2,A0A1C3ZXN2,B9LVP8,M5RSF0,W0JW77,B7K585,F8D8G0,A0A343TL88,L0AJX6,A0A2A5QS34,A0A343JEE2,A0A3P3RGE5,A0A329TBQ3,A0A285N2A8,A0A0W1S8B8,A0A1V4C8L7,L9VRQ2,E4NRV1,A0A1I6HGN0,A0A1I0NI68,,",366,37
"1245","N.H8.6","N.H8.9",340,181,159,2.61895826818166,"4F1N,4F3T,4KRE,5GUH,5VM9,6KR6,6OON,7KX7,7SWF,A0A163JTZ6,J9D5G4,Q389P5,C4LVV2,A0A2P6N8X7,A8BCK6,A2DPV7,A0A0G4H2S4,T1H8B3,R1FDF0,S4RWI0,D2VMG4,A0A074TLL7,A0A0D1ZAJ4,Q1K660,F4PH46,A0A3M7S814,A0A164ZA52,A0A383WDW5,Q54G64,S7WCF7,I0YVB2,R7QGN7,C1DZY0,A0A2C5Z0M1,A0CB11,R9ACY5,D3BMP8,A0A1Z5TVE5,W7XD45,A0A1U7LLR0,A0A4S2MWZ7,K1VVQ6,A0A158P1R9,G7DVX0,V6R0U9,G4N9J3,E3KLI3,B7Q5I1,A0A1E3QC61,D5GGK8,S8ANP9,A0A139AUH8,L2GMR6,U4LBG4,A0A177URI1,O74957,A0A3N4IGK1,A6N7Y9,A0A0E9NDK5,T1KZ60,A0A250WXN5,A0A2G8JLH3,Q5KAT1,L2GUF2,W2T741,A0A1W0E4B5,A0A2J7QB22,S4RYE2,A0A2K3CW87,A0A388KES6,A0A226EFL3,A0A3S3PD82,A0A0L0TEV1,A0A1S3J512,G0QTT2,A0A1J1HRI1,C4V9J2,Q9JMB7,A0A075AN09,Q5TW24,U5HIG6,A0A401PRI6,Q96J94,A0A2B4RHN2,G2QEV0,A0A397UU01,A0A2T7PFL8,K7ISV0,A0A024FT57,H3HCL6,A0A0G4IME3,E9FUN9,A0A1S3CYL5,D7FQK3,A0A1Y1YHC8,T1GSU4,F4S231,A0A1D8PMK0,A0A2G5B1D8,Q5BD61,A0A1C7M8P2,A0A4D8YSQ3,A0A158PJG6,J9JZ66,A0A0C2XG51,A0A158QZT6,A0A165QYQ9,T0SAU8,R7YY92,A0A3S1A0C3,A0A074YJ47,A0A2K1J482,A0A1Q3ENA6,O04379,A0A371I3C8,M8AEW7,A8P0D4,A0A2K3NY65,F4NYW7,A0A409Y6G2,A0A0L0HAB7,D8PZT7,A0A1D1W4K0,A7RQ46,W4YU94,A7BJS5,D8SNM6,A0A1J8PPA3,X1WG39,M5FQK2,Q69VD5,A0A2R6NSC2,A0A0D8XL16,A0A016WPN3,Q9QZ81,G5EES3,A0A0K0EFP6,Q8CJG0,A0A1D5NTU6,V2WTL2,A0A0V0YLH8,A0A139WDH0,A0A0R3W9Q7,H3DS31,A0A1Y1HWP2,G4T5G9,B7QCC4,A0A0B2UV00,M7BCJ9,E9GN30,Q7PZ41,A0A077Z361,R7U9I3,A0A1X7V1N5,A0A0K0JDP1,A0A0N4UKJ1,A0A498N3A3,A0A3M0IQP5,A0A0L8GBV4,Q32KD4,A0A1J1JBJ0,E0W4C3,A0A482XDA9,A0A3P7EJD6,J9K2Z4,A0A2J7Q8V4,T1IBM6,V3ZRX0,A0A210QKF7,A0A423TSS1,K1PT78,A0A267E8R7,A0A1D2N447,A0A226D7A9,F6YK55,T1KTE4,A0A2C9JGZ6,A0A1V9X9F0,K5X5Z7,A0A3Q0KUG5,T1FY40,1Z26,3DLB,5AWH,5G5T,5I4A,6QZK,7R8K,E8N0K8,A0A328VKE4,C4L1M1,A0A1I3LMA1,K9TPA9,A0A0F4NXW8,A0A142XB92,L8D0R3,B1XJG0,A0A326U7G5,A0A3D8L290,H1KXR6,K9U8J6,K9RC91,A0A0D8ZUC0,A0A139XGN8,A0A1T4Y3A2,Q5P0R2,A0A0B0H9B4,A0YYT3,A0A2T1EFY0,G6FTN0,R6KUL9,A0A433NB65,A0A1Z4L0A1,K9UQR0,A0A2T1G8M7,K9VUN0,B7GJX9,A0A0P6X5X2,K9ZDE3,B0JXD6,A0A2T1LS63,A0A1Z4K1Y3,A0A2Z6E0R7,A0A1N6SSK9,A0A0P4UVI8,A0A0V7ZCG4,A0A1J0AGK2,K9PFF9,A0A2G9DT08,K9UEV4,Q9L1X1,A0A060HNJ0,A0A235B542,R5XQK4,A0A1H3LE92,A0A496APJ8,A0A062U2W9,H0HWQ5,A0A1V9G9U4,A0A1I2ZGP1,A0A317EJY3,A0A1I2BD20,F8ERC7,S7VLM7,A0A1A5X8H4,A0A1I2T6Q1,A0A1R3T9N6,A0A0Q2M2Z1,H8KXJ0,D3S0S6,A0A2D1U4H7,I3TE64,A0A0B7I4Z6,A0LL61,Q8DKB1,A0A139WY18,A0A1J1EK56,A0A2T1E1K4,A0A1Q8ZD62,A0A4Q6XKV6,A0A1Z3HNN4,A0A239JE83,A0A2N4XBY2,Q53W94,R5JEI2,A0A0Q0ZC47,A0A2T0XH18,A0A1V4CHV0,A0A1K1RQP7,A0A2T1EKT1,A0A1N6LUI7,A0A0P0NGR6,A0A1X7IML5,A0A0A2LKJ7,K1L112,A0A0U3AL92,A0A1H3A054,E0UCX3,K9XZC6,A0A0C1VHB4,Q31N05,A0A0C5JKF3,R5NJJ8,A5D4D9,Q2JI93,A0A142Y7A9,A0A432MEQ5,A0A372DKU2,A0A3R7KLK4,C1F5Q7,A0A4R3EV39,A0A1P8WP90,A0A222F7P0,A0A1C9VH88,A0A2T2YMB1,A0A329TD61,A0A101R2A0,A0A1E3XF49,A0A1U9ND56,A0A4R7BQC4,A0A1H3DGN3,A0A1Q1FPH0,E0TGY3,A0A259TUP4,F6EYI8,A0A2S9Q9J0,A0A4Q2UIU6,A0A1H0LH25,A0A318LG42,H1YCU5,L0JS08,A0A1Q5ZS75,A0A345E7N0,M0AF24,A0A1W2A082,A0A1H3X247,A0A0C1XUA0,M0D2X3,A0A2R5G167,A0A346PK63,R7RTW6,A0A1C3ZXN2,B9LVP8,M5RSF0,W0JW77,B7K585,F8D8G0,A0A343TL88,L0AJX6,A0A2A5QS34,A0A343JEE2,A0A3P3RGE5,A0A329TBQ3,A0A285N2A8,A0A0W1S8B8,A0A1V4C8L7,L9VRQ2,E4NRV1,A0A1I6HGN0,A0A1I0NI68,,",366,37
"1246","N.H8.7","N.H8.9",356,181,175,2.06876085240726,"4F1N,4F3T,4KRE,5GUH,5VM9,6KR6,6OON,7KX7,7SWF,A0A163JTZ6,J9D5G4,Q389P5,C4LVV2,A0A2P6N8X7,A8BCK6,A2DPV7,A0A0G4H2S4,T1H8B3,R1FDF0,S4RWI0,D2VMG4,A0A074TLL7,A0A0D1ZAJ4,Q1K660,F4PH46,A0A3M7S814,A0A164ZA52,A0A383WDW5,Q54G64,S7WCF7,I0YVB2,R7QGN7,C1DZY0,A0A2C5Z0M1,A0CB11,R9ACY5,D3BMP8,A0A1Z5TVE5,W7XD45,A0A1U7LLR0,A0A4S2MWZ7,K1VVQ6,A0A158P1R9,G7DVX0,V6R0U9,G4N9J3,E3KLI3,B7Q5I1,A0A1E3QC61,D5GGK8,S8ANP9,A0A139AUH8,L2GMR6,U4LBG4,A0A177URI1,O74957,A0A3N4IGK1,A6N7Y9,A0A0E9NDK5,T1KZ60,A0A250WXN5,A0A2G8JLH3,Q5KAT1,L2GUF2,W2T741,A0A1W0E4B5,A0A2J7QB22,S4RYE2,A0A2K3CW87,A0A388KES6,A0A226EFL3,A0A3S3PD82,A0A0L0TEV1,A0A1S3J512,G0QTT2,A0A1J1HRI1,C4V9J2,Q9JMB7,A0A075AN09,Q5TW24,U5HIG6,A0A401PRI6,Q96J94,A0A2B4RHN2,G2QEV0,A0A397UU01,A0A2T7PFL8,K7ISV0,A0A024FT57,H3HCL6,A0A0G4IME3,E9FUN9,A0A1S3CYL5,D7FQK3,A0A1Y1YHC8,T1GSU4,F4S231,A0A1D8PMK0,A0A2G5B1D8,Q5BD61,A0A1C7M8P2,A0A4D8YSQ3,A0A158PJG6,J9JZ66,A0A0C2XG51,A0A158QZT6,A0A165QYQ9,T0SAU8,R7YY92,A0A3S1A0C3,A0A074YJ47,A0A2K1J482,A0A1Q3ENA6,O04379,A0A371I3C8,M8AEW7,A8P0D4,A0A2K3NY65,F4NYW7,A0A409Y6G2,A0A0L0HAB7,D8PZT7,A0A1D1W4K0,A7RQ46,W4YU94,A7BJS5,D8SNM6,A0A1J8PPA3,X1WG39,M5FQK2,Q69VD5,A0A2R6NSC2,A0A0D8XL16,A0A016WPN3,Q9QZ81,G5EES3,A0A0K0EFP6,Q8CJG0,A0A1D5NTU6,V2WTL2,A0A0V0YLH8,A0A139WDH0,A0A0R3W9Q7,H3DS31,A0A1Y1HWP2,G4T5G9,B7QCC4,A0A0B2UV00,M7BCJ9,E9GN30,Q7PZ41,A0A077Z361,R7U9I3,A0A1X7V1N5,A0A0K0JDP1,A0A0N4UKJ1,A0A498N3A3,A0A3M0IQP5,A0A0L8GBV4,Q32KD4,A0A1J1JBJ0,E0W4C3,A0A482XDA9,A0A3P7EJD6,J9K2Z4,A0A2J7Q8V4,T1IBM6,V3ZRX0,A0A210QKF7,A0A423TSS1,K1PT78,A0A267E8R7,A0A1D2N447,A0A226D7A9,F6YK55,T1KTE4,A0A2C9JGZ6,A0A1V9X9F0,K5X5Z7,A0A3Q0KUG5,T1FY40,1YVU,1Z26,3DLB,5AWH,5G5T,5I4A,6QZK,7R8K,E8N0K8,A0A1I7IXT4,A0A2W1JZ37,A0A2S7WBN3,A0A328VKE4,A0A420DFE6,E0ST67,A0A4V1VDY2,A0A368P5I0,C4L1M1,A0A4R1RMM2,A0A1Y2RDH8,A0A0M2PXX3,A0A1I3LMA1,K9TPA9,A0A1L3JHM3,A0A1W6MIP2,A0A1C0UUC4,A0A2U2J9E0,A0A0F4NXW8,A0A142XB92,L8D0R3,B1XJG0,A0A326U7G5,A0A3D8L290,H1KXR6,K9U8J6,K9RC91,A0A0D8ZUC0,A0A139XGN8,A0A1T4Y3A2,Q5P0R2,A0A0B0H9B4,A0YYT3,A0A2T1EFY0,G6FTN0,R6KUL9,A0A433NB65,A0A1Z4L0A1,K9UQR0,A0A2T1G8M7,K9VUN0,B7GJX9,A0A0P6X5X2,K9ZDE3,B0JXD6,A0A2T1LS63,A0A1Z4K1Y3,A0A2Z6E0R7,A0A1N6SSK9,A0A0P4UVI8,A0A0V7ZCG4,A0A1J0AGK2,K9PFF9,A0A2G9DT08,K9UEV4,Q9L1X1,A0A235B542,R5XQK4,A0A1H3LE92,A0A496APJ8,A0A062U2W9,H0HWQ5,A0A1V9G9U4,A0A1I2ZGP1,A0A317EJY3,A0A1I2BD20,F8ERC7,S7VLM7,A0A1A5X8H4,A0A1I2T6Q1,A0A1R3T9N6,A0A0Q2M2Z1,H8KXJ0,D3S0S6,A0A2D1U4H7,I3TE64,A0A0B7I4Z6,A0LL61,Q8DKB1,A0A139WY18,A0A1J1EK56,A0A2T1E1K4,A0A1Q8ZD62,A0A4Q6XKV6,A0A1Z3HNN4,A0A239JE83,A0A2N4XBY2,Q53W94,R5JEI2,A0A0Q0ZC47,A0A2T0XH18,A0A1V4CHV0,A0A1K1RQP7,A0A2T1EKT1,A0A1N6LUI7,A0A0P0NGR6,A0A1X7IML5,A0A0A2LKJ7,K1L112,A0A0U3AL92,A0A1H3A054,E0UCX3,K9XZC6,B9LVW4,A0A0C1VHB4,Q31N05,A0A0C5JKF3,R5NJJ8,A5D4D9,Q2JI93,A0A142Y7A9,A0A432MEQ5,A0A372DKU2,A0A3R7KLK4,C1F5Q7,A0A4R3EV39,A0A1P8WP90,A0A222F7P0,A0A1C9VH88,A0A2T2YMB1,A0A329TD61,A0A101R2A0,A0A1E3XF49,A0A1U9ND56,A0A4R7BQC4,A0A1H3DGN3,A0A1Q1FPH0,E0TGY3,A0A259TUP4,F6EYI8,A0A2S9Q9J0,A0A4Q2UIU6,A0A1H0LH25,A0A318LG42,H1YCU5,L0JS08,A0A1Q5ZS75,A0A345E7N0,M0AF24,A0A1W2A082,A0A1H3X247,A0A0C1XUA0,M0D2X3,A0A2R5G167,A0A346PK63,R7RTW6,A0A1H2RBI2,A0A1C3ZXN2,B9LVP8,M5RSF0,W0JW77,B7K585,F8D8G0,A0A343TL88,L0AJX6,A0A2A5QS34,A0A343JEE2,A0A3P3RGE5,A0A329TBQ3,A0A285N2A8,A0A0W1S8B8,A0A1V4C8L7,L9VRQ2,E4NRV1,A0A1I6HGN0,A0A1I0NI68,,",366,37
"1247","N.L22.2","N.S19.1",334,181,153,1.20355324450222,"4F3T,4KRE,5GUH,5VM9,6KR6,6OON,7KX7,7SWF,A0A163JTZ6,A0A0N4X8S8,A0A196SDB4,J9D5G4,Q389P5,C4LVV2,A0A2P6N8X7,A8BCK6,A2DPV7,A0A0G4H2S4,T1H8B3,R1FDF0,S4RWI0,D2VMG4,A0A074TLL7,A0A0D1ZAJ4,Q1K660,F4PH46,A0A3M7S814,A0A164ZA52,A0A383WDW5,Q54G64,S7WCF7,I0YVB2,R7QGN7,C1DZY0,A0A2C5Z0M1,A0CB11,R9ACY5,D3BMP8,A0A1Z5TVE5,W7XD45,A0A1U7LLR0,A0A4S2MWZ7,K1VVQ6,A0A158P1R9,G7DVX0,V6R0U9,G4N9J3,E3KLI3,A0A1E3QC61,D5GGK8,S8ANP9,A0A139AUH8,L2GMR6,U4LBG4,A0A177URI1,O74957,A0A3N4IGK1,A6N7Y9,A0A0E9NDK5,T1KZ60,A0A250WXN5,A0A2G8JLH3,Q5KAT1,L2GUF2,W2T741,A0A1W0E4B5,A0A2J7QB22,S4RYE2,A0A2K3CW87,A0A388KES6,A0A226EFL3,A0A3S3PD82,A0A0L0TEV1,A0A1S3J512,G0QTT2,A0A1J1HRI1,C4V9J2,Q9JMB7,A0A075AN09,Q5TW24,U5HIG6,A0A401PRI6,Q96J94,A0A2B4RHN2,G2QEV0,A0A397UU01,A0A2T7PFL8,K7ISV0,A0A024FT57,H3HCL6,A0A0G4IME3,E9FUN9,A0A1S3CYL5,D7FQK3,A0A1Y1YHC8,T1GSU4,F4S231,A0A1D8PMK0,A0A2G5B1D8,Q5BD61,A0A1C7M8P2,A0A4D8YSQ3,A0A158PJG6,J9JZ66,A0A0C2XG51,A0A158QZT6,A0A165QYQ9,T0SAU8,R7YY92,A0A3S1A0C3,A0A074YJ47,A0A2K1J482,A0A1Q3ENA6,O04379,A0A371I3C8,M8AEW7,A8P0D4,A0A2K3NY65,F4NYW7,A0A409Y6G2,A0A0L0HAB7,D8PZT7,A0A1D1W4K0,A7RQ46,W4YU94,A7BJS5,D8SNM6,A0A1J8PPA3,X1WG39,M5FQK2,Q69VD5,A0A2R6NSC2,A0A0D8XL16,A0A016WPN3,Q9QZ81,G5EES3,A0A0K0EFP6,Q8CJG0,A0A1D5NTU6,V2WTL2,A0A0V0YLH8,A0A139WDH0,A0A0R3W9Q7,H3DS31,A0A1Y1HWP2,G4T5G9,B7QCC4,A0A0B2UV00,M7BCJ9,E9GN30,Q7PZ41,A0A077Z361,R7U9I3,A0A1X7V1N5,A0A0K0JDP1,A0A0N4UKJ1,A0A498N3A3,A0A3M0IQP5,A0A0L8GBV4,Q32KD4,A0A1J1JBJ0,E0W4C3,A0A482XDA9,A0A3P7EJD6,J9K2Z4,A0A2J7Q8V4,T1IBM6,V3ZRX0,A0A210QKF7,A0A423TSS1,K1PT78,A0A267E8R7,A0A1D2N447,A0A226D7A9,F6YK55,T1KTE4,A0A2C9JGZ6,A0A1V9X9F0,K5X5Z7,A0A3Q0KUG5,T1FY40,1YVU,1Z26,3DLB,5AWH,5G5T,5I4A,6QZK,7R8K,E8N0K8,A0A328VKE4,E0ST67,C4L1M1,Q11QW7,A0A0M2PXX3,A0A1I3LMA1,A0A1C0UUC4,A0A2Z6E1D5,A0A0F4NXW8,L8D0R3,B1XJG0,A0A326U7G5,A0A1Q4R485,K9U8J6,K9RC91,A0A1T4Y3A2,Q5P0R2,A0A0B0H9B4,A0YYT3,R6KUL9,A0A433NB65,A0A1Z4L0A1,K9UQR0,A0A2T1G8M7,K9VUN0,B7GJX9,A0A2T1LS63,A0A1Z4K1Y3,A0A2Z6E0R7,A0A1N6SSK9,A0A0P4UVI8,A0A0V7ZCG4,A0A1J0AGK2,K9PFF9,A0A2G9DT08,Q9L1X1,A0A060HNJ0,A0A235B542,R5XQK4,A0A1H3LE92,A0A496APJ8,A0A062U2W9,H0HWQ5,A0A1V9G9U4,A0A1I2ZGP1,A0A317EJY3,A0A1I2BD20,F8ERC7,S7VLM7,A0A1A5X8H4,A0A1I2T6Q1,A0A1R3T9N6,A0A0Q2M2Z1,H8KXJ0,D3S0S6,A0A2D1U4H7,I3TE64,A0A0B7I4Z6,A0LL61,Q8DKB1,A0A139WY18,A0A1J1EK56,A0A2T1E1K4,A0A1Q8ZD62,A0A4Q6XKV6,A0A1Z3HNN4,A0A239JE83,A0A2N4XBY2,Q53W94,R5JEI2,A0A0Q0ZC47,A0A2T0XH18,A0A1V4CHV0,A0A1K1RQP7,A0A2T1EKT1,A0A1N6LUI7,A0A0P0NGR6,A0A1X7IML5,A0A0A2LKJ7,K1L112,A0A0U3AL92,A0A1H3A054,E0UCX3,K9XZC6,A0A0C1VHB4,Q31N05,A0A0C5JKF3,R5NJJ8,A5D4D9,Q2JI93,A0A142Y7A9,A0A432MEQ5,A0A372DKU2,C1F5Q7,A0A4R3EV39,A0A1P8WP90,A0A222F7P0,A0A1C9VH88,A0A2T2YMB1,A0A329TD61,A0A101R2A0,A0A1E3XF49,A0A1U9ND56,A0A4R7BQC4,A0A1Q1FPH0,E0TGY3,A0A259TUP4,F6EYI8,A0A2S9Q9J0,A0A4Q2UIU6,A0A1H0LH25,A0A318LG42,H1YCU5,L0JS08,A0A1Q5ZS75,A0A345E7N0,M0AF24,A0A1W2A082,A0A1H3X247,A0A0C1XUA0,M0D2X3,A0A2R5G167,A0A346PK63,R7RTW6,A0A1H2RBI2,A0A1C3ZXN2,B9LVP8,M5RSF0,W0JW77,B7K585,F8D8G0,A0A343TL88,L0AJX6,A0A2A5QS34,A0A343JEE2,A0A3P3RGE5,A0A329TBQ3,A0A285N2A8,A0A0W1S8B8,A0A1V4C8L7,L9VRQ2,E4NRV1,A0A1I6HGN0,A0A1I0NI68,,",366,37
"1248","C.H3.7","C.H3.9",362,182,180,1.76538461538462,"4F1N,4F3T,4KRE,5GUH,5VM9,6KR6,6OON,7KX7,7SWF,A0A163JTZ6,A0A0N4X8S8,A0A196SDB4,J9D5G4,Q389P5,C4LVV2,A0A2P6N8X7,A8BCK6,A2DPV7,A0A0G4H2S4,T1H8B3,S4RWI0,D2VMG4,A0A074TLL7,A0A0D1ZAJ4,Q1K660,F4PH46,A0A3M7S814,A0A164ZA52,A0A383WDW5,Q54G64,S7WCF7,I0YVB2,R7QGN7,C1DZY0,A0A2C5Z0M1,A0CB11,R9ACY5,D3BMP8,A0A1Z5TVE5,W7XD45,A0A1U7LLR0,A0A4S2MWZ7,K1VVQ6,A0A158P1R9,G7DVX0,V6R0U9,G4N9J3,E3KLI3,B7Q5I1,A0A1E3QC61,D5GGK8,S8ANP9,A0A139AUH8,L2GMR6,U4LBG4,A0A177URI1,O74957,A0A3N4IGK1,A6N7Y9,A0A0E9NDK5,T1KZ60,A0A250WXN5,A0A2G8JLH3,Q5KAT1,L2GUF2,W2T741,A0A1W0E4B5,A0A2J7QB22,S4RYE2,A0A2K3CW87,A0A388KES6,A0A226EFL3,A0A3S3PD82,A0A0L0TEV1,A0A1S3J512,G0QTT2,A0A1J1HRI1,C4V9J2,Q9JMB7,A0A075AN09,Q5TW24,U5HIG6,A0A401PRI6,Q96J94,A0A2B4RHN2,G2QEV0,A0A397UU01,A0A2T7PFL8,K7ISV0,A0A024FT57,H3HCL6,A0A0G4IME3,E9FUN9,A0A1S3CYL5,D7FQK3,A0A1Y1YHC8,T1GSU4,F4S231,A0A1D8PMK0,A0A2G5B1D8,Q5BD61,A0A1C7M8P2,A0A4D8YSQ3,A0A158PJG6,J9JZ66,A0A0C2XG51,A0A158QZT6,A0A165QYQ9,T0SAU8,R7YY92,A0A3S1A0C3,A0A074YJ47,A0A2K1J482,A0A1Q3ENA6,O04379,A0A371I3C8,M8AEW7,A8P0D4,A0A2K3NY65,F4NYW7,A0A409Y6G2,A0A0L0HAB7,D8PZT7,A0A1D1W4K0,A7RQ46,W4YU94,A7BJS5,D8SNM6,A0A1J8PPA3,X1WG39,M5FQK2,Q69VD5,A0A2R6NSC2,A0A0D8XL16,A0A016WPN3,Q9QZ81,G5EES3,A0A0K0EFP6,Q8CJG0,A0A1D5NTU6,V2WTL2,A0A0V0YLH8,A0A139WDH0,A0A0R3W9Q7,H3DS31,A0A1Y1HWP2,G4T5G9,B7QCC4,A0A0B2UV00,M7BCJ9,E9GN30,Q7PZ41,A0A077Z361,R7U9I3,A0A1X7V1N5,A0A0K0JDP1,A0A0N4UKJ1,A0A498N3A3,A0A3M0IQP5,A0A0L8GBV4,Q32KD4,A0A1J1JBJ0,E0W4C3,A0A482XDA9,A0A3P7EJD6,J9K2Z4,A0A2J7Q8V4,T1IBM6,V3ZRX0,A0A210QKF7,A0A423TSS1,K1PT78,A0A267E8R7,A0A1D2N447,A0A226D7A9,F6YK55,T1KTE4,A0A2C9JGZ6,A0A1V9X9F0,K5X5Z7,A0A3Q0KUG5,T1FY40,1YVU,1Z26,3DLB,5AWH,5G5T,5I4A,6QZK,7R8K,E8N0K8,A0A1I7IXT4,A0A2W1JZ37,A0A2S7WBN3,A0A328VKE4,A0A420DFE6,E0ST67,A0A4V1VDY2,A0A368P5I0,C4L1M1,A0A4R1RMM2,A0A1Y2RDH8,Q11QW7,A0A1M5ZSR3,A0A0K8QX04,A0A0M2PXX3,A0A1I3LMA1,K9TPA9,A0A1L3JHM3,A0A1W6MIP2,A0A1C0UUC4,A0A2U2J9E0,A0A2Z6E1D5,A0A0F4NXW8,A0A142XB92,L8D0R3,B1XJG0,A0A326U7G5,A0A3D8L290,H1KXR6,A0A1Q4R485,K9U8J6,A0A097QRL6,K9RC91,A0A0D8ZUC0,A0A139XGN8,A0A1T4Y3A2,Q5P0R2,B6YTQ5,A0A0B0H9B4,A0YYT3,A0A2T1EFY0,G6FTN0,R6KUL9,A0A433NB65,A0A1Z4L0A1,K9UQR0,A0A2T1G8M7,K9VUN0,B7GJX9,A0A0P6X5X2,K9ZDE3,B0JXD6,A0A2T1LS63,A0A1Z4K1Y3,A0A2Z6E0R7,A0A1N6SSK9,A0A0P4UVI8,A0A0V7ZCG4,A0A1J0AGK2,K9PFF9,A0A2G9DT08,K9UEV4,Q9L1X1,A0A060HNJ0,A0A235B542,R5XQK4,A0A1H3LE92,A0A496APJ8,A0A062U2W9,H0HWQ5,A0A1V9G9U4,A0A1I2ZGP1,A0A317EJY3,A0A1I2BD20,F8ERC7,S7VLM7,A0A1A5X8H4,A0A1I2T6Q1,A0A1R3T9N6,A0A0Q2M2Z1,H8KXJ0,D3S0S6,A0A2D1U4H7,I3TE64,A0A0B7I4Z6,A0LL61,Q8DKB1,A0A139WY18,A0A1J1EK56,A0A2T1E1K4,A0A1Q8ZD62,A0A4Q6XKV6,A0A1Z3HNN4,A0A239JE83,A0A2N4XBY2,Q53W94,R5JEI2,A0A0Q0ZC47,A0A2T0XH18,A0A1V4CHV0,A0A1K1RQP7,A0A2T1EKT1,A0A1N6LUI7,A0A0P0NGR6,A0A1X7IML5,A0A0A2LKJ7,K1L112,A0A0U3AL92,A0A1H3A054,E0UCX3,K9XZC6,A0A0C1VHB4,Q31N05,A0A0C5JKF3,R5NJJ8,A5D4D9,Q2JI93,A0A142Y7A9,A0A432MEQ5,A0A372DKU2,C1F5Q7,A0A4R3EV39,A0A1P8WP90,A0A222F7P0,A0A1C9VH88,A0A2T2YMB1,A0A329TD61,A0A101R2A0,A0A1E3XF49,A0A1U9ND56,A0A4R7BQC4,A0A1Q1FPH0,E0TGY3,A0A259TUP4,F6EYI8,A0A2S9Q9J0,A0A4Q2UIU6,A0A1H0LH25,A0A318LG42,H1YCU5,L0JS08,A0A1Q5ZS75,A0A345E7N0,M0AF24,A0A1W2A082,A0A1H3X247,A0A0C1XUA0,M0D2X3,A0A2R5G167,A0A346PK63,R7RTW6,A0A1H2RBI2,A0A1C3ZXN2,B9LVP8,M5RSF0,W0JW77,B7K585,F8D8G0,A0A343TL88,L0AJX6,A0A2A5QS34,A0A343JEE2,A0A3P3RGE5,A0A329TBQ3,A0A285N2A8,A0A0W1S8B8,A0A1V4C8L7,L9VRQ2,E4NRV1,A0A1I6HGN0,A0A1I0NI68,,",366,37
"1249","C.H5.13","C.H5.15",360,182,178,1.98681936041487,"4F1N,4F3T,4KRE,5GUH,5VM9,6KR6,6OON,7KX7,7SWF,A0A163JTZ6,A0A196SDB4,J9D5G4,Q389P5,C4LVV2,A0A2P6N8X7,A8BCK6,A2DPV7,A0A0G4H2S4,T1H8B3,R1FDF0,S4RWI0,D2VMG4,A0A074TLL7,A0A0D1ZAJ4,Q1K660,F4PH46,A0A3M7S814,A0A164ZA52,A0A383WDW5,Q54G64,S7WCF7,I0YVB2,R7QGN7,C1DZY0,A0A2C5Z0M1,A0CB11,R9ACY5,D3BMP8,A0A1Z5TVE5,W7XD45,A0A1U7LLR0,A0A4S2MWZ7,K1VVQ6,A0A158P1R9,G7DVX0,V6R0U9,G4N9J3,E3KLI3,B7Q5I1,A0A1E3QC61,D5GGK8,S8ANP9,A0A139AUH8,L2GMR6,U4LBG4,A0A177URI1,O74957,A0A3N4IGK1,A6N7Y9,A0A0E9NDK5,T1KZ60,A0A250WXN5,A0A2G8JLH3,Q5KAT1,L2GUF2,W2T741,A0A1W0E4B5,A0A2J7QB22,S4RYE2,A0A2K3CW87,A0A388KES6,A0A226EFL3,A0A3S3PD82,A0A0L0TEV1,A0A1S3J512,G0QTT2,A0A1J1HRI1,C4V9J2,Q9JMB7,A0A075AN09,Q5TW24,U5HIG6,A0A401PRI6,Q96J94,A0A2B4RHN2,G2QEV0,A0A397UU01,A0A2T7PFL8,K7ISV0,A0A024FT57,H3HCL6,A0A0G4IME3,E9FUN9,A0A1S3CYL5,D7FQK3,A0A1Y1YHC8,T1GSU4,F4S231,A0A1D8PMK0,A0A2G5B1D8,Q5BD61,A0A1C7M8P2,A0A4D8YSQ3,A0A158PJG6,J9JZ66,A0A0C2XG51,A0A158QZT6,A0A165QYQ9,T0SAU8,R7YY92,A0A3S1A0C3,A0A074YJ47,A0A2K1J482,A0A1Q3ENA6,O04379,A0A371I3C8,M8AEW7,A8P0D4,A0A2K3NY65,F4NYW7,A0A409Y6G2,A0A0L0HAB7,D8PZT7,A0A1D1W4K0,A7RQ46,W4YU94,A7BJS5,D8SNM6,A0A1J8PPA3,X1WG39,M5FQK2,Q69VD5,A0A2R6NSC2,A0A0D8XL16,A0A016WPN3,Q9QZ81,G5EES3,A0A0K0EFP6,Q8CJG0,A0A1D5NTU6,V2WTL2,A0A0V0YLH8,A0A139WDH0,A0A0R3W9Q7,H3DS31,A0A1Y1HWP2,G4T5G9,B7QCC4,A0A0B2UV00,M7BCJ9,E9GN30,Q7PZ41,A0A077Z361,R7U9I3,A0A1X7V1N5,A0A0K0JDP1,A0A0N4UKJ1,A0A498N3A3,A0A3M0IQP5,A0A0L8GBV4,Q32KD4,A0A1J1JBJ0,E0W4C3,A0A482XDA9,A0A3P7EJD6,J9K2Z4,A0A2J7Q8V4,T1IBM6,V3ZRX0,A0A210QKF7,A0A423TSS1,K1PT78,A0A267E8R7,A0A1D2N447,A0A226D7A9,F6YK55,T1KTE4,A0A2C9JGZ6,A0A1V9X9F0,K5X5Z7,A0A3Q0KUG5,T1FY40,1YVU,1Z26,3DLB,5AWH,5G5T,5I4A,6QZK,7R8K,E8N0K8,A0A1I7IXT4,A0A2W1JZ37,A0A2S7WBN3,A0A328VKE4,A0A420DFE6,E0ST67,A0A4V1VDY2,A0A368P5I0,C4L1M1,A0A4R1RMM2,A0A1Y2RDH8,Q11QW7,A0A1M5ZSR3,A0A0K8QX04,A0A0M2PXX3,A0A1I3LMA1,K9TPA9,A0A1L3JHM3,A0A1W6MIP2,A0A1C0UUC4,A0A2U2J9E0,A0A2Z6E1D5,A0A0F4NXW8,A0A142XB92,B1XJG0,A0A326U7G5,A0A3D8L290,H1KXR6,A0A1Q4R485,K9U8J6,A0A097QRL6,K9RC91,A0A0D8ZUC0,A0A139XGN8,A0A1T4Y3A2,Q5P0R2,B6YTQ5,A0A0B0H9B4,A0YYT3,A0A2T1EFY0,G6FTN0,R6KUL9,A0A433NB65,A0A1Z4L0A1,K9UQR0,A0A2T1G8M7,K9VUN0,B7GJX9,K9ZDE3,B0JXD6,A0A2T1LS63,A0A1Z4K1Y3,A0A2Z6E0R7,A0A1N6SSK9,A0A0P4UVI8,A0A0V7ZCG4,A0A1J0AGK2,K9PFF9,A0A2G9DT08,K9UEV4,Q9L1X1,A0A060HNJ0,A0A235B542,R5XQK4,A0A1H3LE92,A0A496APJ8,A0A062U2W9,H0HWQ5,A0A1V9G9U4,A0A1I2ZGP1,A0A317EJY3,A0A1I2BD20,F8ERC7,S7VLM7,A0A1A5X8H4,A0A1I2T6Q1,A0A1R3T9N6,A0A0Q2M2Z1,H8KXJ0,D3S0S6,A0A2D1U4H7,I3TE64,A0A0B7I4Z6,A0LL61,Q8DKB1,A0A139WY18,A0A1J1EK56,A0A2T1E1K4,A0A1Q8ZD62,A0A4Q6XKV6,A0A1Z3HNN4,A0A239JE83,A0A2N4XBY2,Q53W94,R5JEI2,A0A0Q0ZC47,A0A2T0XH18,A0A1V4CHV0,A0A1K1RQP7,A0A2T1EKT1,A0A1N6LUI7,A0A0P0NGR6,A0A1X7IML5,A0A0A2LKJ7,K1L112,A0A0U3AL92,A0A1H3A054,E0UCX3,K9XZC6,A0A0C1VHB4,Q31N05,A0A0C5JKF3,R5NJJ8,A5D4D9,Q2JI93,A0A142Y7A9,A0A432MEQ5,A0A372DKU2,C1F5Q7,A0A4R3EV39,A0A1P8WP90,A0A222F7P0,A0A1C9VH88,A0A2T2YMB1,A0A329TD61,A0A101R2A0,A0A1E3XF49,A0A1U9ND56,A0A4R7BQC4,A0A1Q1FPH0,E0TGY3,A0A259TUP4,F6EYI8,A0A2S9Q9J0,A0A4Q2UIU6,A0A1H0LH25,A0A318LG42,H1YCU5,L0JS08,A0A1Q5ZS75,A0A345E7N0,M0AF24,A0A1W2A082,A0A1H3X247,A0A0C1XUA0,M0D2X3,A0A2R5G167,A0A346PK63,R7RTW6,A0A1H2RBI2,A0A1C3ZXN2,B9LVP8,M5RSF0,W0JW77,B7K585,F8D8G0,A0A343TL88,L0AJX6,A0A2A5QS34,A0A343JEE2,A0A3P3RGE5,A0A329TBQ3,A0A285N2A8,A0A0W1S8B8,A0A1V4C8L7,L9VRQ2,E4NRV1,A0A1I6HGN0,A0A1I0NI68,,",366,37
"1250","C.H5.14","C.H5.16",361,182,179,2.02802504757812,"4F1N,4F3T,4KRE,5GUH,5VM9,6KR6,6OON,7KX7,7SWF,A0A163JTZ6,A0A196SDB4,J9D5G4,Q389P5,C4LVV2,A0A2P6N8X7,A8BCK6,A2DPV7,A0A0G4H2S4,T1H8B3,R1FDF0,S4RWI0,D2VMG4,A0A074TLL7,A0A0D1ZAJ4,Q1K660,F4PH46,A0A3M7S814,A0A164ZA52,A0A383WDW5,Q54G64,S7WCF7,I0YVB2,R7QGN7,C1DZY0,A0A2C5Z0M1,A0CB11,R9ACY5,D3BMP8,A0A1Z5TVE5,W7XD45,A0A1U7LLR0,A0A4S2MWZ7,K1VVQ6,A0A158P1R9,G7DVX0,V6R0U9,G4N9J3,E3KLI3,B7Q5I1,A0A1E3QC61,D5GGK8,S8ANP9,A0A139AUH8,L2GMR6,U4LBG4,A0A177URI1,O74957,A0A3N4IGK1,A6N7Y9,A0A0E9NDK5,T1KZ60,A0A250WXN5,A0A2G8JLH3,Q5KAT1,L2GUF2,W2T741,A0A1W0E4B5,A0A2J7QB22,S4RYE2,A0A2K3CW87,A0A388KES6,A0A226EFL3,A0A3S3PD82,A0A0L0TEV1,A0A1S3J512,G0QTT2,A0A1J1HRI1,C4V9J2,Q9JMB7,A0A075AN09,Q5TW24,U5HIG6,A0A401PRI6,Q96J94,A0A2B4RHN2,G2QEV0,A0A397UU01,A0A2T7PFL8,K7ISV0,A0A024FT57,H3HCL6,A0A0G4IME3,E9FUN9,A0A1S3CYL5,D7FQK3,A0A1Y1YHC8,T1GSU4,F4S231,A0A1D8PMK0,A0A2G5B1D8,Q5BD61,A0A1C7M8P2,A0A4D8YSQ3,A0A158PJG6,J9JZ66,A0A0C2XG51,A0A158QZT6,A0A165QYQ9,T0SAU8,R7YY92,A0A3S1A0C3,A0A074YJ47,A0A2K1J482,A0A1Q3ENA6,O04379,A0A371I3C8,M8AEW7,A8P0D4,A0A2K3NY65,F4NYW7,A0A409Y6G2,A0A0L0HAB7,D8PZT7,A0A1D1W4K0,A7RQ46,W4YU94,A7BJS5,D8SNM6,A0A1J8PPA3,X1WG39,M5FQK2,Q69VD5,A0A2R6NSC2,A0A0D8XL16,A0A016WPN3,Q9QZ81,G5EES3,A0A0K0EFP6,Q8CJG0,A0A1D5NTU6,V2WTL2,A0A0V0YLH8,A0A139WDH0,A0A0R3W9Q7,H3DS31,A0A1Y1HWP2,G4T5G9,B7QCC4,A0A0B2UV00,M7BCJ9,E9GN30,Q7PZ41,A0A077Z361,R7U9I3,A0A1X7V1N5,A0A0K0JDP1,A0A0N4UKJ1,A0A498N3A3,A0A3M0IQP5,A0A0L8GBV4,Q32KD4,A0A1J1JBJ0,E0W4C3,A0A482XDA9,A0A3P7EJD6,J9K2Z4,A0A2J7Q8V4,T1IBM6,V3ZRX0,A0A210QKF7,A0A423TSS1,K1PT78,A0A267E8R7,A0A1D2N447,A0A226D7A9,F6YK55,T1KTE4,A0A2C9JGZ6,A0A1V9X9F0,K5X5Z7,A0A3Q0KUG5,T1FY40,1YVU,1Z26,3DLB,5AWH,5G5T,5I4A,6QZK,7R8K,E8N0K8,A0A1I7IXT4,A0A2W1JZ37,A0A2S7WBN3,A0A328VKE4,A0A420DFE6,E0ST67,A0A4V1VDY2,A0A368P5I0,C4L1M1,A0A4R1RMM2,A0A1Y2RDH8,Q11QW7,A0A1M5ZSR3,A0A0K8QX04,A0A0M2PXX3,A0A1I3LMA1,K9TPA9,A0A1L3JHM3,A0A1W6MIP2,A0A1C0UUC4,A0A2U2J9E0,A0A2Z6E1D5,A0A0F4NXW8,A0A142XB92,B1XJG0,A0A326U7G5,A0A3D8L290,H1KXR6,A0A1Q4R485,K9U8J6,A0A097QRL6,K9RC91,A0A0D8ZUC0,A0A139XGN8,A0A1T4Y3A2,Q5P0R2,B6YTQ5,A0A0B0H9B4,A0YYT3,A0A2T1EFY0,G6FTN0,R6KUL9,A0A433NB65,A0A1Z4L0A1,K9UQR0,A0A2T1G8M7,K9VUN0,B7GJX9,K9ZDE3,B0JXD6,A0A2T1LS63,A0A1Z4K1Y3,A0A2Z6E0R7,A0A1N6SSK9,A0A0P4UVI8,A0A0V7ZCG4,A0A1J0AGK2,K9PFF9,A0A2G9DT08,K9UEV4,Q9L1X1,A0A060HNJ0,A0A235B542,R5XQK4,A0A1H3LE92,A0A496APJ8,A0A062U2W9,H0HWQ5,A0A1V9G9U4,A0A1I2ZGP1,A0A317EJY3,A0A1I2BD20,F8ERC7,S7VLM7,A0A1A5X8H4,A0A1I2T6Q1,A0A1R3T9N6,A0A0Q2M2Z1,H8KXJ0,D3S0S6,A0A2D1U4H7,I3TE64,A0A0B7I4Z6,A0LL61,Q8DKB1,A0A139WY18,A0A1J1EK56,A0A2T1E1K4,A0A1Q8ZD62,A0A4Q6XKV6,A0A1Z3HNN4,A0A239JE83,A0A2N4XBY2,Q53W94,R5JEI2,A0A0Q0ZC47,A0A2T0XH18,A0A1V4CHV0,A0A1K1RQP7,A0A2T1EKT1,A0A1N6LUI7,A0A0P0NGR6,A0A1X7IML5,A0A0A2LKJ7,K1L112,A0A0U3AL92,A0A1H3A054,E0UCX3,K9XZC6,B9LVW4,A0A0C1VHB4,Q31N05,A0A0C5JKF3,R5NJJ8,A5D4D9,Q2JI93,A0A142Y7A9,A0A432MEQ5,A0A372DKU2,C1F5Q7,A0A4R3EV39,A0A1P8WP90,A0A222F7P0,A0A1C9VH88,A0A2T2YMB1,A0A329TD61,A0A101R2A0,A0A1E3XF49,A0A1U9ND56,A0A4R7BQC4,A0A1Q1FPH0,E0TGY3,A0A259TUP4,F6EYI8,A0A2S9Q9J0,A0A4Q2UIU6,A0A1H0LH25,A0A318LG42,H1YCU5,L0JS08,A0A1Q5ZS75,A0A345E7N0,M0AF24,A0A1W2A082,A0A1H3X247,A0A0C1XUA0,M0D2X3,A0A2R5G167,A0A346PK63,R7RTW6,A0A1H2RBI2,A0A1C3ZXN2,B9LVP8,M5RSF0,W0JW77,B7K585,F8D8G0,A0A343TL88,L0AJX6,A0A2A5QS34,A0A343JEE2,A0A3P3RGE5,A0A329TBQ3,A0A285N2A8,A0A0W1S8B8,A0A1V4C8L7,L9VRQ2,E4NRV1,A0A1I6HGN0,A0A1I0NI68,,",366,37
"1253","C.H8.13","C.H8.15",350,182,168,1.9702380952381,"4F1N,4F3T,4KRE,5GUH,5VM9,6KR6,6OON,7KX7,7SWF,A0A163JTZ6,A0A0N4X8S8,A0A196SDB4,J9D5G4,Q389P5,C4LVV2,A0A2P6N8X7,A8BCK6,A2DPV7,A0A0G4H2S4,T1H8B3,R1FDF0,S4RWI0,D2VMG4,A0A074TLL7,A0A0D1ZAJ4,Q1K660,F4PH46,A0A3M7S814,A0A164ZA52,A0A383WDW5,Q54G64,S7WCF7,I0YVB2,R7QGN7,C1DZY0,A0A2C5Z0M1,A0CB11,R9ACY5,D3BMP8,A0A1Z5TVE5,W7XD45,A0A1U7LLR0,A0A4S2MWZ7,K1VVQ6,A0A158P1R9,G7DVX0,V6R0U9,G4N9J3,E3KLI3,B7Q5I1,A0A1E3QC61,D5GGK8,S8ANP9,A0A139AUH8,L2GMR6,U4LBG4,A0A177URI1,O74957,A0A3N4IGK1,A6N7Y9,A0A0E9NDK5,T1KZ60,A0A250WXN5,A0A2G8JLH3,Q5KAT1,L2GUF2,W2T741,A0A1W0E4B5,A0A2J7QB22,A0A2K3CW87,A0A388KES6,A0A226EFL3,A0A3S3PD82,A0A0L0TEV1,A0A1S3J512,G0QTT2,A0A1J1HRI1,C4V9J2,Q9JMB7,A0A075AN09,Q5TW24,U5HIG6,A0A401PRI6,Q96J94,A0A2B4RHN2,G2QEV0,A0A397UU01,A0A2T7PFL8,K7ISV0,A0A024FT57,H3HCL6,A0A0G4IME3,E9FUN9,A0A1S3CYL5,D7FQK3,A0A1Y1YHC8,T1GSU4,F4S231,A0A1D8PMK0,A0A2G5B1D8,Q5BD61,A0A1C7M8P2,A0A4D8YSQ3,A0A158PJG6,J9JZ66,A0A0C2XG51,A0A158QZT6,A0A165QYQ9,T0SAU8,R7YY92,A0A3S1A0C3,A0A074YJ47,A0A2K1J482,A0A1Q3ENA6,O04379,A0A371I3C8,M8AEW7,A8P0D4,A0A2K3NY65,F4NYW7,A0A409Y6G2,A0A0L0HAB7,D8PZT7,A0A1D1W4K0,A7RQ46,W4YU94,A7BJS5,D8SNM6,A0A1J8PPA3,X1WG39,M5FQK2,Q69VD5,A0A2R6NSC2,A0A0D8XL16,A0A016WPN3,Q9QZ81,G5EES3,A0A0K0EFP6,Q8CJG0,A0A1D5NTU6,V2WTL2,A0A0V0YLH8,A0A139WDH0,A0A0R3W9Q7,H3DS31,A0A1Y1HWP2,G4T5G9,B7QCC4,A0A0B2UV00,M7BCJ9,E9GN30,Q7PZ41,A0A077Z361,R7U9I3,A0A1X7V1N5,A0A0K0JDP1,A0A0N4UKJ1,A0A498N3A3,A0A3M0IQP5,A0A0L8GBV4,Q32KD4,A0A1J1JBJ0,E0W4C3,A0A482XDA9,A0A3P7EJD6,J9K2Z4,A0A2J7Q8V4,T1IBM6,V3ZRX0,A0A210QKF7,A0A423TSS1,K1PT78,A0A267E8R7,A0A1D2N447,A0A226D7A9,F6YK55,T1KTE4,A0A2C9JGZ6,A0A1V9X9F0,K5X5Z7,A0A3Q0KUG5,T1FY40,1YVU,1Z26,3DLB,5AWH,5G5T,6QZK,7R8K,E8N0K8,A0A1I7IXT4,A0A2W1JZ37,A0A2S7WBN3,A0A328VKE4,A0A420DFE6,E0ST67,A0A4V1VDY2,A0A368P5I0,C4L1M1,A0A4R1RMM2,A0A1Y2RDH8,Q11QW7,A0A0K8QX04,A0A0M2PXX3,A0A1I3LMA1,K9TPA9,A0A1L3JHM3,A0A1W6MIP2,A0A1C0UUC4,A0A2U2J9E0,A0A2Z6E1D5,A0A0F4NXW8,A0A142XB92,L8D0R3,B1XJG0,A0A326U7G5,A0A3D8L290,H1KXR6,A0A1Q4R485,K9U8J6,A0A097QRL6,K9RC91,A0A0D8ZUC0,A0A139XGN8,A0A1T4Y3A2,Q5P0R2,B6YTQ5,A0A0B0H9B4,A0YYT3,A0A2T1EFY0,G6FTN0,R6KUL9,A0A433NB65,A0A1Z4L0A1,K9UQR0,A0A2T1G8M7,K9VUN0,B7GJX9,A0A0P6X5X2,K9ZDE3,B0JXD6,A0A2T1LS63,A0A1Z4K1Y3,A0A2Z6E0R7,A0A1N6SSK9,A0A0P4UVI8,A0A0V7ZCG4,A0A1J0AGK2,K9PFF9,A0A2G9DT08,K9UEV4,A0A060HNJ0,A0A235B542,R5XQK4,A0A1H3LE92,A0A496APJ8,A0A062U2W9,H0HWQ5,A0A1V9G9U4,A0A1I2ZGP1,A0A317EJY3,A0A1I2BD20,F8ERC7,S7VLM7,A0A1A5X8H4,A0A1I2T6Q1,A0A1R3T9N6,A0A0Q2M2Z1,H8KXJ0,D3S0S6,A0A2D1U4H7,I3TE64,A0A0B7I4Z6,A0LL61,Q8DKB1,A0A139WY18,A0A1J1EK56,A0A2T1E1K4,A0A1Q8ZD62,A0A4Q6XKV6,A0A1Z3HNN4,A0A239JE83,A0A2N4XBY2,Q53W94,R5JEI2,A0A0Q0ZC47,A0A2T0XH18,A0A1V4CHV0,A0A1K1RQP7,A0A2T1EKT1,A0A0P0NGR6,A0A1X7IML5,A0A0A2LKJ7,K1L112,A0A0U3AL92,A0A1H3A054,E0UCX3,K9XZC6,A0A0C1VHB4,Q31N05,A0A0C5JKF3,R5NJJ8,A5D4D9,Q2JI93,A0A372DKU2,A0A3R7KLK4,C1F5Q7,A0A4R3EV39,A0A1P8WP90,A0A222F7P0,A0A1C9VH88,A0A2T2YMB1,A0A329TD61,A0A101R2A0,A0A1E3XF49,A0A4R7BQC4,A0A1H3DGN3,A0A1Q1FPH0,E0TGY3,A0A259TUP4,F6EYI8,A0A2S9Q9J0,A0A4Q2UIU6,H1YCU5,L0JS08,A0A1Q5ZS75,A0A345E7N0,M0AF24,A0A1W2A082,A0A1H3X247,A0A0C1XUA0,M0D2X3,A0A346PK63,R7RTW6,A0A1H2RBI2,A0A1C3ZXN2,B9LVP8,M5RSF0,W0JW77,A0A343TL88,L0AJX6,A0A2A5QS34,A0A343JEE2,A0A3P3RGE5,A0A329TBQ3,A0A285N2A8,A0A0W1S8B8,L9VRQ2,E4NRV1,A0A1I6HGN0,,",366,37
"1255","N.H4.1","N.H4.4",335,182,153,6.14691517632694,"4F1N,4F3T,4KRE,5GUH,5VM9,6KR6,6OON,7KX7,7SWF,A0A163JTZ6,A0A0N4X8S8,A0A196SDB4,J9D5G4,Q389P5,C4LVV2,A8BCK6,A2DPV7,A0A0G4H2S4,T1H8B3,R1FDF0,S4RWI0,D2VMG4,A0A074TLL7,A0A0D1ZAJ4,Q1K660,F4PH46,A0A3M7S814,A0A164ZA52,A0A383WDW5,Q54G64,S7WCF7,I0YVB2,R7QGN7,C1DZY0,A0A2C5Z0M1,A0CB11,R9ACY5,D3BMP8,A0A1Z5TVE5,W7XD45,A0A1U7LLR0,A0A4S2MWZ7,K1VVQ6,A0A158P1R9,G7DVX0,V6R0U9,G4N9J3,E3KLI3,B7Q5I1,A0A1E3QC61,D5GGK8,S8ANP9,A0A139AUH8,L2GMR6,U4LBG4,A0A177URI1,O74957,A0A3N4IGK1,A6N7Y9,A0A0E9NDK5,T1KZ60,A0A250WXN5,A0A2G8JLH3,Q5KAT1,L2GUF2,W2T741,A0A1W0E4B5,A0A2J7QB22,S4RYE2,A0A2K3CW87,A0A388KES6,A0A226EFL3,A0A3S3PD82,A0A0L0TEV1,A0A1S3J512,G0QTT2,A0A1J1HRI1,C4V9J2,Q9JMB7,A0A075AN09,Q5TW24,U5HIG6,A0A401PRI6,Q96J94,A0A2B4RHN2,G2QEV0,A0A397UU01,A0A2T7PFL8,K7ISV0,A0A024FT57,H3HCL6,A0A0G4IME3,E9FUN9,A0A1S3CYL5,D7FQK3,A0A1Y1YHC8,T1GSU4,F4S231,A0A1D8PMK0,A0A2G5B1D8,Q5BD61,A0A1C7M8P2,A0A4D8YSQ3,A0A158PJG6,J9JZ66,A0A0C2XG51,A0A158QZT6,A0A165QYQ9,T0SAU8,R7YY92,A0A3S1A0C3,A0A074YJ47,A0A2K1J482,A0A1Q3ENA6,O04379,A0A371I3C8,M8AEW7,A8P0D4,A0A2K3NY65,F4NYW7,A0A409Y6G2,A0A0L0HAB7,D8PZT7,A0A1D1W4K0,A7RQ46,W4YU94,A7BJS5,D8SNM6,A0A1J8PPA3,X1WG39,M5FQK2,Q69VD5,A0A2R6NSC2,A0A0D8XL16,A0A016WPN3,Q9QZ81,G5EES3,A0A0K0EFP6,Q8CJG0,A0A1D5NTU6,V2WTL2,A0A0V0YLH8,A0A139WDH0,A0A0R3W9Q7,H3DS31,A0A1Y1HWP2,G4T5G9,B7QCC4,A0A0B2UV00,M7BCJ9,E9GN30,Q7PZ41,A0A077Z361,R7U9I3,A0A1X7V1N5,A0A0K0JDP1,A0A0N4UKJ1,A0A498N3A3,A0A3M0IQP5,A0A0L8GBV4,Q32KD4,A0A1J1JBJ0,E0W4C3,A0A482XDA9,A0A3P7EJD6,J9K2Z4,A0A2J7Q8V4,T1IBM6,V3ZRX0,A0A210QKF7,A0A423TSS1,K1PT78,A0A267E8R7,A0A1D2N447,A0A226D7A9,F6YK55,T1KTE4,A0A2C9JGZ6,A0A1V9X9F0,K5X5Z7,A0A3Q0KUG5,T1FY40,1YVU,1Z26,3DLB,5AWH,5G5T,5I4A,6QZK,E8N0K8,A0A328VKE4,C4L1M1,A0A0K8QX04,A0A0M2PXX3,A0A1I3LMA1,K9TPA9,A0A1C0UUC4,A0A142XB92,B1XJG0,H1KXR6,A0A1Q4R485,K9U8J6,A0A097QRL6,K9RC91,A0A0D8ZUC0,A0A139XGN8,A0A1T4Y3A2,A0A0B0H9B4,A0YYT3,A0A2T1EFY0,G6FTN0,R6KUL9,A0A433NB65,A0A1Z4L0A1,K9UQR0,A0A2T1G8M7,K9VUN0,B7GJX9,K9ZDE3,B0JXD6,A0A2T1LS63,A0A1Z4K1Y3,A0A1N6SSK9,A0A0P4UVI8,A0A0V7ZCG4,A0A1J0AGK2,K9PFF9,A0A2G9DT08,K9UEV4,Q9L1X1,A0A060HNJ0,A0A235B542,R5XQK4,A0A1H3LE92,A0A496APJ8,A0A1V9G9U4,S7VLM7,A0A1A5X8H4,A0A1I2T6Q1,A0A1R3T9N6,A0A0Q2M2Z1,H8KXJ0,D3S0S6,A0A2D1U4H7,I3TE64,A0A0B7I4Z6,A0LL61,Q8DKB1,A0A139WY18,A0A1J1EK56,A0A2T1E1K4,A0A1Q8ZD62,A0A4Q6XKV6,A0A1Z3HNN4,A0A239JE83,A0A2N4XBY2,Q53W94,R5JEI2,A0A0Q0ZC47,A0A2T0XH18,A0A1V4CHV0,A0A1K1RQP7,A0A2T1EKT1,A0A1N6LUI7,A0A0P0NGR6,A0A1X7IML5,A0A0A2LKJ7,K1L112,A0A0U3AL92,A0A1H3A054,E0UCX3,K9XZC6,B9LVW4,A0A0C1VHB4,Q31N05,A0A0C5JKF3,R5NJJ8,A5D4D9,Q2JI93,A0A142Y7A9,A0A432MEQ5,A0A372DKU2,A0A3R7KLK4,C1F5Q7,A0A4R3EV39,A0A1P8WP90,A0A222F7P0,A0A1C9VH88,A0A2T2YMB1,A0A329TD61,A0A101R2A0,A0A1E3XF49,A0A1U9ND56,A0A4R7BQC4,A0A1H3DGN3,A0A1Q1FPH0,E0TGY3,A0A259TUP4,F6EYI8,A0A2S9Q9J0,A0A4Q2UIU6,A0A1H0LH25,A0A318LG42,H1YCU5,L0JS08,A0A1Q5ZS75,A0A345E7N0,M0AF24,A0A1W2A082,A0A1H3X247,A0A0C1XUA0,M0D2X3,A0A2R5G167,A0A346PK63,R7RTW6,A0A1H2RBI2,A0A1C3ZXN2,B9LVP8,M5RSF0,W0JW77,B7K585,F8D8G0,A0A343TL88,L0AJX6,A0A2A5QS34,A0A343JEE2,A0A3P3RGE5,A0A329TBQ3,A0A285N2A8,A0A0W1S8B8,A0A1V4C8L7,L9VRQ2,E4NRV1,A0A1I6HGN0,A0A1I0NI68,,",366,37
"1256","N.H8.3","N.H8.5",322,182,140,1.74065934065934,"4F1N,4F3T,4KRE,5GUH,5VM9,6KR6,6OON,7KX7,7SWF,A0A163JTZ6,A0A0N4X8S8,A0A196SDB4,J9D5G4,Q389P5,C4LVV2,A8BCK6,A2DPV7,A0A0G4H2S4,T1H8B3,R1FDF0,S4RWI0,D2VMG4,A0A074TLL7,A0A0D1ZAJ4,Q1K660,F4PH46,A0A3M7S814,A0A164ZA52,A0A383WDW5,Q54G64,S7WCF7,I0YVB2,R7QGN7,C1DZY0,A0A2C5Z0M1,A0CB11,R9ACY5,D3BMP8,A0A1Z5TVE5,W7XD45,A0A1U7LLR0,A0A4S2MWZ7,K1VVQ6,A0A158P1R9,G7DVX0,V6R0U9,G4N9J3,E3KLI3,B7Q5I1,A0A1E3QC61,D5GGK8,S8ANP9,A0A139AUH8,L2GMR6,U4LBG4,A0A177URI1,O74957,A0A3N4IGK1,A6N7Y9,A0A0E9NDK5,T1KZ60,A0A250WXN5,A0A2G8JLH3,Q5KAT1,L2GUF2,W2T741,A0A1W0E4B5,A0A2J7QB22,S4RYE2,A0A2K3CW87,A0A388KES6,A0A226EFL3,A0A3S3PD82,A0A0L0TEV1,A0A1S3J512,G0QTT2,A0A1J1HRI1,C4V9J2,Q9JMB7,A0A075AN09,Q5TW24,U5HIG6,A0A401PRI6,Q96J94,A0A2B4RHN2,G2QEV0,A0A397UU01,A0A2T7PFL8,K7ISV0,A0A024FT57,H3HCL6,A0A0G4IME3,E9FUN9,A0A1S3CYL5,D7FQK3,A0A1Y1YHC8,T1GSU4,F4S231,A0A1D8PMK0,A0A2G5B1D8,Q5BD61,A0A1C7M8P2,A0A4D8YSQ3,A0A158PJG6,J9JZ66,A0A0C2XG51,A0A158QZT6,A0A165QYQ9,T0SAU8,R7YY92,A0A3S1A0C3,A0A074YJ47,A0A2K1J482,A0A1Q3ENA6,O04379,A0A371I3C8,M8AEW7,A8P0D4,A0A2K3NY65,F4NYW7,A0A409Y6G2,A0A0L0HAB7,D8PZT7,A0A1D1W4K0,A7RQ46,W4YU94,A7BJS5,D8SNM6,A0A1J8PPA3,X1WG39,M5FQK2,Q69VD5,A0A2R6NSC2,A0A0D8XL16,A0A016WPN3,Q9QZ81,G5EES3,A0A0K0EFP6,Q8CJG0,A0A1D5NTU6,V2WTL2,A0A0V0YLH8,A0A139WDH0,A0A0R3W9Q7,H3DS31,A0A1Y1HWP2,G4T5G9,B7QCC4,A0A0B2UV00,M7BCJ9,E9GN30,Q7PZ41,A0A077Z361,R7U9I3,A0A1X7V1N5,A0A0K0JDP1,A0A0N4UKJ1,A0A498N3A3,A0A3M0IQP5,A0A0L8GBV4,Q32KD4,A0A1J1JBJ0,E0W4C3,A0A482XDA9,A0A3P7EJD6,J9K2Z4,A0A2J7Q8V4,T1IBM6,V3ZRX0,A0A210QKF7,A0A423TSS1,K1PT78,A0A267E8R7,A0A1D2N447,A0A226D7A9,F6YK55,T1KTE4,A0A2C9JGZ6,A0A1V9X9F0,K5X5Z7,A0A3Q0KUG5,T1FY40,1YVU,1Z26,3DLB,5AWH,5G5T,6QZK,7R8K,E0ST67,C4L1M1,Q11QW7,A0A0K8QX04,A0A1I3LMA1,A0A1C0UUC4,A0A2Z6E1D5,A0A0F4NXW8,A0A142XB92,L8D0R3,B1XJG0,A0A3D8L290,A0A1T4Y3A2,Q5P0R2,A0A0B0H9B4,R6KUL9,B7GJX9,A0A0P6X5X2,A0A2Z6E0R7,A0A1N6SSK9,A0A2G9DT08,Q9L1X1,A0A060HNJ0,A0A235B542,R5XQK4,A0A1H3LE92,A0A496APJ8,A0A062U2W9,H0HWQ5,A0A1V9G9U4,A0A1I2ZGP1,A0A317EJY3,A0A1I2BD20,F8ERC7,S7VLM7,A0A1A5X8H4,A0A1I2T6Q1,A0A1R3T9N6,A0A0Q2M2Z1,H8KXJ0,D3S0S6,A0A2D1U4H7,I3TE64,A0A0B7I4Z6,A0LL61,Q8DKB1,A0A139WY18,A0A1J1EK56,A0A2T1E1K4,A0A1Q8ZD62,A0A4Q6XKV6,A0A1Z3HNN4,A0A239JE83,A0A2N4XBY2,Q53W94,R5JEI2,A0A0Q0ZC47,A0A2T0XH18,A0A1V4CHV0,A0A1K1RQP7,A0A2T1EKT1,A0A1N6LUI7,A0A0P0NGR6,A0A1X7IML5,A0A0A2LKJ7,K1L112,A0A0U3AL92,A0A1H3A054,E0UCX3,K9XZC6,B9LVW4,A0A0C1VHB4,Q31N05,A0A0C5JKF3,R5NJJ8,A5D4D9,Q2JI93,A0A142Y7A9,A0A432MEQ5,A0A372DKU2,A0A3R7KLK4,C1F5Q7,A0A4R3EV39,A0A1P8WP90,A0A222F7P0,A0A1C9VH88,A0A2T2YMB1,A0A329TD61,A0A101R2A0,A0A1E3XF49,A0A1U9ND56,A0A4R7BQC4,A0A1H3DGN3,A0A1Q1FPH0,E0TGY3,A0A259TUP4,F6EYI8,A0A2S9Q9J0,A0A4Q2UIU6,A0A1H0LH25,A0A318LG42,H1YCU5,L0JS08,A0A1Q5ZS75,A0A345E7N0,M0AF24,A0A1W2A082,A0A1H3X247,A0A0C1XUA0,M0D2X3,A0A2R5G167,A0A346PK63,R7RTW6,A0A1H2RBI2,A0A1C3ZXN2,B9LVP8,M5RSF0,W0JW77,B7K585,F8D8G0,A0A343TL88,L0AJX6,A0A2A5QS34,A0A343JEE2,A0A3P3RGE5,A0A329TBQ3,A0A285N2A8,A0A0W1S8B8,A0A1V4C8L7,L9VRQ2,E4NRV1,A0A1I6HGN0,A0A1I0NI68,,",366,37
"1259","N.H4.2","N.H4.4",340,183,157,1.95903379624796,"4F1N,4F3T,4KRE,5GUH,5VM9,6KR6,6OON,7KX7,7SWF,A0A163JTZ6,A0A0N4X8S8,A0A196SDB4,J9D5G4,Q389P5,C4LVV2,A0A2P6N8X7,A8BCK6,A2DPV7,A0A0G4H2S4,T1H8B3,R1FDF0,S4RWI0,D2VMG4,A0A074TLL7,A0A0D1ZAJ4,Q1K660,F4PH46,A0A3M7S814,A0A164ZA52,A0A383WDW5,Q54G64,S7WCF7,I0YVB2,R7QGN7,C1DZY0,A0A2C5Z0M1,A0CB11,R9ACY5,D3BMP8,A0A1Z5TVE5,W7XD45,A0A1U7LLR0,A0A4S2MWZ7,K1VVQ6,A0A158P1R9,G7DVX0,V6R0U9,G4N9J3,E3KLI3,B7Q5I1,A0A1E3QC61,D5GGK8,S8ANP9,A0A139AUH8,L2GMR6,U4LBG4,A0A177URI1,O74957,A0A3N4IGK1,A6N7Y9,A0A0E9NDK5,T1KZ60,A0A250WXN5,A0A2G8JLH3,Q5KAT1,L2GUF2,W2T741,A0A1W0E4B5,A0A2J7QB22,S4RYE2,A0A2K3CW87,A0A388KES6,A0A226EFL3,A0A3S3PD82,A0A0L0TEV1,A0A1S3J512,G0QTT2,A0A1J1HRI1,C4V9J2,Q9JMB7,A0A075AN09,Q5TW24,U5HIG6,A0A401PRI6,Q96J94,A0A2B4RHN2,G2QEV0,A0A397UU01,A0A2T7PFL8,K7ISV0,A0A024FT57,H3HCL6,A0A0G4IME3,E9FUN9,A0A1S3CYL5,D7FQK3,A0A1Y1YHC8,T1GSU4,F4S231,A0A1D8PMK0,A0A2G5B1D8,Q5BD61,A0A1C7M8P2,A0A4D8YSQ3,A0A158PJG6,J9JZ66,A0A0C2XG51,A0A158QZT6,A0A165QYQ9,T0SAU8,R7YY92,A0A3S1A0C3,A0A074YJ47,A0A2K1J482,A0A1Q3ENA6,O04379,A0A371I3C8,M8AEW7,A8P0D4,A0A2K3NY65,F4NYW7,A0A409Y6G2,A0A0L0HAB7,D8PZT7,A0A1D1W4K0,A7RQ46,W4YU94,A7BJS5,D8SNM6,A0A1J8PPA3,X1WG39,M5FQK2,Q69VD5,A0A2R6NSC2,A0A0D8XL16,A0A016WPN3,Q9QZ81,G5EES3,A0A0K0EFP6,Q8CJG0,A0A1D5NTU6,V2WTL2,A0A0V0YLH8,A0A139WDH0,A0A0R3W9Q7,H3DS31,A0A1Y1HWP2,G4T5G9,B7QCC4,A0A0B2UV00,M7BCJ9,E9GN30,Q7PZ41,A0A077Z361,R7U9I3,A0A1X7V1N5,A0A0K0JDP1,A0A0N4UKJ1,A0A498N3A3,A0A3M0IQP5,A0A0L8GBV4,Q32KD4,A0A1J1JBJ0,E0W4C3,A0A482XDA9,A0A3P7EJD6,J9K2Z4,A0A2J7Q8V4,T1IBM6,V3ZRX0,A0A210QKF7,A0A423TSS1,K1PT78,A0A267E8R7,A0A1D2N447,A0A226D7A9,F6YK55,T1KTE4,A0A2C9JGZ6,A0A1V9X9F0,K5X5Z7,A0A3Q0KUG5,T1FY40,1YVU,1Z26,3DLB,5AWH,5G5T,5I4A,6QZK,E8N0K8,A0A328VKE4,C4L1M1,A0A0K8QX04,A0A0M2PXX3,A0A1I3LMA1,K9TPA9,A0A1C0UUC4,A0A142XB92,B1XJG0,H1KXR6,A0A1Q4R485,K9U8J6,A0A097QRL6,K9RC91,A0A0D8ZUC0,A0A139XGN8,A0A1T4Y3A2,B6YTQ5,A0A0B0H9B4,A0YYT3,A0A2T1EFY0,G6FTN0,R6KUL9,A0A433NB65,A0A1Z4L0A1,K9UQR0,A0A2T1G8M7,K9VUN0,B7GJX9,K9ZDE3,B0JXD6,A0A2T1LS63,A0A1Z4K1Y3,A0A1N6SSK9,A0A0P4UVI8,A0A0V7ZCG4,A0A1J0AGK2,K9PFF9,A0A2G9DT08,K9UEV4,Q9L1X1,A0A060HNJ0,A0A235B542,R5XQK4,A0A1H3LE92,A0A496APJ8,H0HWQ5,A0A1V9G9U4,A0A1I2ZGP1,A0A317EJY3,A0A1I2BD20,S7VLM7,A0A1A5X8H4,A0A1I2T6Q1,A0A1R3T9N6,A0A0Q2M2Z1,H8KXJ0,D3S0S6,A0A2D1U4H7,A0A0B7I4Z6,A0LL61,Q8DKB1,A0A139WY18,A0A1J1EK56,A0A2T1E1K4,A0A1Q8ZD62,A0A4Q6XKV6,A0A1Z3HNN4,A0A239JE83,A0A2N4XBY2,Q53W94,R5JEI2,A0A0Q0ZC47,A0A2T0XH18,A0A1V4CHV0,A0A1K1RQP7,A0A2T1EKT1,A0A1N6LUI7,A0A0P0NGR6,A0A1X7IML5,A0A0A2LKJ7,K1L112,A0A0U3AL92,A0A1H3A054,E0UCX3,K9XZC6,B9LVW4,A0A0C1VHB4,Q31N05,A0A0C5JKF3,R5NJJ8,A5D4D9,Q2JI93,A0A142Y7A9,A0A432MEQ5,A0A372DKU2,A0A3R7KLK4,C1F5Q7,A0A4R3EV39,A0A1P8WP90,A0A222F7P0,A0A1C9VH88,A0A2T2YMB1,A0A329TD61,A0A101R2A0,A0A1E3XF49,A0A1U9ND56,A0A4R7BQC4,A0A1H3DGN3,A0A1Q1FPH0,E0TGY3,A0A259TUP4,F6EYI8,A0A2S9Q9J0,A0A4Q2UIU6,A0A1H0LH25,A0A318LG42,H1YCU5,L0JS08,A0A1Q5ZS75,A0A345E7N0,M0AF24,A0A1W2A082,A0A1H3X247,A0A0C1XUA0,M0D2X3,A0A2R5G167,A0A346PK63,R7RTW6,A0A1H2RBI2,A0A1C3ZXN2,B9LVP8,M5RSF0,W0JW77,B7K585,F8D8G0,A0A343TL88,L0AJX6,A0A2A5QS34,A0A343JEE2,A0A3P3RGE5,A0A329TBQ3,A0A285N2A8,A0A0W1S8B8,A0A1V4C8L7,L9VRQ2,E4NRV1,A0A1I6HGN0,A0A1I0NI68,,",366,37
